compagnie,Domaine,Porte-greffe,parcelle,Filename,True_count,detect_count,TP,FP,FN,Precision,Recall
2022,SAOUDA,BIGARADIER,10010,IMG-00011-45.jpg,28,35,28,7,0,0.8,1.0
2022,SAOUDA,BIGARADIER,10010,IMG-00012-45.jpg,27,33,26,7,1,0.7878787878787878,0.9629629629629628
2022,SAOUDA,BIGARADIER,10010,IMG-00014-45.jpg,50,59,49,10,1,0.8305084745762712,0.98
2022,SAOUDA,BIGARADIER,10010,IMG-00018-45.jpg,30,33,29,4,1,0.8787878787878788,0.9666666666666668
2022,SAOUDA,BIGARADIER,10010,IMG-00020-45.jpg,31,40,30,10,1,0.75,0.967741935483871
2024,SAOUDA,BIGARADIER,10010,IMG-23410.jpg,85,12,12,0,73,1.0,0.1411764705882353
2024,SAOUDA,BIGARADIER,10010,IMG-23417.jpg,86,17,17,0,69,1.0,0.1976744186046512
2024,SAOUDA,BIGARADIER,10010,IMG-23430.jpg,74,25,25,0,49,1.0,0.3378378378378378
2024,SAOUDA,BIGARADIER,10010,IMG-23647.jpg,95,23,23,0,72,1.0,0.2421052631578947
2024,SAOUDA,BIGARADIER,10010,IMG-23672.jpg,47,6,6,0,41,1.0,0.1276595744680851
2024,SAOUDA,BIGARADIER,10010,IMG-23707.jpg,30,14,14,0,16,1.0,0.4666666666666667
2024,SAOUDA,BIGARADIER,10010,IMG-23709.jpg,31,5,5,0,26,1.0,0.1612903225806452
2024,SAOUDA,BIGARADIER,10010,IMG-23711.jpg,79,16,15,1,64,0.9375,0.189873417721519
2022,SAOUDA,MACROPHYLLA,10030,IMG-00158-45.jpg,101,114,97,17,4,0.8508771929824561,0.9603960396039604
2022,SAOUDA,MACROPHYLLA,10030,IMG-00159-45.jpg,155,163,146,17,9,0.8957055214723927,0.9419354838709676
2022,SAOUDA,MACROPHYLLA,10030,IMG-00162-45.jpg,119,134,113,21,6,0.8432835820895522,0.9495798319327732
2022,SAOUDA,MACROPHYLLA,10030,IMG-00169-45.jpg,72,80,68,12,4,0.85,0.9444444444444444
2022,SAOUDA,MACROPHYLLA,10031,IMG-00002-45.jpg,46,51,41,10,5,0.803921568627451,0.8913043478260869
2022,SAOUDA,MACROPHYLLA,10031,IMG-00084-45.jpg,41,49,39,10,2,0.7959183673469388,0.951219512195122
2022,SAOUDA,MACROPHYLLA,10031,IMG-00450-45.jpg,27,34,23,11,4,0.6764705882352942,0.8518518518518519
2022,SAOUDA,MACROPHYLLA,10031,IMG-00451-45.jpg,34,39,31,8,3,0.7948717948717948,0.9117647058823528
2022,SAOUDA,MACROPHYLLA,10031,IMG-00464-45.jpg,33,37,31,6,2,0.8378378378378378,0.9393939393939394
2022,ONAGRI,CITRUS VOLKAMERIANA,10101,IMG-00003-39.jpg,120,122,114,8,6,0.9344262295081968,0.95
2022,ONAGRI,CITRUS VOLKAMERIANA,10101,IMG-00010-39.jpg,85,87,78,9,7,0.896551724137931,0.9176470588235294
2024,ONAGRI,CITRUS VOLKAMERIANA,10101,IMG-10523.jpg,288,226,226,0,62,1.0,0.7847222222222222
2024,ONAGRI,CITRUS VOLKAMERIANA,10101,IMG-10545.jpg,98,79,78,1,20,0.9873417721518988,0.7959183673469388
2024,ONAGRI,CITRUS VOLKAMERIANA,10101,IMG-10558.jpg,143,103,100,3,43,0.970873786407767,0.6993006993006993
2022,ONAGRI,CITRUS VOLKAMERIANA,10102,IMG-00003-39.jpg,48,44,42,2,6,0.9545454545454546,0.875
2024,ONAGRI,CITRUS VOLKAMERIANA,10102,IMG-10637.jpg,140,110,110,0,30,1.0,0.7857142857142857
2024,ONAGRI,CITRUS VOLKAMERIANA,10102,IMG-10658.jpg,163,125,123,2,40,0.984,0.754601226993865
2022,ONAGRI,CITRUS VOLKAMERIANA,10103,IMG-00003-39.jpg,215,203,195,8,20,0.9605911330049262,0.9069767441860463
2022,ONAGRI,CITRUS VOLKAMERIANA,10103,IMG-00008-39.jpg,195,194,184,10,11,0.9484536082474226,0.9435897435897436
2024,ONAGRI,CITRUS VOLKAMERIANA,10103,IMG-10614.jpg,134,108,106,2,28,0.9814814814814816,0.7910447761194029
2024,ONAGRI,CITRUS VOLKAMERIANA,10103,IMG-10630.jpg,213,173,171,2,42,0.9884393063583816,0.8028169014084507
2024,ONAGRI,CITRUS VOLKAMERIANA,10103,IMG-10631.jpg,134,97,96,1,38,0.9896907216494846,0.7164179104477612
2022,ONAGRI,CITRUS VOLKAMERIANA,10104,IMG-00004-39.jpg,65,62,60,2,5,0.967741935483871,0.9230769230769232
2022,ONAGRI,CITRUS VOLKAMERIANA,10104,IMG-00008-39.jpg,69,70,61,9,8,0.8714285714285714,0.8840579710144928
2024,ONAGRI,CITRUS VOLKAMERIANA,10104,IMG-11267.jpg,22,17,15,2,7,0.8823529411764706,0.6818181818181818
2024,ONAGRI,CITRUS VOLKAMERIANA,10104,IMG-11327.jpg,128,98,93,5,35,0.9489795918367347,0.7265625
2024,ONAGRI,CITRUS VOLKAMERIANA,10104,IMG-11347.jpg,118,99,97,2,21,0.9797979797979798,0.8220338983050848
2024,ONAGRI,CITRUS VOLKAMERIANA,10104,IMG-11366.jpg,351,255,251,4,100,0.984313725490196,0.7150997150997151
2024,ONAGRI,CITRUS VOLKAMERIANA,10104,IMG-11386.jpg,99,80,78,2,21,0.975,0.7878787878787878
2022,ONAGRI,CITRUS VOLKAMERIANA,10105,IMG-00004-39.jpg,17,21,16,5,1,0.7619047619047619,0.9411764705882352
2022,ONAGRI,CITRUS VOLKAMERIANA,10105,IMG-00005-39.jpg,68,72,67,5,1,0.9305555555555556,0.9852941176470588
2022,ONAGRI,CITRUS VOLKAMERIANA,10108,IMG-00003-39.jpg,61,54,53,1,8,0.9814814814814816,0.8688524590163934
2022,ONAGRI,CITRUS VOLKAMERIANA,10108,IMG-00007-39.jpg,69,60,60,0,9,1.0,0.8695652173913043
2022,ONAGRI,CITRUS VOLKAMERIANA,10109,IMG-00003-39.jpg,4,4,4,0,0,1.0,1.0
2022,ONAGRI,CITRUS VOLKAMERIANA,10109,IMG-00008-39.jpg,105,108,100,8,5,0.925925925925926,0.9523809523809524
2022,KHOUALKA,CITRANGE CARRIZO,10213,IMG-00001.jpg,77,84,75,9,2,0.8928571428571429,0.974025974025974
2022,KHOUALKA,CITRANGE CARRIZO,10213,IMG-00005-40.jpg,73,85,71,14,2,0.8352941176470589,0.9726027397260274
2022,KHOUALKA,CITRANGE CARRIZO,10213,IMG-00009-40.jpg,14,19,14,5,0,0.7368421052631579,1.0
2022,KHOUALKA,CITRANGE CARRIZO,10213,IMG-00014-40.jpg,21,24,21,3,0,0.875,1.0
2022,KHOUALKA,CITRANGE CARRIZO,10213,IMG-00028-40.jpg,47,52,46,6,1,0.8846153846153846,0.9787234042553192
2022,KHOUALKA,CITRANGE CARRIZO,10213,IMG-00034-40.jpg,48,51,48,3,0,0.9411764705882352,1.0
2022,KHOUALKA,CITRANGE CARRIZO,10213,IMG-00035-40.jpg,37,39,36,3,1,0.9230769230769232,0.972972972972973
2022,KHOUALKA,CITRANGE CARRIZO,10213,IMG-00036-40.jpg,47,52,44,8,3,0.8461538461538461,0.9361702127659576
2022,KHOUALKA,CITRANGE CARRIZO,10213,IMG-00042-40.jpg,22,25,22,3,0,0.88,1.0
2022,KHOUALKA,CITRANGE CARRIZO,10213,IMG-00047-40.jpg,70,70,67,3,3,0.9571428571428572,0.9571428571428572
2022,KHOUALKA,CITRANGE CARRIZO,10213,IMG-00054-40.jpg,33,37,33,4,0,0.8918918918918919,1.0
2022,KHOUALKA,CITRANGE CARRIZO,10213,IMG-00055-40.jpg,93,93,90,3,3,0.967741935483871,0.967741935483871
2022,KHOUALKA,CITRANGE CARRIZO,10213,IMG-00061-40.jpg,113,117,108,9,5,0.9230769230769232,0.9557522123893806
2022,KHOUALKA,CITRANGE CARRIZO,10213,IMG-00066-40.jpg,48,48,42,6,6,0.875,0.875
2022,OUARGHA,MACROPHYLLA,11010,IMG-00001.jpg,40,42,39,3,1,0.9285714285714286,0.975
2022,OUARGHA,MACROPHYLLA,11010,IMG-00015-41.jpg,24,27,23,4,1,0.8518518518518519,0.9583333333333334
2022,OUARGHA,MACROPHYLLA,11010,IMG-00019-41.jpg,20,35,20,15,0,0.5714285714285714,1.0
2022,OUARGHA,MACROPHYLLA,11010,IMG-00024-41.jpg,21,25,21,4,0,0.84,1.0
2022,OUARGHA,MACROPHYLLA,11020,IMG-00017-41.jpg,51,56,50,6,1,0.8928571428571429,0.9803921568627452
2022,OUARGHA,MACROPHYLLA,11020,IMG-00018-41.jpg,13,14,13,1,0,0.9285714285714286,1.0
2022,OUARGHA,CITRANGE CARRIZO,13010,IMG-00067-41.jpg,55,74,53,21,2,0.7162162162162162,0.9636363636363636
2022,OUARGHA,CITRANGE CARRIZO,13010,IMG-00086-41.jpg,49,59,48,11,1,0.8135593220338984,0.979591836734694
2022,OUARGHA,CITRANGE CARRIZO,13010,IMG-00194-41.jpg,33,38,33,5,0,0.868421052631579,1.0
2022,OUARGHA,CITRANGE CARRIZO,13020,IMG-00023-41.jpg,31,39,31,8,0,0.7948717948717948,1.0
2022,OUARGHA,CITRANGE CARRIZO,13020,IMG-00024-41.jpg,18,22,18,4,0,0.8181818181818182,1.0
2022,OUARGHA,CITRANGE CARRIZO,13020,IMG-00039-41.jpg,4,12,4,8,0,0.3333333333333333,1.0
2022,OUARGHA,CITRANGE CARRIZO,13020,IMG-00040-41.jpg,6,14,6,8,0,0.4285714285714285,1.0
2022,OUARGHA,CITRUS VOLKAMERIANA,13030,IMG-00009-41.jpg,18,26,18,8,0,0.6923076923076923,1.0
2022,OUARGHA,CITRUS VOLKAMERIANA,13030,IMG-00013-41.jpg,46,71,46,25,0,0.647887323943662,1.0
2022,OUARGHA,CITRUS VOLKAMERIANA,13030,IMG-00027-41.jpg,12,29,12,17,0,0.4137931034482759,1.0
2022,OUARGHA,CITRUS VOLKAMERIANA,13030,IMG-00029-41.jpg,18,30,18,12,0,0.6,1.0
2022,OUARGHA,CITRUS VOLKAMERIANA,13030,IMG-00036-41.jpg,16,32,16,16,0,0.5,1.0
2022,OUARGHA,CITRUS VOLKAMERIANA,14010,IMG-00008-41.jpg,40,44,37,7,3,0.8409090909090909,0.925
2022,OUARGHA,CITRUS VOLKAMERIANA,14010,IMG-00010-41.jpg,49,57,47,10,2,0.8245614035087719,0.9591836734693876
2022,OUARGHA,CITRUS VOLKAMERIANA,14010,IMG-00011-41.jpg,47,59,47,12,0,0.7966101694915254,1.0
2022,OUARGHA,CITRUS VOLKAMERIANA,14010,IMG-00018-41.jpg,44,56,44,12,0,0.7857142857142857,1.0
2022,KHOUALKA,MACROPHYLLA,20118,IMG-00007-40.jpg,44,45,44,1,0,0.9777777777777776,1.0
2022,KHOUALKA,MACROPHYLLA,20118,IMG-00008-40.jpg,115,122,114,8,1,0.9344262295081968,0.991304347826087
2022,KHOUALKA,MACROPHYLLA,20118,IMG-00022-40.jpg,113,111,104,7,9,0.9369369369369368,0.9203539823008848
2022,KHOUALKA,MACROPHYLLA,20118,IMG-00033-40.jpg,58,62,55,7,3,0.8870967741935484,0.9482758620689656
2022,KHOUALKA,MACROPHYLLA,20118,IMG-00037-40.jpg,29,29,26,3,3,0.896551724137931,0.896551724137931
2022,KHOUALKA,MACROPHYLLA,20118,IMG-00042-40.jpg,137,138,131,7,6,0.9492753623188406,0.9562043795620438
2022,KHOUALKA,MACROPHYLLA,20118,IMG-00046-40.jpg,45,52,44,8,1,0.8461538461538461,0.9777777777777776
2022,KHOUALKA,MACROPHYLLA,20118,IMG-00050-40.jpg,48,50,46,4,2,0.92,0.9583333333333334
2022,KHOUALKA,MACROPHYLLA,20118,IMG-00055-40.jpg,52,52,49,3,3,0.9423076923076924,0.9423076923076924
2022,KHOUALKA,MACROPHYLLA,20118,IMG-00061-40.jpg,120,130,112,18,8,0.8615384615384616,0.9333333333333332
2022,KHOUALKA,MACROPHYLLA,20118,IMG-00062-40.jpg,63,63,58,5,5,0.9206349206349206,0.9206349206349206
2022,KHOUALKA,MACROPHYLLA,20118,IMG-00063-40.jpg,47,47,42,5,5,0.8936170212765957,0.8936170212765957
2022,KHOUALKA,MACROPHYLLA,20118,IMG-00066-40.jpg,84,88,81,7,3,0.9204545454545454,0.9642857142857144
2024,KHOUALKA,MACROPHYLLA,20118,IMG-12691.jpg,22,14,14,0,8,1.0,0.6363636363636364
2024,KHOUALKA,MACROPHYLLA,20118,IMG-12729.jpg,56,41,41,0,15,1.0,0.7321428571428571
2024,KHOUALKA,MACROPHYLLA,20118,IMG-12735.jpg,88,65,65,0,23,1.0,0.7386363636363636
2024,KHOUALKA,MACROPHYLLA,20118,IMG-12748.jpg,107,76,75,1,32,0.986842105263158,0.7009345794392523
2024,KHOUALKA,MACROPHYLLA,20118,IMG-12764.jpg,111,96,92,4,19,0.9583333333333334,0.8288288288288288
2024,KHOUALKA,MACROPHYLLA,20118,IMG-12808.jpg,113,77,76,1,37,0.987012987012987,0.672566371681416
2024,KHOUALKA,MACROPHYLLA,20118,IMG-12851.jpg,24,12,12,0,12,1.0,0.5
2022,KHOUALKA,MACROPHYLLA,20119,IMG-00005-40.jpg,106,108,104,4,2,0.9629629629629628,0.981132075471698
2022,KHOUALKA,MACROPHYLLA,20119,IMG-00008-40.jpg,142,149,136,13,6,0.912751677852349,0.9577464788732394
2022,KHOUALKA,MACROPHYLLA,20119,IMG-00014-40.jpg,132,135,130,5,2,0.9629629629629628,0.9848484848484848
2022,KHOUALKA,BIGARADIER,20132,IMG-00004-40.jpg,181,185,178,7,3,0.9621621621621622,0.9834254143646408
2022,KHOUALKA,BIGARADIER,20132,IMG-00025-40.jpg,91,99,88,11,3,0.8888888888888888,0.967032967032967
2022,KHOUALKA,BIGARADIER,20132,IMG-00028-40.jpg,49,53,48,5,1,0.9056603773584906,0.979591836734694
2022,KHOUALKA,BIGARADIER,20132,IMG-00035-40.jpg,103,118,103,15,0,0.8728813559322034,1.0
2022,KHOUALKA,BIGARADIER,20132,IMG-00039-40.jpg,119,136,117,19,2,0.8602941176470589,0.9831932773109244
2022,KHOUALKA,BIGARADIER,20132,IMG-00046-40.jpg,156,170,151,19,5,0.888235294117647,0.967948717948718
2022,KHOUALKA,BIGARADIER,20132,IMG-00051-40.jpg,108,112,105,7,3,0.9375,0.9722222222222222
2022,KHOUALKA,BIGARADIER,20132,IMG-00055-40.jpg,67,69,66,3,1,0.9565217391304348,0.9850746268656716
2022,KHOUALKA,BIGARADIER,20132,IMG-00058-40.jpg,89,88,86,2,3,0.9772727272727272,0.9662921348314608
2022,KHOUALKA,BIGARADIER,20132,IMG-00059-40.jpg,139,141,131,10,8,0.9290780141843972,0.9424460431654677
2022,KHOUALKA,BIGARADIER,20132,IMG-00060-40.jpg,57,54,52,2,5,0.9629629629629628,0.912280701754386
2022,KHOUALKA,BIGARADIER,20132,IMG-00064-40.jpg,117,120,111,9,6,0.925,0.9487179487179488
2022,KHOUALKA,BIGARADIER,20132,IMG-00075-40.jpg,69,77,68,9,1,0.8831168831168831,0.9855072463768116
2022,ONAGRI,BIGARADIER,20139,IMG-00021-39.jpg,93,91,88,3,5,0.967032967032967,0.946236559139785
2024,KHOUALKA,CITRUS VOLKAMERIANA,20205,IMG-12040.jpg,123,87,85,2,38,0.9770114942528736,0.6910569105691057
2024,KHOUALKA,CITRUS VOLKAMERIANA,20205,IMG-12058.jpg,116,116,111,5,5,0.956896551724138,0.956896551724138
2022,SAOUDA,CITRUS VOLKAMERIANA,21020,IMG-00033-45.jpg,67,82,67,15,0,0.8170731707317073,1.0
2022,SAOUDA,CITRUS VOLKAMERIANA,21020,IMG-00087-45.jpg,21,22,16,6,5,0.7272727272727273,0.7619047619047619
2022,SAOUDA,CITRUS VOLKAMERIANA,21020,IMG-00138-45.jpg,40,47,38,9,2,0.8085106382978723,0.95
2022,SAOUDA,CITRUS VOLKAMERIANA,21020,IMG-00145-45.jpg,37,40,35,5,2,0.875,0.945945945945946
2022,SAOUDA,CITRUS VOLKAMERIANA,21020,IMG-00155-45.jpg,38,54,38,16,0,0.7037037037037037,1.0
2022,SAOUDA,CITRUS VOLKAMERIANA,21030,IMG-00521-45.jpg,31,42,30,12,1,0.7142857142857143,0.967741935483871
2022,SAOUDA,CITRUS VOLKAMERIANA,21030,IMG-00524-45.jpg,71,84,70,14,1,0.8333333333333334,0.9859154929577464
2022,SAOUDA,CITRUS VOLKAMERIANA,21030,IMG-00536-45.jpg,41,57,40,17,1,0.7017543859649122,0.975609756097561
2022,SAOUDA,CITRUS VOLKAMERIANA,21030,IMG-00537-45.jpg,52,65,46,19,6,0.7076923076923077,0.8846153846153846
2022,SAOUDA,CITRUS VOLKAMERIANA,22020,IMG-00053-45.jpg,39,48,38,10,1,0.7916666666666666,0.9743589743589745
2022,SAOUDA,CITRUS VOLKAMERIANA,22020,IMG-00059-45.jpg,46,52,44,8,2,0.8461538461538461,0.9565217391304348
2022,SAOUDA,CITRUS VOLKAMERIANA,22020,IMG-00060-45.jpg,48,51,46,5,2,0.9019607843137256,0.9583333333333334
2022,SAOUDA,CITRUS VOLKAMERIANA,22020,IMG-00062-45.jpg,50,64,50,14,0,0.78125,1.0
2022,SAOUDA,CITRUS VOLKAMERIANA,22030,IMG-00062-45.jpg,62,71,60,11,2,0.8450704225352113,0.967741935483871
2022,SAOUDA,CITRUS VOLKAMERIANA,22030,IMG-00063-45.jpg,83,91,76,15,7,0.8351648351648352,0.9156626506024096
2022,SAOUDA,CITRUS VOLKAMERIANA,22030,IMG-00065-45.jpg,58,63,55,8,3,0.873015873015873,0.9482758620689656
2022,SAOUDA,CITRUS VOLKAMERIANA,22030,IMG-00068-45.jpg,66,74,65,9,1,0.8783783783783784,0.9848484848484848
2022,SAOUDA,CITRUS VOLKAMERIANA,23020,IMG-00024-45.jpg,47,60,44,16,3,0.7333333333333333,0.9361702127659576
2022,SAOUDA,CITRUS VOLKAMERIANA,23020,IMG-00032-45.jpg,33,37,33,4,0,0.8918918918918919,1.0
2022,SAOUDA,CITRUS VOLKAMERIANA,23020,IMG-00074-45.jpg,28,34,27,7,1,0.7941176470588235,0.9642857142857144
2022,SAOUDA,CITRUS VOLKAMERIANA,23020,IMG-00079-45.jpg,28,39,28,11,0,0.717948717948718,1.0
2022,SAOUDA,CITRUS VOLKAMERIANA,23030,IMG-00014-45.jpg,25,30,23,7,2,0.7666666666666667,0.92
2022,SAOUDA,CITRUS VOLKAMERIANA,23030,IMG-00034-45.jpg,43,60,41,19,2,0.6833333333333333,0.9534883720930232
2022,SAOUDA,CITRUS VOLKAMERIANA,23030,IMG-00069-45.jpg,28,42,27,15,1,0.6428571428571429,0.9642857142857144
2022,SAOUDA,CITRUS VOLKAMERIANA,23030,IMG-00079-45.jpg,50,67,48,19,2,0.7164179104477612,0.96
2022,SAOUDA,CITRANGE CARRIZO,24010,IMG-00097-45.jpg,59,68,56,12,3,0.8235294117647058,0.9491525423728814
2022,SAOUDA,CITRANGE CARRIZO,24010,IMG-00101-45.jpg,27,35,27,8,0,0.7714285714285715,1.0
2022,SAOUDA,CITRANGE CARRIZO,24010,IMG-00111-45.jpg,54,62,52,10,2,0.8387096774193549,0.9629629629629628
2022,SAOUDA,CITRANGE CARRIZO,24010,IMG-00112-45.jpg,40,49,39,10,1,0.7959183673469388,0.975
2022,SAOUDA,CITRANGE CARRIZO,25010,IMG-00006-45.jpg,55,66,53,13,2,0.803030303030303,0.9636363636363636
2022,SAOUDA,CITRANGE CARRIZO,25010,IMG-00007-45.jpg,77,89,74,15,3,0.8314606741573034,0.961038961038961
2022,SAOUDA,CITRANGE CARRIZO,25010,IMG-00010-45.jpg,53,67,51,16,2,0.7611940298507462,0.9622641509433962
2022,SAOUDA,CITRANGE CARRIZO,25010,IMG-00011-45.jpg,26,30,26,4,0,0.8666666666666667,1.0
2022,SAOUDA,CITRANGE CARRIZO,26010,IMG-00008-45.jpg,39,42,39,3,0,0.9285714285714286,1.0
2022,SAOUDA,CITRANGE CARRIZO,26010,IMG-00013-45.jpg,36,43,36,7,0,0.8372093023255814,1.0
2022,SAOUDA,CITRANGE CARRIZO,26010,IMG-00018-45.jpg,43,46,41,5,2,0.8913043478260869,0.9534883720930232
2022,SAOUDA,CITRANGE CARRIZO,26010,IMG-00020-45.jpg,44,43,40,3,4,0.9302325581395348,0.9090909090909092
2022,KHOUALKA,CITRANGE CARRIZO,30138,IMG-00002-40.jpg,39,44,39,5,0,0.8863636363636364,1.0
2022,KHOUALKA,CITRANGE CARRIZO,30138,IMG-00003-40.jpg,59,63,57,6,2,0.9047619047619048,0.9661016949152542
2022,KHOUALKA,CITRANGE CARRIZO,30138,IMG-00005-40.jpg,58,61,57,4,1,0.9344262295081968,0.9827586206896552
2022,KHOUALKA,CITRANGE CARRIZO,30138,IMG-00008-40.jpg,32,37,32,5,0,0.8648648648648649,1.0
2022,KHOUALKA,CITRANGE CARRIZO,30138,IMG-00011-40.jpg,26,27,25,2,1,0.925925925925926,0.9615384615384616
2022,KHOUALKA,CITRANGE CARRIZO,30138,IMG-00019-40.jpg,2,2,2,0,0,1.0,1.0
2022,KHOUALKA,CITRANGE CARRIZO,30138,IMG-00037-40.jpg,30,31,30,1,0,0.967741935483871,1.0
2022,KHOUALKA,CITRANGE CARRIZO,30138,IMG-00040-40.jpg,41,44,40,4,1,0.9090909090909092,0.975609756097561
2022,KHOUALKA,CITRANGE CARRIZO,30138,IMG-00043-40.jpg,28,35,24,11,4,0.6857142857142857,0.8571428571428571
2022,KHOUALKA,CITRANGE CARRIZO,30138,IMG-00044-40.jpg,99,103,95,8,4,0.9223300970873788,0.9595959595959596
2022,KHOUALKA,CITRANGE CARRIZO,30138,IMG-00048-40.jpg,37,40,35,5,2,0.875,0.945945945945946
2022,KHOUALKA,CITRANGE CARRIZO,30138,IMG-00057-40.jpg,73,75,70,5,3,0.9333333333333332,0.958904109589041
2022,KHOUALKA,CITRANGE CARRIZO,30138,IMG-00063-40.jpg,89,83,81,2,8,0.9759036144578314,0.9101123595505618
2022,ONAGRI,CITRUS VOLKAMERIANA,30145,IMG-00018-39.jpg,219,231,204,27,15,0.8831168831168831,0.9315068493150684
2022,ONAGRI,CITRUS VOLKAMERIANA,30145,IMG-00043-39.jpg,64,71,63,8,1,0.8873239436619719,0.984375
2022,ONAGRI,CITRUS VOLKAMERIANA,30146,IMG-00008-39.jpg,262,270,258,12,4,0.9555555555555556,0.9847328244274808
2022,ONAGRI,CITRUS VOLKAMERIANA,30146,IMG-00045-39.jpg,190,200,180,20,10,0.9,0.9473684210526316
2022,ONAGRI,CITRUS VOLKAMERIANA,30147,IMG-00002-39.jpg,269,285,264,21,5,0.9263157894736842,0.9814126394052044
2022,ONAGRI,CITRUS VOLKAMERIANA,30147,IMG-00008-39.jpg,172,184,171,13,1,0.9293478260869564,0.994186046511628
2022,ONAGRI,CITRUS VOLKAMERIANA,30148,IMG-00016-40.jpg,88,85,81,4,7,0.9529411764705882,0.9204545454545454
2022,ONAGRI,CITRUS VOLKAMERIANA,30148,IMG-00047-40.jpg,34,28,28,0,6,1.0,0.8235294117647058
2022,ONAGRI,CITRUS VOLKAMERIANA,30149,IMG-00018-39.jpg,151,148,143,5,8,0.9662162162162162,0.9470198675496688
2022,ONAGRI,CITRUS VOLKAMERIANA,30149,IMG-00027-39.jpg,226,213,206,7,20,0.9671361502347418,0.911504424778761
2022,ONAGRI,CITRUS VOLKAMERIANA,30151,IMG-00012-39.jpg,185,185,169,16,16,0.9135135135135136,0.9135135135135136
2022,ONAGRI,CITRUS VOLKAMERIANA,30151,IMG-00033-39.jpg,214,212,201,11,13,0.9481132075471698,0.9392523364485982
2024,ONAGRI,CITRUS VOLKAMERIANA,30151,IMG-21881.jpg,73,51,50,1,23,0.9803921568627452,0.684931506849315
2024,ONAGRI,CITRUS VOLKAMERIANA,30151,IMG-21935.jpg,179,91,91,0,88,1.0,0.5083798882681564
2024,ONAGRI,CITRUS VOLKAMERIANA,30151,IMG-21936.jpg,93,56,56,0,37,1.0,0.6021505376344086
2022,ONAGRI,CITRUS VOLKAMERIANA,30152,IMG-00016-39.jpg,39,33,32,1,7,0.9696969696969696,0.8205128205128205
2022,ONAGRI,CITRUS VOLKAMERIANA,30152,IMG-00019-39.jpg,139,137,131,6,8,0.9562043795620438,0.9424460431654677
2022,ONAGRI,CITRUS VOLKAMERIANA,30153,IMG-00001.jpg,157,151,145,6,12,0.9602649006622516,0.9235668789808916
2022,ONAGRI,CITRUS VOLKAMERIANA,30153,IMG-00007-39.jpg,127,114,112,2,15,0.9824561403508772,0.8818897637795275
2022,ONAGRI,CITRUS VOLKAMERIANA,30153,IMG-00013-39.jpg,159,150,147,3,12,0.98,0.9245283018867924
2022,ONAGRI,CITRUS VOLKAMERIANA,30153,IMG-00040-39.jpg,153,149,146,3,7,0.9798657718120806,0.954248366013072
2022,ONAGRI,CITRUS VOLKAMERIANA,30154,IMG-00017-39.jpg,160,162,156,6,4,0.9629629629629628,0.975
2022,ONAGRI,CITRUS VOLKAMERIANA,30154,IMG-00027-39.jpg,220,217,210,7,10,0.967741935483871,0.9545454545454546
2022,ONAGRI,CITRUS VOLKAMERIANA,30154,IMG-00033-39.jpg,51,48,48,0,3,1.0,0.9411764705882352
2022,ONAGRI,CITRUS VOLKAMERIANA,30154,IMG-00036-39.jpg,137,142,134,8,3,0.943661971830986,0.978102189781022
2022,ONAGRI,CITRUS VOLKAMERIANA,30154,IMG-00038-39.jpg,242,244,236,8,6,0.9672131147540984,0.975206611570248
2022,ONAGRI,CITRUS VOLKAMERIANA,30154,IMG-00041-39.jpg,272,265,255,10,17,0.9622641509433962,0.9375
2022,ONAGRI,CITRUS VOLKAMERIANA,30154,IMG-00044-39.jpg,141,143,136,7,5,0.951048951048951,0.9645390070921984
2022,ONAGRI,BIGARADIER,30155,IMG-00002-39.jpg,139,143,135,8,4,0.944055944055944,0.9712230215827338
2022,ONAGRI,BIGARADIER,30155,IMG-00003-39.jpg,115,112,109,3,6,0.9732142857142856,0.9478260869565216
2022,ONAGRI,BIGARADIER,30155,IMG-00006-39.jpg,44,43,42,1,2,0.9767441860465116,0.9545454545454546
2022,ONAGRI,BIGARADIER,30155,IMG-00011-39.jpg,100,91,90,1,10,0.989010989010989,0.9
2022,ONAGRI,BIGARADIER,30155,IMG-00019-39.jpg,142,138,133,5,9,0.9637681159420288,0.9366197183098592
2022,ONAGRI,BIGARADIER,30155,IMG-00026-39.jpg,124,118,116,2,8,0.9830508474576272,0.935483870967742
2022,ONAGRI,BIGARADIER,30155,IMG-00032-39.jpg,81,78,74,4,7,0.9487179487179488,0.9135802469135802
2022,ONAGRI,BIGARADIER,30155,IMG-00039-39.jpg,19,20,19,1,0,0.95,1.0
2022,ONAGRI,BIGARADIER,30155,IMG-00043-39.jpg,130,136,127,9,3,0.9338235294117648,0.9769230769230768
2022,ONAGRI,CITRUS VOLKAMERIANA,30157,IMG-00003-39.jpg,227,225,216,9,11,0.96,0.9515418502202644
2022,ONAGRI,CITRUS VOLKAMERIANA,30157,IMG-00012-39.jpg,283,280,269,11,14,0.9607142857142856,0.950530035335689
2022,ONAGRI,CITRUS VOLKAMERIANA,30157,IMG-00032-39.jpg,64,66,63,3,1,0.9545454545454546,0.984375
2022,ONAGRI,CITRUS VOLKAMERIANA,30157,IMG-00035-39.jpg,159,157,152,5,7,0.9681528662420382,0.9559748427672956
2022,KHOUALKA,CITRUS VOLKAMERIANA,30235,IMG-00001.jpg,93,100,92,8,1,0.92,0.989247311827957
2022,KHOUALKA,CITRUS VOLKAMERIANA,30235,IMG-00003-40.jpg,37,39,37,2,0,0.9487179487179488,1.0
2022,KHOUALKA,CITRUS VOLKAMERIANA,30235,IMG-00009-40.jpg,103,112,102,10,1,0.9107142857142856,0.9902912621359224
2022,KHOUALKA,CITRUS VOLKAMERIANA,30235,IMG-00013-40.jpg,90,98,89,9,1,0.9081632653061223,0.9888888888888888
2022,KHOUALKA,CITRUS VOLKAMERIANA,30235,IMG-00026-40.jpg,122,134,121,13,1,0.9029850746268656,0.9918032786885246
2022,KHOUALKA,CITRUS VOLKAMERIANA,30235,IMG-00047-40.jpg,47,53,44,9,3,0.8301886792452831,0.9361702127659576
2022,KHOUALKA,CITRUS VOLKAMERIANA,30235,IMG-00048-40.jpg,90,98,87,11,3,0.8877551020408163,0.9666666666666668
2022,KHOUALKA,CITRUS VOLKAMERIANA,30235,IMG-00049-40.jpg,44,53,43,10,1,0.8113207547169812,0.9772727272727272
2022,KHOUALKA,CITRUS VOLKAMERIANA,30235,IMG-00050-40.jpg,84,92,82,10,2,0.8913043478260869,0.9761904761904762
2022,KHOUALKA,CITRUS VOLKAMERIANA,30235,IMG-00052-40.jpg,98,109,96,13,2,0.8807339449541285,0.979591836734694
2022,KHOUALKA,CITRUS VOLKAMERIANA,30235,IMG-00057-40.jpg,80,82,75,7,5,0.9146341463414634,0.9375
2022,KHOUALKA,CITRUS VOLKAMERIANA,30235,IMG-00064-40.jpg,38,40,35,5,3,0.875,0.9210526315789472
2022,KHOUALKA,CITRUS VOLKAMERIANA,30235,IMG-00067-40.jpg,107,101,95,6,12,0.9405940594059404,0.8878504672897196
2022,KHOUALKA,CITRUS VOLKAMERIANA,30235,IMG-00069-40.jpg,34,33,30,3,4,0.9090909090909092,0.8823529411764706
2022,KHOUALKA,CITRUS VOLKAMERIANA,30235,IMG-00075-40.jpg,95,95,87,8,8,0.9157894736842104,0.9157894736842104
2022,KHOUALKA,BIGARADIER,40141,IMG-00006-40.jpg,7,9,6,3,1,0.6666666666666666,0.8571428571428571
2022,KHOUALKA,BIGARADIER,40141,IMG-00007-40.jpg,20,14,11,3,9,0.7857142857142857,0.55
2022,KHOUALKA,BIGARADIER,40141,IMG-00008-40.jpg,15,17,13,4,2,0.7647058823529411,0.8666666666666667
2022,ONAGRI,CITRANGE C35,40166,IMG-00009-39.jpg,38,37,35,2,3,0.945945945945946,0.9210526315789472
2022,ONAGRI,CITRANGE C35,40166,IMG-00011-39.jpg,173,174,167,7,6,0.9597701149425288,0.9653179190751444
2022,ONAGRI,CITRANGE C35,40166,IMG-00014-39.jpg,179,180,177,3,2,0.9833333333333332,0.988826815642458
2022,ONAGRI,CITRANGE C35,40166,IMG-00015-39.jpg,122,120,119,1,3,0.9916666666666668,0.9754098360655736
2022,ONAGRI,CITRANGE C35,40166,IMG-00041-39.jpg,102,102,101,1,1,0.9901960784313726,0.9901960784313726
2022,ONAGRI,CITRANGE C35,40167,IMG-00019-39.jpg,197,196,192,4,5,0.979591836734694,0.9746192893401016
2022,ONAGRI,CITRANGE C35,40167,IMG-00030-39.jpg,126,121,121,0,5,1.0,0.9603174603174603
2022,ONAGRI,CITRANGE C35,40167,IMG-00039-39.jpg,217,212,203,9,14,0.9575471698113208,0.935483870967742
2022,ONAGRI,CITRANGE C35,40171,IMG-00008-39.jpg,109,105,105,0,4,1.0,0.963302752293578
2022,ONAGRI,CITRANGE C35,40171,IMG-00037-39.jpg,94,91,89,2,5,0.978021978021978,0.946808510638298
2022,ONAGRI,CITRANGE C35,40171,IMG-00040-39.jpg,149,144,140,4,9,0.9722222222222222,0.9395973154362416
2022,ONAGRI,CITRANGE C35,40172,IMG-00012-39.jpg,89,84,83,1,6,0.988095238095238,0.9325842696629212
2022,ONAGRI,CITRANGE C35,40172,IMG-00025-39.jpg,109,104,102,2,7,0.9807692307692308,0.9357798165137616
2022,ONAGRI,CITRANGE C35,40172,IMG-00027-39.jpg,103,101,99,2,4,0.9801980198019802,0.9611650485436892
2022,ONAGRI,CITRANGE C35,40173,IMG-00004-39.jpg,133,122,120,2,13,0.9836065573770492,0.9022556390977444
2022,ONAGRI,CITRANGE C35,40173,IMG-00008-39.jpg,57,45,45,0,12,1.0,0.7894736842105263
2022,ONAGRI,CITRANGE C35,40173,IMG-00010-39.jpg,53,53,52,1,1,0.981132075471698,0.981132075471698
2022,ONAGRI,CITRANGE C35,40175,IMG-00005-39.jpg,95,90,87,3,8,0.9666666666666668,0.9157894736842104
2022,ONAGRI,CITRANGE C35,40175,IMG-00006-39.jpg,64,66,61,5,3,0.9242424242424242,0.953125
2022,ONAGRI,CITRANGE C35,40176,IMG-00004-39.jpg,79,88,72,16,7,0.8181818181818182,0.9113924050632912
2022,ONAGRI,CITRANGE C35,40176,IMG-00012-39.jpg,105,114,104,10,1,0.912280701754386,0.9904761904761904
2022,ONAGRI,CITRANGE C35,40176,IMG-00014-39.jpg,91,98,87,11,4,0.8877551020408163,0.956043956043956
2022,ONAGRI,CITRUMELO SACCATON,40177,IMG-00012-39.jpg,89,97,85,12,4,0.8762886597938144,0.9550561797752808
2022,ONAGRI,CITRUMELO SACCATON,40177,IMG-00015-39.jpg,213,221,211,10,2,0.9547511312217196,0.9906103286384976
2022,ONAGRI,CITRUMELO SACCATON,40177,IMG-00037-39.jpg,95,97,91,6,4,0.9381443298969072,0.9578947368421052
2022,ONAGRI,CITRANGE C35,40178,IMG-00013-39.jpg,76,80,75,5,1,0.9375,0.986842105263158
2022,ONAGRI,CITRANGE C35,40178,IMG-00027-39.jpg,56,60,55,5,1,0.9166666666666666,0.9821428571428572
2022,ONAGRI,CITRANGE C35,40178,IMG-00031-39.jpg,30,33,30,3,0,0.9090909090909092,1.0
2022,ONAGRI,CITRANGE C35,40178,IMG-00032-39.jpg,27,28,27,1,0,0.9642857142857144,1.0
2022,ONAGRI,CITRANGE C35,40178,IMG-00033-39.jpg,34,39,34,5,0,0.8717948717948718,1.0
2022,ONAGRI,CITRANGE C35,40179,IMG-00001.jpg,83,87,81,6,2,0.9310344827586208,0.9759036144578314
2022,ONAGRI,CITRANGE C35,40179,IMG-00010-39.jpg,161,164,155,9,6,0.945121951219512,0.9627329192546584
2022,ONAGRI,CITRANGE C35,40179,IMG-00011-39.jpg,102,109,98,11,4,0.8990825688073395,0.9607843137254902
2022,ONAGRI,CITRANGE C35,40179,IMG-00018-39.jpg,9,11,9,2,0,0.8181818181818182,1.0
2022,ONAGRI,CITRUMELO SACCATON,40182,IMG-00004-39.jpg,35,38,35,3,0,0.9210526315789472,1.0
2022,ONAGRI,CITRUMELO SACCATON,40182,IMG-00010-39.jpg,52,50,48,2,4,0.96,0.9230769230769232
2022,ONAGRI,CITRUMELO SACCATON,40182,IMG-00015-39.jpg,85,85,78,7,7,0.9176470588235294,0.9176470588235294
2022,ONAGRI,CITRUMELO SACCATON,40183,IMG-00005-39.jpg,68,71,67,4,1,0.943661971830986,0.9852941176470588
2022,ONAGRI,CITRUMELO SACCATON,40183,IMG-00009-39.jpg,57,64,57,7,0,0.890625,1.0
2022,ONAGRI,CITRUMELO SACCATON,40183,IMG-00010-39.jpg,48,51,45,6,3,0.8823529411764706,0.9375
2024,KHOUALKA,CITRUS VOLKAMERIANA,50152,IMG-17274.jpg,170,127,125,2,45,0.984251968503937,0.7352941176470589
2024,KHOUALKA,CITRUS VOLKAMERIANA,50152,IMG-17306.jpg,105,93,93,0,12,1.0,0.8857142857142857
2024,KHOUALKA,CITRUS VOLKAMERIANA,50152,IMG-17330.jpg,41,34,32,2,9,0.9411764705882352,0.7804878048780488
2024,KHOUALKA,CITRUS VOLKAMERIANA,50152,IMG-17335.jpg,44,35,35,0,9,1.0,0.7954545454545454
2024,KHOUALKA,CITRUS VOLKAMERIANA,50152,IMG-17340.jpg,108,75,71,4,37,0.9466666666666668,0.6574074074074074
2024,KHOUALKA,CITRUS VOLKAMERIANA,50152,IMG-17356.jpg,60,42,41,1,19,0.9761904761904762,0.6833333333333333
2024,KHOUALKA,CITRUS VOLKAMERIANA,50152,IMG-17384.jpg,53,35,34,1,19,0.9714285714285714,0.6415094339622641
2024,KHOUALKA,CITRUS VOLKAMERIANA,50154,IMG-17440.jpg,76,64,63,1,13,0.984375,0.8289473684210527
2024,KHOUALKA,CITRUS VOLKAMERIANA,50154,IMG-17490.jpg,107,75,73,2,34,0.9733333333333334,0.6822429906542056
2024,KHOUALKA,CITRUS VOLKAMERIANA,50154,IMG-17543.jpg,100,71,70,1,30,0.9859154929577464,0.7
2024,KHOUALKA,CITRUS VOLKAMERIANA,50154,IMG-17545.jpg,94,63,63,0,31,1.0,0.6702127659574468
2024,KHOUALKA,CITRUS VOLKAMERIANA,50154,IMG-17562.jpg,129,102,101,1,28,0.9901960784313726,0.7829457364341085
2024,KHOUALKA,CITRUS VOLKAMERIANA,50154,IMG-17576.jpg,121,95,95,0,26,1.0,0.7851239669421488
2024,KHOUALKA,CITRUS VOLKAMERIANA,50154,IMG-17585.jpg,171,120,117,3,54,0.975,0.6842105263157895
2024,KHOUALKA,CITRUS VOLKAMERIANA,50168,IMG-13980.jpg,174,125,124,1,50,0.992,0.7126436781609196
2024,KHOUALKA,CITRUS VOLKAMERIANA,50168,IMG-15749.jpg,147,110,107,3,40,0.9727272727272728,0.7278911564625851
2024,KHOUALKA,CITRUS VOLKAMERIANA,50168,IMG-15758.jpg,163,125,120,5,43,0.96,0.7361963190184049
2024,KHOUALKA,CITRUS VOLKAMERIANA,50168,IMG-15981.jpg,210,161,159,2,51,0.9875776397515528,0.7571428571428571
2024,KHOUALKA,CITRUS VOLKAMERIANA,50168,IMG-15983.jpg,120,85,85,0,35,1.0,0.7083333333333334
2024,KHOUALKA,CITRUS VOLKAMERIANA,50176,IMG-16025.jpg,81,62,61,1,20,0.9838709677419356,0.7530864197530864
2024,KHOUALKA,CITRUS VOLKAMERIANA,50176,IMG-16051.jpg,85,54,54,0,31,1.0,0.6352941176470588
2024,KHOUALKA,CITRUS VOLKAMERIANA,50176,IMG-16079.jpg,161,118,117,1,44,0.9915254237288136,0.7267080745341615
2024,KHOUALKA,CITRUS VOLKAMERIANA,50176,IMG-16095.jpg,101,61,60,1,41,0.9836065573770492,0.594059405940594
2024,KHOUALKA,CITRUS VOLKAMERIANA,50176,IMG-16105.jpg,43,28,27,1,16,0.9642857142857144,0.627906976744186
2022,ONAGRI,CITRUMELO SACCATON,50193,IMG-00007-39.jpg,218,238,215,23,3,0.9033613445378152,0.9862385321100916
2022,ONAGRI,CITRUMELO SACCATON,50193,IMG-00016-39.jpg,64,76,62,14,2,0.8157894736842105,0.96875
2022,ONAGRI,CITRUMELO SACCATON,50193,IMG-00018-39.jpg,115,123,113,10,2,0.91869918699187,0.982608695652174
2022,ONAGRI,CITRUMELO SACCATON,50193,IMG-00021-39.jpg,62,62,58,4,4,0.935483870967742,0.935483870967742
2022,ONAGRI,CITRUMELO SACCATON,50193,IMG-00023-39.jpg,113,125,111,14,2,0.888,0.9823008849557522
2022,ONAGRI,CITRUMELO SACCATON,50194,IMG-00032-39.jpg,162,165,153,12,9,0.9272727272727272,0.9444444444444444
2022,ONAGRI,CITRUMELO SACCATON,50194,IMG-00034-39.jpg,105,114,105,9,0,0.9210526315789472,1.0
2022,ONAGRI,CITRUMELO SACCATON,50194,IMG-00036-39.jpg,161,171,154,17,7,0.9005847953216374,0.9565217391304348
2022,ONAGRI,CITRUMELO SACCATON,50194,IMG-00038-39.jpg,100,116,97,19,3,0.8362068965517241,0.97
2022,ONAGRI,CITRUMELO SACCATON,50194,IMG-00039-39.jpg,65,65,62,3,3,0.953846153846154,0.953846153846154
2022,ONAGRI,CITRUMELO SACCATON,50194,IMG-00041-39.jpg,153,157,148,9,5,0.9426751592356688,0.9673202614379084
2022,ONAGRI,CITRUMELO SACCATON,50194,IMG-00051-39.jpg,137,136,130,6,7,0.9558823529411764,0.948905109489051
2022,ONAGRI,CITRUMELO SACCATON,50194,IMG-00054-39.jpg,111,114,105,9,6,0.9210526315789472,0.945945945945946
2022,ONAGRI,CITRUMELO SACCATON,51091,IMG-00015-39.jpg,85,96,84,12,1,0.875,0.9882352941176472
2022,ONAGRI,CITRUMELO SACCATON,51091,IMG-00016-39.jpg,170,179,167,12,3,0.9329608938547486,0.9823529411764704
2022,ONAGRI,CITRUMELO SACCATON,51091,IMG-00018-39.jpg,185,198,183,15,2,0.9242424242424242,0.9891891891891892
2022,ONAGRI,CITRUMELO SACCATON,51091,IMG-00022-39.jpg,135,147,132,15,3,0.8979591836734694,0.9777777777777776
2022,ONAGRI,CITRUMELO SACCATON,51091,IMG-00023-39.jpg,140,137,130,7,10,0.948905109489051,0.9285714285714286
2022,ONAGRI,CITRUMELO SACCATON,51091,IMG-00026-39.jpg,149,147,142,5,7,0.9659863945578232,0.953020134228188
2022,ONAGRI,CITRUMELO SACCATON,51091,IMG-00044-39.jpg,168,181,166,15,2,0.9171270718232044,0.988095238095238
2022,ONAGRI,CITRUMELO SACCATON,51095,IMG-00004-39.jpg,201,216,196,20,5,0.9074074074074074,0.9751243781094528
2022,ONAGRI,CITRUMELO SACCATON,51095,IMG-00013-39.jpg,154,152,144,8,10,0.9473684210526316,0.935064935064935
2022,ONAGRI,CITRUMELO SACCATON,51095,IMG-00014-39.jpg,140,145,135,10,5,0.9310344827586208,0.9642857142857144
2022,ONAGRI,CITRUMELO SACCATON,51095,IMG-00015-39.jpg,196,200,192,8,4,0.96,0.979591836734694
2022,ONAGRI,CITRUMELO SACCATON,51095,IMG-00024-39.jpg,234,240,225,15,9,0.9375,0.9615384615384616
2022,ONAGRI,CITRUMELO SACCATON,51095,IMG-00025-39.jpg,198,207,191,16,7,0.9227053140096618,0.9646464646464646
2022,ONAGRI,CITRUMELO SACCATON,51096,IMG-00009-39.jpg,219,221,208,13,11,0.9411764705882352,0.9497716894977168
2022,ONAGRI,CITRUMELO SACCATON,51096,IMG-00011-39.jpg,145,160,143,17,2,0.89375,0.986206896551724
2022,ONAGRI,CITRUMELO SACCATON,51096,IMG-00012-39.jpg,114,110,104,6,10,0.9454545454545454,0.912280701754386
2022,ONAGRI,CITRUMELO SACCATON,51096,IMG-00055-39.jpg,217,222,212,10,5,0.954954954954955,0.976958525345622
2022,ONAGRI,MC PONSIRUCE TRIFOLIATA,51097,IMG-00025-39.jpg,121,123,112,11,9,0.9105691056910568,0.9256198347107438
2022,ONAGRI,MC PONSIRUCE TRIFOLIATA,51097,IMG-00029-39.jpg,106,115,102,13,4,0.8869565217391304,0.9622641509433962
2022,ONAGRI,MC PONSIRUCE TRIFOLIATA,51097,IMG-00044-39.jpg,182,187,173,14,9,0.9251336898395722,0.9505494505494504
2022,ONAGRI,MC PONSIRUCE TRIFOLIATA,51098,IMG-00003-39.jpg,65,76,65,11,0,0.8552631578947368,1.0
2022,ONAGRI,MC PONSIRUCE TRIFOLIATA,51098,IMG-00010-39.jpg,184,193,180,13,4,0.932642487046632,0.9782608695652174
2022,ONAGRI,MC PONSIRUCE TRIFOLIATA,51098,IMG-00015-39.jpg,162,169,161,8,1,0.9526627218934912,0.9938271604938272
2022,ONAGRI,MC PONSIRUCE TRIFOLIATA,51099,IMG-00012-39.jpg,133,148,133,15,0,0.8986486486486487,1.0
2024,ONAGRI,MC PONSIRUCE TRIFOLIATA,51101,IMG-12118.jpg,177,122,122,0,55,1.0,0.6892655367231638
2024,ONAGRI,MC PONSIRUCE TRIFOLIATA,51101,IMG-14223.jpg,153,119,119,0,34,1.0,0.7777777777777778
2024,ONAGRI,MC PONSIRUCE TRIFOLIATA,51101,IMG-14226.jpg,151,117,116,1,35,0.9914529914529916,0.7682119205298014
2024,ONAGRI,MC PONSIRUCE TRIFOLIATA,51101,IMG-14255.jpg,189,150,150,0,39,1.0,0.7936507936507936
2024,ONAGRI,MC PONSIRUCE TRIFOLIATA,51101,IMG-14281.jpg,150,111,111,0,39,1.0,0.74
2022,ONAGRI,CITRUS VOLKAMERIANA,101020,IMG-00001.jpg,6,5,5,0,1,1.0,0.8333333333333334
2022,ONAGRI,CITRUS VOLKAMERIANA,101020,IMG-00004-44.jpg,53,36,35,1,18,0.9722222222222222,0.660377358490566
2022,ONAGRI,CITRUS VOLKAMERIANA,101030,IMG-00003-44.jpg,29,30,28,2,1,0.9333333333333332,0.9655172413793104
2022,ONAGRI,CITRUS VOLKAMERIANA,101030,IMG-00004-44.jpg,110,86,86,0,24,1.0,0.7818181818181819
2022,ONAGRI,CITRUS VOLKAMERIANA,101030,IMG-00005-44.jpg,134,102,100,2,34,0.9803921568627452,0.746268656716418
2022,ONAGRI,CITRUS VOLKAMERIANA,101030,IMG-00017-44.jpg,79,56,55,1,24,0.9821428571428572,0.6962025316455697
2022,ONAGRI,CITRUS VOLKAMERIANA,101040,IMG-00005-44.jpg,172,130,128,2,44,0.9846153846153848,0.7441860465116279
2022,ONAGRI,CITRUS VOLKAMERIANA,101040,IMG-00009-44.jpg,131,105,104,1,27,0.9904761904761904,0.7938931297709924
2022,ONAGRI,CITRUS VOLKAMERIANA,101040,IMG-00011-44.jpg,64,47,46,1,18,0.9787234042553192,0.71875
2022,ONAGRI,CITRUS VOLKAMERIANA,101040,IMG-00012-44.jpg,139,105,102,3,37,0.9714285714285714,0.7338129496402878
2022,ONAGRI,CITRUS VOLKAMERIANA,101050,IMG-00002-44.jpg,95,69,66,3,29,0.9565217391304348,0.6947368421052632
2022,ONAGRI,CITRUS VOLKAMERIANA,101050,IMG-00005-44.jpg,59,45,44,1,15,0.9777777777777776,0.7457627118644068
2022,ONAGRI,CITRUS VOLKAMERIANA,101050,IMG-00011-44.jpg,46,27,27,0,19,1.0,0.5869565217391305
2022,ONAGRI,CITRUS VOLKAMERIANA,101050,IMG-00024-44.jpg,40,30,29,1,11,0.9666666666666668,0.725
2022,ONAGRI,CITRUS VOLKAMERIANA,101080,IMG-00005-44.jpg,42,25,24,1,18,0.96,0.5714285714285714
2022,ONAGRI,CITRUS VOLKAMERIANA,101080,IMG-00006-44.jpg,79,49,49,0,30,1.0,0.620253164556962
2022,ONAGRI,CITRUS VOLKAMERIANA,101080,IMG-00023-44.jpg,7,7,6,1,1,0.8571428571428571,0.8571428571428571
2022,ONAGRI,CITRUS VOLKAMERIANA,101080,IMG-00024-44.jpg,27,17,17,0,10,1.0,0.6296296296296297
2022,ONAGRI,CITRUS VOLKAMERIANA,101090,IMG-00003-44.jpg,66,48,48,0,18,1.0,0.7272727272727273
2022,ONAGRI,CITRUS VOLKAMERIANA,101090,IMG-00006-44.jpg,41,29,28,1,13,0.9655172413793104,0.6829268292682927
2022,ONAGRI,CITRUS VOLKAMERIANA,101090,IMG-00019-44.jpg,35,29,29,0,6,1.0,0.8285714285714286
2022,ONAGRI,CITRUS VOLKAMERIANA,101090,IMG-00020-44.jpg,42,34,32,2,10,0.9411764705882352,0.7619047619047619
2022,KHOUALKA,CITRANGE CARRIZO,102130,IMG-00001.jpg,5,1,1,0,4,1.0,0.2
2022,KHOUALKA,CITRANGE CARRIZO,102130,IMG-00004-43.jpg,24,7,7,0,17,1.0,0.2916666666666667
2022,KHOUALKA,CITRANGE CARRIZO,102130,IMG-00019-43.jpg,33,19,19,0,14,1.0,0.5757575757575758
2022,KHOUALKA,CITRANGE CARRIZO,102130,IMG-00020-43.jpg,18,11,8,3,10,0.7272727272727273,0.4444444444444444
2022,KHOUALKA,MACROPHYLLA,201180,IMG-00007-43.jpg,38,36,33,3,5,0.9166666666666666,0.868421052631579
2022,KHOUALKA,MACROPHYLLA,201180,IMG-00011-43.jpg,64,37,36,1,28,0.972972972972973,0.5625
2022,KHOUALKA,MACROPHYLLA,201180,IMG-00019-43.jpg,64,39,39,0,25,1.0,0.609375
2022,KHOUALKA,MACROPHYLLA,201180,IMG-00020-43.jpg,43,30,29,1,14,0.9666666666666668,0.6744186046511628
2022,KHOUALKA,MACROPHYLLA,201190,IMG-00004-43.jpg,101,58,57,1,44,0.9827586206896552,0.5643564356435643
2022,KHOUALKA,MACROPHYLLA,201190,IMG-00010-43.jpg,90,32,32,0,58,1.0,0.3555555555555556
2022,KHOUALKA,MACROPHYLLA,201190,IMG-00011-43.jpg,134,52,51,1,83,0.9807692307692308,0.3805970149253731
2022,KHOUALKA,MACROPHYLLA,201190,IMG-00020-43.jpg,95,45,45,0,50,1.0,0.4736842105263158
2022,KHOUALKA,CITRUS VOLKAMERIANA,201210,IMG-00011-43.jpg,103,67,66,1,37,0.9850746268656716,0.6407766990291263
2022,KHOUALKA,CITRUS VOLKAMERIANA,201210,IMG-00012-43.jpg,42,27,25,2,17,0.925925925925926,0.5952380952380952
2022,KHOUALKA,CITRUS VOLKAMERIANA,201210,IMG-00015-43.jpg,77,35,35,0,42,1.0,0.4545454545454545
2022,KHOUALKA,CITRUS VOLKAMERIANA,201210,IMG-00019-43.jpg,31,18,18,0,13,1.0,0.5806451612903226
2022,KHOUALKA,BIGARADIER,201320,IMG-00006-43.jpg,87,48,48,0,39,1.0,0.5517241379310345
2022,KHOUALKA,BIGARADIER,201320,IMG-00016-43.jpg,97,72,72,0,25,1.0,0.7422680412371134
2022,KHOUALKA,BIGARADIER,201320,IMG-00017-43.jpg,49,37,36,1,13,0.972972972972973,0.7346938775510204
2022,KHOUALKA,BIGARADIER,201320,IMG-00020-43.jpg,88,59,58,1,30,0.9830508474576272,0.6590909090909091
2022,ONAGRI,BIGARADIER,201390,IMG-00008-44.jpg,62,26,26,0,36,1.0,0.4193548387096774
2022,ONAGRI,BIGARADIER,201390,IMG-00011-44.jpg,90,40,37,3,53,0.925,0.4111111111111111
2022,ONAGRI,BIGARADIER,201390,IMG-00013-44.jpg,77,27,27,0,50,1.0,0.3506493506493507
2022,ONAGRI,BIGARADIER,201390,IMG-00016-44.jpg,69,24,24,0,45,1.0,0.3478260869565217
2022,KHOUALKA,CITRUS VOLKAMERIANA,202050,IMG-00006-43.jpg,89,45,45,0,44,1.0,0.5056179775280899
2022,KHOUALKA,CITRUS VOLKAMERIANA,202050,IMG-00010-43.jpg,94,52,52,0,42,1.0,0.5531914893617021
2022,KHOUALKA,CITRUS VOLKAMERIANA,202050,IMG-00011-43.jpg,151,84,83,1,68,0.988095238095238,0.5496688741721855
2022,KHOUALKA,CITRUS VOLKAMERIANA,202050,IMG-00020-43.jpg,129,60,60,0,69,1.0,0.4651162790697674
2022,KHOUALKA,CITRUS VOLKAMERIANA,202070,IMG-00006-43.jpg,68,35,35,0,33,1.0,0.5147058823529411
2022,KHOUALKA,CITRUS VOLKAMERIANA,202070,IMG-00009-43.jpg,120,58,57,1,63,0.9827586206896552,0.475
2022,KHOUALKA,CITRUS VOLKAMERIANA,202070,IMG-00013-43.jpg,95,47,47,0,48,1.0,0.4947368421052631
2022,KHOUALKA,CITRUS VOLKAMERIANA,202070,IMG-00019-43.jpg,57,36,36,0,21,1.0,0.631578947368421
2022,KHOUALKA,CITRUS VOLKAMERIANA,202080,IMG-00005-43.jpg,65,42,42,0,23,1.0,0.6461538461538462
2022,KHOUALKA,CITRUS VOLKAMERIANA,202080,IMG-00008-43.jpg,31,18,18,0,13,1.0,0.5806451612903226
2022,KHOUALKA,CITRUS VOLKAMERIANA,202080,IMG-00015-43.jpg,220,86,86,0,134,1.0,0.3909090909090909
2022,KHOUALKA,CITRUS VOLKAMERIANA,202080,IMG-00016-43.jpg,131,66,66,0,65,1.0,0.5038167938931297
2022,KHOUALKA,CITRANGE CARRIZO,301380,IMG-00007-43.jpg,30,15,14,1,16,0.9333333333333332,0.4666666666666667
2022,KHOUALKA,CITRANGE CARRIZO,301380,IMG-00011-43.jpg,53,41,41,0,12,1.0,0.7735849056603774
2022,KHOUALKA,CITRANGE CARRIZO,301380,IMG-00014-43.jpg,7,5,5,0,2,1.0,0.7142857142857143
2022,KHOUALKA,CITRANGE CARRIZO,301380,IMG-00020-43.jpg,91,49,49,0,42,1.0,0.5384615384615384
2022,ONAGRI,CITRUS VOLKAMERIANA,301470,IMG-00003-44.jpg,148,90,90,0,58,1.0,0.6081081081081081
2022,ONAGRI,CITRUS VOLKAMERIANA,301470,IMG-00004-44.jpg,163,64,63,1,100,0.984375,0.3865030674846626
2022,ONAGRI,CITRUS VOLKAMERIANA,301470,IMG-00005-44.jpg,160,58,58,0,102,1.0,0.3625
2022,ONAGRI,CITRUS VOLKAMERIANA,301480,IMG-00001.jpg,92,44,43,1,49,0.9772727272727272,0.4673913043478261
2022,ONAGRI,CITRUS VOLKAMERIANA,301480,IMG-00003-43.jpg,26,11,11,0,15,1.0,0.4230769230769231
2022,ONAGRI,CITRUS VOLKAMERIANA,301480,IMG-00012-43.jpg,50,24,24,0,26,1.0,0.48
2022,ONAGRI,CITRUS VOLKAMERIANA,301480,IMG-00014-43.jpg,77,40,40,0,37,1.0,0.5194805194805194
2022,ONAGRI,CITRUS VOLKAMERIANA,301490,IMG-00005-44.jpg,108,45,45,0,63,1.0,0.4166666666666667
2022,ONAGRI,CITRUS VOLKAMERIANA,301490,IMG-00009-44.jpg,185,72,71,1,114,0.9861111111111112,0.3837837837837838
2022,ONAGRI,CITRUS VOLKAMERIANA,301490,IMG-00012-44.jpg,162,71,71,0,91,1.0,0.4382716049382716
2022,ONAGRI,CITRUS VOLKAMERIANA,301490,IMG-00015-44.jpg,109,36,35,1,74,0.9722222222222222,0.3211009174311927
2022,ONAGRI,CITRUS VOLKAMERIANA,301510,IMG-00001.jpg,252,90,89,1,163,0.9888888888888888,0.3531746031746032
2022,ONAGRI,CITRUS VOLKAMERIANA,301510,IMG-00006-44.jpg,137,63,63,0,74,1.0,0.4598540145985401
2022,ONAGRI,CITRUS VOLKAMERIANA,301510,IMG-00007-44.jpg,115,42,40,2,75,0.9523809523809524,0.3478260869565217
2022,ONAGRI,CITRUS VOLKAMERIANA,301510,IMG-00008-44.jpg,150,77,75,2,75,0.974025974025974,0.5
2022,ONAGRI,BIGARADIER,301550,IMG-00008-44.jpg,144,77,77,0,67,1.0,0.5347222222222222
2022,ONAGRI,BIGARADIER,301550,IMG-00011-44.jpg,40,21,21,0,19,1.0,0.525
2022,ONAGRI,BIGARADIER,301550,IMG-00013-44.jpg,76,35,35,0,41,1.0,0.4605263157894737
2022,ONAGRI,BIGARADIER,301550,IMG-00014-44.jpg,80,33,29,4,51,0.8787878787878788,0.3625
2022,ONAGRI,CITRUS VOLKAMERIANA,301570,IMG-00004-44.jpg,158,73,73,0,85,1.0,0.4620253164556962
2022,ONAGRI,CITRUS VOLKAMERIANA,301570,IMG-00007-44.jpg,152,69,68,1,84,0.9855072463768116,0.4473684210526316
2022,ONAGRI,CITRUS VOLKAMERIANA,301570,IMG-00008-44.jpg,103,42,42,0,61,1.0,0.4077669902912621
2022,ONAGRI,CITRUS VOLKAMERIANA,301570,IMG-00017-44.jpg,218,84,83,1,135,0.988095238095238,0.3807339449541284
2022,KHOUALKA,CITRUS VOLKAMERIANA,302340,IMG-00004-43.jpg,106,52,52,0,54,1.0,0.4905660377358491
2022,KHOUALKA,CITRUS VOLKAMERIANA,302340,IMG-00005-43.jpg,105,57,57,0,48,1.0,0.5428571428571428
2022,KHOUALKA,CITRUS VOLKAMERIANA,302340,IMG-00011-43.jpg,75,33,33,0,42,1.0,0.44
2022,KHOUALKA,CITRUS VOLKAMERIANA,302340,IMG-00015-43.jpg,92,30,29,1,63,0.9666666666666668,0.3152173913043478
2022,KHOUALKA,CITRUS VOLKAMERIANA,302350,IMG-00008-43.jpg,33,21,21,0,12,1.0,0.6363636363636364
2022,KHOUALKA,CITRUS VOLKAMERIANA,302350,IMG-00013-43.jpg,80,42,40,2,40,0.9523809523809524,0.5
2022,KHOUALKA,CITRUS VOLKAMERIANA,302350,IMG-00014-43.jpg,76,34,34,0,42,1.0,0.4473684210526316
2022,KHOUALKA,CITRUS VOLKAMERIANA,302350,IMG-00018-43.jpg,44,28,28,0,16,1.0,0.6363636363636364
2022,KHOUALKA,CITRUS VOLKAMERIANA,302360,IMG-00005-43.jpg,97,37,37,0,60,1.0,0.3814432989690721
2022,KHOUALKA,CITRUS VOLKAMERIANA,302360,IMG-00006-43.jpg,118,37,37,0,81,1.0,0.3135593220338983
2022,KHOUALKA,CITRUS VOLKAMERIANA,302360,IMG-00016-43.jpg,67,28,28,0,39,1.0,0.417910447761194
2022,KHOUALKA,CITRUS VOLKAMERIANA,302360,IMG-00021-43.jpg,65,35,33,2,32,0.9428571428571428,0.5076923076923077
2022,KHOUALKA,CITRUS VOLKAMERIANA,302510,IMG-00001.jpg,73,34,34,0,39,1.0,0.4657534246575342
2022,KHOUALKA,CITRUS VOLKAMERIANA,302510,IMG-00002-43.jpg,44,18,18,0,26,1.0,0.4090909090909091
2022,KHOUALKA,CITRUS VOLKAMERIANA,302510,IMG-00003-43.jpg,78,47,46,1,32,0.9787234042553192,0.5897435897435898
2022,KHOUALKA,CITRUS VOLKAMERIANA,302510,IMG-00015-43.jpg,49,23,23,0,26,1.0,0.4693877551020408
2022,KHOUALKA,BIGARADIER,401410,IMG-00093-43.jpg,35,15,15,0,20,1.0,0.4285714285714285
2022,KHOUALKA,BIGARADIER,401410,IMG-00099-43.jpg,6,3,3,0,3,1.0,0.5
2022,KHOUALKA,BIGARADIER,401410,IMG-00102-43.jpg,78,31,30,1,48,0.967741935483871,0.3846153846153846
2022,KHOUALKA,BIGARADIER,401410,IMG-00104-43.jpg,81,31,30,1,51,0.967741935483871,0.3703703703703703
2022,ONAGRI,CITRANGE C35,401660,IMG-00001.jpg,56,36,35,1,21,0.9722222222222222,0.625
2022,ONAGRI,CITRANGE C35,401660,IMG-00008-44.jpg,42,28,28,0,14,1.0,0.6666666666666666
2022,ONAGRI,CITRANGE C35,401660,IMG-00010-44.jpg,29,20,18,2,11,0.9,0.6206896551724138
2022,ONAGRI,CITRANGE C35,401660,IMG-00016-44.jpg,64,44,44,0,20,1.0,0.6875
2022,ONAGRI,CITRANGE C35,401710,IMG-00003-44.jpg,51,28,28,0,23,1.0,0.5490196078431373
2022,ONAGRI,CITRANGE C35,401710,IMG-00012-44.jpg,19,16,14,2,5,0.875,0.7368421052631579
2022,ONAGRI,CITRANGE C35,401710,IMG-00013-44.jpg,33,26,24,2,9,0.9230769230769232,0.7272727272727273
2022,ONAGRI,CITRANGE C35,401710,IMG-00019-44.jpg,76,52,52,0,24,1.0,0.6842105263157895
2022,ONAGRI,CITRANGE C35,401720,IMG-00007-44.jpg,93,65,64,1,29,0.9846153846153848,0.6881720430107527
2022,ONAGRI,CITRANGE C35,401720,IMG-00008-44.jpg,38,26,25,1,13,0.9615384615384616,0.6578947368421053
2022,ONAGRI,CITRANGE C35,401720,IMG-00010-44.jpg,50,23,23,0,27,1.0,0.46
2022,ONAGRI,CITRANGE C35,401720,IMG-00017-44.jpg,68,44,44,0,24,1.0,0.6470588235294118
2022,ONAGRI,CITRANGE C35,401730,IMG-00001.jpg,19,14,13,1,6,0.9285714285714286,0.6842105263157895
2022,ONAGRI,CITRANGE C35,401730,IMG-00010-44.jpg,50,34,33,1,17,0.9705882352941176,0.66
2022,ONAGRI,CITRANGE C35,401730,IMG-00013-44.jpg,75,61,60,1,15,0.9836065573770492,0.8
2022,ONAGRI,CITRANGE C35,401730,IMG-00016-44.jpg,36,24,24,0,12,1.0,0.6666666666666666
2022,ONAGRI,CITRANGE C35,401750,IMG-00005-44.jpg,88,36,36,0,52,1.0,0.4090909090909091
2022,ONAGRI,CITRANGE C35,401750,IMG-00009-44.jpg,127,63,62,1,65,0.984126984126984,0.4881889763779528
2022,ONAGRI,CITRANGE C35,401750,IMG-00016-44.jpg,107,60,60,0,47,1.0,0.5607476635514018
2022,ONAGRI,CITRANGE C35,401750,IMG-00024-44.jpg,50,26,26,0,24,1.0,0.52
2022,ONAGRI,CITRUMELO SACCATON,401770,IMG-00003-44.jpg,24,15,15,0,9,1.0,0.625
2022,ONAGRI,CITRUMELO SACCATON,401770,IMG-00008-44.jpg,72,45,44,1,28,0.9777777777777776,0.6111111111111112
2022,ONAGRI,CITRUMELO SACCATON,401770,IMG-00009-44.jpg,14,10,9,1,5,0.9,0.6428571428571429
2022,ONAGRI,CITRUMELO SACCATON,401770,IMG-00017-44.jpg,20,13,12,1,8,0.9230769230769232,0.6
2022,KHOUALKA,BIGARADIER,402440,IMG-00005-43.jpg,17,4,3,1,14,0.75,0.1764705882352941
2022,KHOUALKA,BIGARADIER,402440,IMG-00012-43.jpg,46,22,22,0,24,1.0,0.4782608695652174
2022,KHOUALKA,BIGARADIER,402440,IMG-00014-43.jpg,11,4,4,0,7,1.0,0.3636363636363636
2022,KHOUALKA,BIGARADIER,402440,IMG-00015-43.jpg,22,4,4,0,18,1.0,0.1818181818181818
2022,KHOUALKA,BIGARADIER,402590,IMG-00007-43.jpg,104,46,46,0,58,1.0,0.4423076923076923
2022,KHOUALKA,BIGARADIER,402590,IMG-00012-43.jpg,45,25,24,1,21,0.96,0.5333333333333333
2022,KHOUALKA,BIGARADIER,402590,IMG-00015-43.jpg,58,35,34,1,24,0.9714285714285714,0.5862068965517241
2022,KHOUALKA,BIGARADIER,402590,IMG-00019-43.jpg,64,45,45,0,19,1.0,0.703125
2022,KHOUALKA,CITRUS VOLKAMERIANA,501520,IMG-00004-43.jpg,39,12,12,0,27,1.0,0.3076923076923077
2022,KHOUALKA,CITRUS VOLKAMERIANA,501520,IMG-00007-43.jpg,43,21,20,1,23,0.9523809523809524,0.4651162790697674
2022,KHOUALKA,CITRUS VOLKAMERIANA,501520,IMG-00015-43.jpg,18,7,7,0,11,1.0,0.3888888888888889
2022,KHOUALKA,CITRUS VOLKAMERIANA,501520,IMG-00020-43.jpg,48,25,25,0,23,1.0,0.5208333333333334
2022,KHOUALKA,CITRUS VOLKAMERIANA,501540,IMG-00006-43.jpg,38,25,25,0,13,1.0,0.6578947368421053
2022,KHOUALKA,CITRUS VOLKAMERIANA,501540,IMG-00012-43.jpg,102,60,60,0,42,1.0,0.5882352941176471
2022,KHOUALKA,CITRUS VOLKAMERIANA,501540,IMG-00017-43.jpg,138,49,49,0,89,1.0,0.355072463768116
2022,KHOUALKA,CITRUS VOLKAMERIANA,501540,IMG-00018-43.jpg,51,26,24,2,27,0.9230769230769232,0.4705882352941176
2022,KHOUALKA,CITRUS VOLKAMERIANA,501660,IMG-00006-43.jpg,60,37,35,2,25,0.945945945945946,0.5833333333333334
2022,KHOUALKA,CITRUS VOLKAMERIANA,501660,IMG-00016-43.jpg,63,34,34,0,29,1.0,0.5396825396825397
2022,KHOUALKA,CITRUS VOLKAMERIANA,501660,IMG-00018-43.jpg,112,52,52,0,60,1.0,0.4642857142857143
2022,KHOUALKA,CITRUS VOLKAMERIANA,501660,IMG-00021-43.jpg,90,49,49,0,41,1.0,0.5444444444444444
2022,KHOUALKA,CITRUS VOLKAMERIANA,501680,IMG-00005-43.jpg,179,81,80,1,99,0.9876543209876544,0.446927374301676
2022,KHOUALKA,CITRUS VOLKAMERIANA,501680,IMG-00011-43.jpg,101,38,38,0,63,1.0,0.3762376237623762
2022,KHOUALKA,CITRUS VOLKAMERIANA,501680,IMG-00012-43.jpg,76,27,27,0,49,1.0,0.3552631578947368
2022,KHOUALKA,CITRUS VOLKAMERIANA,501680,IMG-00016-43.jpg,113,64,64,0,49,1.0,0.5663716814159292
2022,KHOUALKA,CITRUS VOLKAMERIANA,501690,IMG-00032-43.jpg,34,11,11,0,23,1.0,0.3235294117647059
2022,KHOUALKA,CITRUS VOLKAMERIANA,501690,IMG-00039-43.jpg,186,89,88,1,98,0.9887640449438202,0.4731182795698925
2022,KHOUALKA,CITRUS VOLKAMERIANA,501690,IMG-00047-43.jpg,103,39,39,0,64,1.0,0.3786407766990291
2022,KHOUALKA,CITRUS VOLKAMERIANA,501690,IMG-00049-43.jpg,166,75,75,0,91,1.0,0.4518072289156627
2022,KHOUALKA,CITRUS VOLKAMERIANA,501760,IMG-00001.jpg,94,31,31,0,63,1.0,0.3297872340425532
2022,KHOUALKA,CITRUS VOLKAMERIANA,501760,IMG-00034-43.jpg,45,8,8,0,37,1.0,0.1777777777777778
2022,KHOUALKA,CITRUS VOLKAMERIANA,501760,IMG-00036-43.jpg,40,16,16,0,24,1.0,0.4
2022,KHOUALKA,CITRUS VOLKAMERIANA,501760,IMG-00051-43.jpg,92,24,24,0,68,1.0,0.2608695652173913
2022,ONAGRI,CITRUMELO SACCATON,510910,IMG-00004-44.jpg,73,49,49,0,24,1.0,0.6712328767123288
2022,ONAGRI,CITRUMELO SACCATON,510910,IMG-00008-44.jpg,152,76,75,1,77,0.986842105263158,0.4934210526315789
2022,ONAGRI,CITRUMELO SACCATON,510910,IMG-00010-44.jpg,107,59,58,1,49,0.9830508474576272,0.5420560747663551
2022,ONAGRI,CITRUMELO SACCATON,510910,IMG-00011-44.jpg,92,57,55,2,37,0.9649122807017544,0.5978260869565217
2022,ONAGRI,CITRUMELO SACCATON,510950,IMG-00006-44.jpg,70,47,47,0,23,1.0,0.6714285714285714
2022,ONAGRI,CITRUMELO SACCATON,510950,IMG-00008-44.jpg,75,44,44,0,31,1.0,0.5866666666666667
2022,ONAGRI,CITRUMELO SACCATON,510950,IMG-00009-44.jpg,85,51,48,3,37,0.9411764705882352,0.5647058823529412
2022,ONAGRI,CITRUMELO SACCATON,510950,IMG-00011-44.jpg,135,85,84,1,51,0.9882352941176472,0.6222222222222222
2022,ONAGRI,MC PONSIRUCE TRIFOLIATA,510980,IMG-00014-44.jpg,67,40,39,1,28,0.975,0.582089552238806
2022,ONAGRI,MC PONSIRUCE TRIFOLIATA,510980,IMG-00015-44.jpg,51,36,35,1,16,0.9722222222222222,0.6862745098039216
2022,ONAGRI,MC PONSIRUCE TRIFOLIATA,510980,IMG-00016-44.jpg,99,58,58,0,41,1.0,0.5858585858585859
2022,ONAGRI,MC PONSIRUCE TRIFOLIATA,510980,IMG-00019-44.jpg,102,58,57,1,45,0.9827586206896552,0.5588235294117647
2022,ONAGRI,MC PONSIRUCE TRIFOLIATA,510990,IMG-00006-44.jpg,135,85,83,2,52,0.976470588235294,0.6148148148148148
2022,ONAGRI,MC PONSIRUCE TRIFOLIATA,510990,IMG-00008-44.jpg,110,76,76,0,34,1.0,0.6909090909090909
2022,ONAGRI,MC PONSIRUCE TRIFOLIATA,510990,IMG-00009-44.jpg,85,57,56,1,29,0.9824561403508772,0.6588235294117647
2022,ONAGRI,MC PONSIRUCE TRIFOLIATA,510990,IMG-00024-44.jpg,65,36,36,0,29,1.0,0.5538461538461539
2022,ONAGRI,MC PONSIRUCE TRIFOLIATA,511030,IMG-00007-44.jpg,100,80,78,2,22,0.975,0.78
2022,ONAGRI,MC PONSIRUCE TRIFOLIATA,511030,IMG-00016-44.jpg,63,46,46,0,17,1.0,0.7301587301587301
2022,ONAGRI,MC PONSIRUCE TRIFOLIATA,511030,IMG-00022-44.jpg,98,73,72,1,26,0.9863013698630136,0.7346938775510204
2022,ONAGRI,MC PONSIRUCE TRIFOLIATA,511030,IMG-00027-44.jpg,82,62,62,0,20,1.0,0.7560975609756098
2022,ONAGRI,MS PONSIRUCE TRIFOLIATA,511040,IMG-00004-44.jpg,77,57,56,1,21,0.9824561403508772,0.7272727272727273
2022,ONAGRI,MS PONSIRUCE TRIFOLIATA,511040,IMG-00014-44.jpg,48,31,30,1,18,0.967741935483871,0.625
2022,ONAGRI,MS PONSIRUCE TRIFOLIATA,511040,IMG-00016-44.jpg,71,45,45,0,26,1.0,0.6338028169014085
2022,ONAGRI,MS PONSIRUCE TRIFOLIATA,511040,IMG-00025-44.jpg,56,35,33,2,23,0.9428571428571428,0.5892857142857143
2022,ONAGRI,FUZHU,511050,IMG-00004-44.jpg,109,55,53,2,56,0.9636363636363636,0.4862385321100918
2022,ONAGRI,FUZHU,511050,IMG-00006-44.jpg,142,77,77,0,65,1.0,0.5422535211267606
2022,ONAGRI,FUZHU,511050,IMG-00011-44.jpg,172,121,121,0,51,1.0,0.7034883720930233
2022,ONAGRI,FUZHU,511050,IMG-00022-44.jpg,194,127,126,1,68,0.9921259842519684,0.6494845360824743
2022,ONAGRI,MS PONSIRUCE TRIFOLIATA,511060,IMG-00007-44.jpg,115,74,74,0,41,1.0,0.6434782608695652
2022,ONAGRI,MS PONSIRUCE TRIFOLIATA,511060,IMG-00016-44.jpg,102,61,59,2,43,0.9672131147540984,0.5784313725490197
2022,ONAGRI,MS PONSIRUCE TRIFOLIATA,511060,IMG-00017-44.jpg,59,29,29,0,30,1.0,0.4915254237288136
2022,ONAGRI,MS PONSIRUCE TRIFOLIATA,511060,IMG-00019-44.jpg,108,63,62,1,46,0.984126984126984,0.5740740740740741
2022,ONAGRI,FUZHU,511070,IMG-00006-44.jpg,82,65,63,2,19,0.9692307692307692,0.7682926829268293
2022,ONAGRI,FUZHU,511070,IMG-00016-44.jpg,96,58,57,1,39,0.9827586206896552,0.59375
2022,ONAGRI,FUZHU,511070,IMG-00018-44.jpg,93,56,56,0,37,1.0,0.6021505376344086
2022,ONAGRI,FUZHU,511070,IMG-00019-44.jpg,142,85,84,1,58,0.9882352941176472,0.5915492957746479
