compagnie,Domaine,Porte-greffe,parcelle,Filename,True_count,detect_count,TP,FP,FN,Precision,Recall
2022,SAOUDA,BIGARADIER,10010,IMG-00011-45.jpg,28,27,26,1,2,0.9629629629629628,0.9285714285714286
2022,SAOUDA,BIGARADIER,10010,IMG-00012-45.jpg,27,26,25,1,2,0.9615384615384616,0.925925925925926
2022,SAOUDA,BIGARADIER,10010,IMG-00014-45.jpg,50,51,46,5,4,0.9019607843137256,0.92
2022,SAOUDA,BIGARADIER,10010,IMG-00018-45.jpg,30,29,27,2,3,0.9310344827586208,0.9
2022,SAOUDA,BIGARADIER,10010,IMG-00020-45.jpg,31,32,28,4,3,0.875,0.9032258064516128
2024,SAOUDA,BIGARADIER,10010,IMG-23410.jpg,85,70,69,1,16,0.9857142857142858,0.8117647058823529
2024,SAOUDA,BIGARADIER,10010,IMG-23417.jpg,86,67,66,1,20,0.9850746268656716,0.7674418604651163
2024,SAOUDA,BIGARADIER,10010,IMG-23430.jpg,74,64,64,0,10,1.0,0.8648648648648649
2024,SAOUDA,BIGARADIER,10010,IMG-23647.jpg,95,86,84,2,11,0.9767441860465116,0.8842105263157894
2024,SAOUDA,BIGARADIER,10010,IMG-23672.jpg,47,36,36,0,11,1.0,0.7659574468085106
2024,SAOUDA,BIGARADIER,10010,IMG-23707.jpg,30,26,26,0,4,1.0,0.8666666666666667
2024,SAOUDA,BIGARADIER,10010,IMG-23709.jpg,31,24,24,0,7,1.0,0.7741935483870968
2024,SAOUDA,BIGARADIER,10010,IMG-23711.jpg,79,64,61,3,18,0.953125,0.7721518987341772
2022,SAOUDA,MACROPHYLLA,10030,IMG-00158-45.jpg,101,102,94,8,7,0.9215686274509804,0.9306930693069309
2022,SAOUDA,MACROPHYLLA,10030,IMG-00159-45.jpg,155,152,142,10,13,0.9342105263157896,0.9161290322580644
2022,SAOUDA,MACROPHYLLA,10030,IMG-00162-45.jpg,119,119,111,8,8,0.9327731092436976,0.9327731092436976
2022,SAOUDA,MACROPHYLLA,10030,IMG-00169-45.jpg,72,73,68,5,4,0.9315068493150684,0.9444444444444444
2022,SAOUDA,MACROPHYLLA,10031,IMG-00002-45.jpg,46,45,41,4,5,0.9111111111111112,0.8913043478260869
2022,SAOUDA,MACROPHYLLA,10031,IMG-00084-45.jpg,41,41,37,4,4,0.902439024390244,0.902439024390244
2022,SAOUDA,MACROPHYLLA,10031,IMG-00450-45.jpg,27,30,25,5,2,0.8333333333333334,0.925925925925926
2022,SAOUDA,MACROPHYLLA,10031,IMG-00451-45.jpg,34,33,28,5,6,0.8484848484848485,0.8235294117647058
2022,SAOUDA,MACROPHYLLA,10031,IMG-00464-45.jpg,33,33,31,2,2,0.9393939393939394,0.9393939393939394
2022,ONAGRI,CITRUS VOLKAMERIANA,10101,IMG-00003-39.jpg,120,116,111,5,9,0.956896551724138,0.925
2022,ONAGRI,CITRUS VOLKAMERIANA,10101,IMG-00010-39.jpg,85,73,69,4,16,0.9452054794520548,0.8117647058823529
2024,ONAGRI,CITRUS VOLKAMERIANA,10101,IMG-10523.jpg,288,269,265,4,23,0.9851301115241636,0.9201388888888888
2024,ONAGRI,CITRUS VOLKAMERIANA,10101,IMG-10545.jpg,98,93,90,3,8,0.967741935483871,0.9183673469387756
2024,ONAGRI,CITRUS VOLKAMERIANA,10101,IMG-10558.jpg,143,137,130,7,13,0.948905109489051,0.9090909090909092
2022,ONAGRI,CITRUS VOLKAMERIANA,10102,IMG-00003-39.jpg,48,35,34,1,14,0.9714285714285714,0.7083333333333334
2024,ONAGRI,CITRUS VOLKAMERIANA,10102,IMG-10637.jpg,140,141,130,11,10,0.9219858156028368,0.9285714285714286
2024,ONAGRI,CITRUS VOLKAMERIANA,10102,IMG-10658.jpg,163,155,147,8,16,0.9483870967741936,0.901840490797546
2022,ONAGRI,CITRUS VOLKAMERIANA,10103,IMG-00003-39.jpg,215,182,176,6,39,0.967032967032967,0.8186046511627907
2022,ONAGRI,CITRUS VOLKAMERIANA,10103,IMG-00008-39.jpg,195,182,171,11,24,0.9395604395604396,0.8769230769230769
2024,ONAGRI,CITRUS VOLKAMERIANA,10103,IMG-10614.jpg,134,137,126,11,8,0.9197080291970804,0.9402985074626866
2024,ONAGRI,CITRUS VOLKAMERIANA,10103,IMG-10630.jpg,213,205,193,12,20,0.9414634146341464,0.9061032863849764
2024,ONAGRI,CITRUS VOLKAMERIANA,10103,IMG-10631.jpg,134,124,119,5,15,0.9596774193548387,0.8880597014925373
2022,ONAGRI,CITRUS VOLKAMERIANA,10104,IMG-00004-39.jpg,65,65,57,8,8,0.8769230769230769,0.8769230769230769
2022,ONAGRI,CITRUS VOLKAMERIANA,10104,IMG-00008-39.jpg,69,63,55,8,14,0.873015873015873,0.7971014492753623
2024,ONAGRI,CITRUS VOLKAMERIANA,10104,IMG-11267.jpg,22,16,16,0,6,1.0,0.7272727272727273
2024,ONAGRI,CITRUS VOLKAMERIANA,10104,IMG-11327.jpg,128,118,114,4,14,0.9661016949152542,0.890625
2024,ONAGRI,CITRUS VOLKAMERIANA,10104,IMG-11347.jpg,118,114,107,7,11,0.9385964912280702,0.9067796610169492
2024,ONAGRI,CITRUS VOLKAMERIANA,10104,IMG-11366.jpg,351,300,293,7,58,0.9766666666666668,0.8347578347578347
2024,ONAGRI,CITRUS VOLKAMERIANA,10104,IMG-11386.jpg,99,92,87,5,12,0.9456521739130436,0.8787878787878788
2022,ONAGRI,CITRUS VOLKAMERIANA,10105,IMG-00004-39.jpg,17,17,13,4,4,0.7647058823529411,0.7647058823529411
2022,ONAGRI,CITRUS VOLKAMERIANA,10105,IMG-00005-39.jpg,68,69,61,8,7,0.8840579710144928,0.8970588235294118
2022,ONAGRI,CITRUS VOLKAMERIANA,10108,IMG-00003-39.jpg,61,53,51,2,10,0.9622641509433962,0.8360655737704918
2022,ONAGRI,CITRUS VOLKAMERIANA,10108,IMG-00007-39.jpg,69,53,53,0,16,1.0,0.7681159420289855
2022,ONAGRI,CITRUS VOLKAMERIANA,10109,IMG-00003-39.jpg,4,4,4,0,0,1.0,1.0
2022,ONAGRI,CITRUS VOLKAMERIANA,10109,IMG-00008-39.jpg,105,102,95,7,10,0.931372549019608,0.9047619047619048
2022,KHOUALKA,CITRANGE CARRIZO,10213,IMG-00001.jpg,77,78,72,6,5,0.9230769230769232,0.935064935064935
2022,KHOUALKA,CITRANGE CARRIZO,10213,IMG-00005-40.jpg,73,73,71,2,2,0.9726027397260274,0.9726027397260274
2022,KHOUALKA,CITRANGE CARRIZO,10213,IMG-00009-40.jpg,14,16,13,3,1,0.8125,0.9285714285714286
2022,KHOUALKA,CITRANGE CARRIZO,10213,IMG-00014-40.jpg,21,19,17,2,4,0.8947368421052632,0.8095238095238095
2022,KHOUALKA,CITRANGE CARRIZO,10213,IMG-00028-40.jpg,47,50,46,4,1,0.92,0.9787234042553192
2022,KHOUALKA,CITRANGE CARRIZO,10213,IMG-00034-40.jpg,48,48,47,1,1,0.9791666666666666,0.9791666666666666
2022,KHOUALKA,CITRANGE CARRIZO,10213,IMG-00035-40.jpg,37,38,36,2,1,0.9473684210526316,0.972972972972973
2022,KHOUALKA,CITRANGE CARRIZO,10213,IMG-00036-40.jpg,47,53,46,7,1,0.8679245283018868,0.9787234042553192
2022,KHOUALKA,CITRANGE CARRIZO,10213,IMG-00042-40.jpg,22,23,22,1,0,0.9565217391304348,1.0
2022,KHOUALKA,CITRANGE CARRIZO,10213,IMG-00047-40.jpg,70,67,67,0,3,1.0,0.9571428571428572
2022,KHOUALKA,CITRANGE CARRIZO,10213,IMG-00054-40.jpg,33,38,33,5,0,0.868421052631579,1.0
2022,KHOUALKA,CITRANGE CARRIZO,10213,IMG-00055-40.jpg,93,89,88,1,5,0.9887640449438202,0.946236559139785
2022,KHOUALKA,CITRANGE CARRIZO,10213,IMG-00061-40.jpg,113,119,111,8,2,0.9327731092436976,0.9823008849557522
2022,KHOUALKA,CITRANGE CARRIZO,10213,IMG-00066-40.jpg,48,47,43,4,5,0.9148936170212766,0.8958333333333334
2024,KHOUALKA,CITRANGE CARRIZO,10213,IMG-12628.jpg,119,111,109,2,10,0.981981981981982,0.9159663865546218
2024,KHOUALKA,CITRANGE CARRIZO,10213,IMG-12774.jpg,118,106,104,2,14,0.981132075471698,0.8813559322033898
2024,KHOUALKA,CITRANGE CARRIZO,10213,IMG-12780.jpg,44,42,40,2,4,0.9523809523809524,0.9090909090909092
2024,KHOUALKA,CITRANGE CARRIZO,10213,IMG-12791.jpg,166,147,143,4,23,0.9727891156462584,0.8614457831325302
2024,KHOUALKA,CITRANGE CARRIZO,10213,IMG-12834.jpg,57,54,51,3,6,0.9444444444444444,0.8947368421052632
2024,KHOUALKA,CITRANGE CARRIZO,10213,IMG-12945.jpg,130,123,120,3,10,0.975609756097561,0.9230769230769232
2022,OUARGHA,MACROPHYLLA,11010,IMG-00001.jpg,40,36,36,0,4,1.0,0.9
2022,OUARGHA,MACROPHYLLA,11010,IMG-00015-41.jpg,24,24,20,4,4,0.8333333333333334,0.8333333333333334
2022,OUARGHA,MACROPHYLLA,11010,IMG-00019-41.jpg,20,22,19,3,1,0.8636363636363636,0.95
2022,OUARGHA,MACROPHYLLA,11010,IMG-00024-41.jpg,21,22,21,1,0,0.9545454545454546,1.0
2022,OUARGHA,MACROPHYLLA,11020,IMG-00017-41.jpg,51,56,50,6,1,0.8928571428571429,0.9803921568627452
2022,OUARGHA,MACROPHYLLA,11020,IMG-00018-41.jpg,13,14,12,2,1,0.8571428571428571,0.9230769230769232
2022,OUARGHA,CITRANGE CARRIZO,13010,IMG-00067-41.jpg,55,52,50,2,5,0.9615384615384616,0.9090909090909092
2022,OUARGHA,CITRANGE CARRIZO,13010,IMG-00086-41.jpg,49,50,47,3,2,0.94,0.9591836734693876
2022,OUARGHA,CITRANGE CARRIZO,13010,IMG-00194-41.jpg,33,34,32,2,1,0.9411764705882352,0.9696969696969696
2022,OUARGHA,CITRANGE CARRIZO,13020,IMG-00023-41.jpg,31,28,28,0,3,1.0,0.9032258064516128
2022,OUARGHA,CITRANGE CARRIZO,13020,IMG-00024-41.jpg,18,17,16,1,2,0.9411764705882352,0.8888888888888888
2022,OUARGHA,CITRANGE CARRIZO,13020,IMG-00039-41.jpg,4,5,3,2,1,0.6,0.75
2022,OUARGHA,CITRANGE CARRIZO,13020,IMG-00040-41.jpg,6,8,6,2,0,0.75,1.0
2022,OUARGHA,CITRUS VOLKAMERIANA,13030,IMG-00009-41.jpg,18,18,16,2,2,0.8888888888888888,0.8888888888888888
2022,OUARGHA,CITRUS VOLKAMERIANA,13030,IMG-00013-41.jpg,46,45,42,3,4,0.9333333333333332,0.9130434782608696
2022,OUARGHA,CITRUS VOLKAMERIANA,13030,IMG-00027-41.jpg,12,11,10,1,2,0.9090909090909092,0.8333333333333334
2022,OUARGHA,CITRUS VOLKAMERIANA,13030,IMG-00029-41.jpg,18,19,17,2,1,0.8947368421052632,0.9444444444444444
2022,OUARGHA,CITRUS VOLKAMERIANA,13030,IMG-00036-41.jpg,16,19,15,4,1,0.7894736842105263,0.9375
2022,OUARGHA,CITRUS VOLKAMERIANA,14010,IMG-00008-41.jpg,40,39,36,3,4,0.9230769230769232,0.9
2022,OUARGHA,CITRUS VOLKAMERIANA,14010,IMG-00010-41.jpg,49,48,46,2,3,0.9583333333333334,0.9387755102040816
2022,OUARGHA,CITRUS VOLKAMERIANA,14010,IMG-00011-41.jpg,47,48,46,2,1,0.9583333333333334,0.9787234042553192
2022,OUARGHA,CITRUS VOLKAMERIANA,14010,IMG-00018-41.jpg,44,43,40,3,4,0.9302325581395348,0.9090909090909092
2022,KHOUALKA,MACROPHYLLA,20118,IMG-00007-40.jpg,44,45,41,4,3,0.9111111111111112,0.9318181818181818
2022,KHOUALKA,MACROPHYLLA,20118,IMG-00008-40.jpg,115,117,111,6,4,0.9487179487179488,0.9652173913043478
2022,KHOUALKA,MACROPHYLLA,20118,IMG-00022-40.jpg,113,108,106,2,7,0.9814814814814816,0.9380530973451328
2022,KHOUALKA,MACROPHYLLA,20118,IMG-00033-40.jpg,58,60,57,3,1,0.95,0.9827586206896552
2022,KHOUALKA,MACROPHYLLA,20118,IMG-00037-40.jpg,29,30,27,3,2,0.9,0.9310344827586208
2022,KHOUALKA,MACROPHYLLA,20118,IMG-00042-40.jpg,137,137,131,6,6,0.9562043795620438,0.9562043795620438
2022,KHOUALKA,MACROPHYLLA,20118,IMG-00046-40.jpg,45,49,45,4,0,0.9183673469387756,1.0
2022,KHOUALKA,MACROPHYLLA,20118,IMG-00050-40.jpg,48,46,45,1,3,0.9782608695652174,0.9375
2022,KHOUALKA,MACROPHYLLA,20118,IMG-00055-40.jpg,52,51,49,2,3,0.9607843137254902,0.9423076923076924
2022,KHOUALKA,MACROPHYLLA,20118,IMG-00061-40.jpg,120,128,114,14,6,0.890625,0.95
2022,KHOUALKA,MACROPHYLLA,20118,IMG-00062-40.jpg,63,63,58,5,5,0.9206349206349206,0.9206349206349206
2022,KHOUALKA,MACROPHYLLA,20118,IMG-00063-40.jpg,47,52,45,7,2,0.8653846153846154,0.9574468085106383
2022,KHOUALKA,MACROPHYLLA,20118,IMG-00066-40.jpg,84,89,81,8,3,0.9101123595505618,0.9642857142857144
2024,KHOUALKA,MACROPHYLLA,20118,IMG-12691.jpg,22,15,15,0,7,1.0,0.6818181818181818
2024,KHOUALKA,MACROPHYLLA,20118,IMG-12729.jpg,56,48,48,0,8,1.0,0.8571428571428571
2024,KHOUALKA,MACROPHYLLA,20118,IMG-12735.jpg,88,76,73,3,15,0.9605263157894736,0.8295454545454546
2024,KHOUALKA,MACROPHYLLA,20118,IMG-12748.jpg,107,105,98,7,9,0.9333333333333332,0.9158878504672896
2024,KHOUALKA,MACROPHYLLA,20118,IMG-12764.jpg,111,106,100,6,11,0.9433962264150944,0.9009009009009008
2024,KHOUALKA,MACROPHYLLA,20118,IMG-12808.jpg,113,96,93,3,20,0.96875,0.8230088495575221
2024,KHOUALKA,MACROPHYLLA,20118,IMG-12851.jpg,24,16,15,1,9,0.9375,0.625
2022,KHOUALKA,MACROPHYLLA,20119,IMG-00005-40.jpg,106,105,96,9,10,0.9142857142857144,0.9056603773584906
2022,KHOUALKA,MACROPHYLLA,20119,IMG-00008-40.jpg,142,147,133,14,9,0.9047619047619048,0.9366197183098592
2022,KHOUALKA,MACROPHYLLA,20119,IMG-00014-40.jpg,132,128,122,6,10,0.953125,0.9242424242424242
2022,KHOUALKA,BIGARADIER,20132,IMG-00004-40.jpg,181,177,173,4,8,0.9774011299435028,0.9558011049723756
2022,KHOUALKA,BIGARADIER,20132,IMG-00025-40.jpg,91,91,83,8,8,0.912087912087912,0.912087912087912
2022,KHOUALKA,BIGARADIER,20132,IMG-00028-40.jpg,49,48,44,4,5,0.9166666666666666,0.8979591836734694
2022,KHOUALKA,BIGARADIER,20132,IMG-00035-40.jpg,103,112,103,9,0,0.9196428571428572,1.0
2022,KHOUALKA,BIGARADIER,20132,IMG-00039-40.jpg,119,124,116,8,3,0.935483870967742,0.9747899159663864
2022,KHOUALKA,BIGARADIER,20132,IMG-00046-40.jpg,156,156,151,5,5,0.967948717948718,0.967948717948718
2022,KHOUALKA,BIGARADIER,20132,IMG-00051-40.jpg,108,104,100,4,8,0.9615384615384616,0.925925925925926
2022,KHOUALKA,BIGARADIER,20132,IMG-00055-40.jpg,67,64,61,3,6,0.953125,0.9104477611940298
2022,KHOUALKA,BIGARADIER,20132,IMG-00058-40.jpg,89,87,86,1,3,0.9885057471264368,0.9662921348314608
2022,KHOUALKA,BIGARADIER,20132,IMG-00059-40.jpg,139,135,130,5,9,0.9629629629629628,0.935251798561151
2022,KHOUALKA,BIGARADIER,20132,IMG-00060-40.jpg,57,53,51,2,6,0.9622641509433962,0.8947368421052632
2022,KHOUALKA,BIGARADIER,20132,IMG-00064-40.jpg,117,118,110,8,7,0.9322033898305084,0.9401709401709402
2022,KHOUALKA,BIGARADIER,20132,IMG-00075-40.jpg,69,73,69,4,0,0.9452054794520548,1.0
2022,ONAGRI,BIGARADIER,20139,IMG-00021-39.jpg,93,89,83,6,10,0.9325842696629212,0.8924731182795699
2024,KHOUALKA,CITRUS VOLKAMERIANA,20205,IMG-12040.jpg,123,118,111,7,12,0.940677966101695,0.902439024390244
2024,KHOUALKA,CITRUS VOLKAMERIANA,20205,IMG-12058.jpg,116,118,112,6,4,0.9491525423728814,0.9655172413793104
2024,KHOUALKA,CITRUS VOLKAMERIANA,20207,IMG-11892.jpg,94,84,77,7,17,0.9166666666666666,0.8191489361702128
2024,KHOUALKA,CITRUS VOLKAMERIANA,20207,IMG-11921.jpg,264,239,230,9,34,0.9623430962343096,0.8712121212121212
2024,KHOUALKA,CITRUS VOLKAMERIANA,20207,IMG-11927.jpg,195,176,167,9,28,0.9488636363636364,0.8564102564102564
2024,KHOUALKA,CITRUS VOLKAMERIANA,20207,IMG-11961.jpg,113,97,97,0,16,1.0,0.8584070796460177
2024,KHOUALKA,CITRUS VOLKAMERIANA,20207,IMG-11972.jpg,94,86,81,5,13,0.9418604651162792,0.8617021276595744
2024,KHOUALKA,CITRUS VOLKAMERIANA,20207,IMG-11981.jpg,81,72,67,5,14,0.9305555555555556,0.8271604938271605
2022,SAOUDA,CITRUS VOLKAMERIANA,21020,IMG-00033-45.jpg,67,70,63,7,4,0.9,0.9402985074626866
2022,SAOUDA,CITRUS VOLKAMERIANA,21020,IMG-00087-45.jpg,21,19,19,0,2,1.0,0.9047619047619048
2022,SAOUDA,CITRUS VOLKAMERIANA,21020,IMG-00138-45.jpg,40,41,38,3,2,0.926829268292683,0.95
2022,SAOUDA,CITRUS VOLKAMERIANA,21020,IMG-00145-45.jpg,37,38,35,3,2,0.9210526315789472,0.945945945945946
2022,SAOUDA,CITRUS VOLKAMERIANA,21020,IMG-00155-45.jpg,38,40,35,5,3,0.875,0.9210526315789472
2022,SAOUDA,CITRUS VOLKAMERIANA,21030,IMG-00521-45.jpg,31,37,31,6,0,0.8378378378378378,1.0
2022,SAOUDA,CITRUS VOLKAMERIANA,21030,IMG-00524-45.jpg,71,77,68,9,3,0.8831168831168831,0.9577464788732394
2022,SAOUDA,CITRUS VOLKAMERIANA,21030,IMG-00536-45.jpg,41,48,39,9,2,0.8125,0.951219512195122
2022,SAOUDA,CITRUS VOLKAMERIANA,21030,IMG-00537-45.jpg,52,46,43,3,9,0.9347826086956522,0.8269230769230769
2022,SAOUDA,CITRUS VOLKAMERIANA,22020,IMG-00053-45.jpg,39,41,34,7,5,0.8292682926829268,0.8717948717948718
2022,SAOUDA,CITRUS VOLKAMERIANA,22020,IMG-00059-45.jpg,46,46,42,4,4,0.9130434782608696,0.9130434782608696
2022,SAOUDA,CITRUS VOLKAMERIANA,22020,IMG-00060-45.jpg,48,48,46,2,2,0.9583333333333334,0.9583333333333334
2022,SAOUDA,CITRUS VOLKAMERIANA,22020,IMG-00062-45.jpg,50,54,49,5,1,0.9074074074074074,0.98
2022,SAOUDA,CITRUS VOLKAMERIANA,22030,IMG-00062-45.jpg,62,63,60,3,2,0.9523809523809524,0.967741935483871
2022,SAOUDA,CITRUS VOLKAMERIANA,22030,IMG-00063-45.jpg,83,81,77,4,6,0.9506172839506172,0.927710843373494
2022,SAOUDA,CITRUS VOLKAMERIANA,22030,IMG-00065-45.jpg,58,60,55,5,3,0.9166666666666666,0.9482758620689656
2022,SAOUDA,CITRUS VOLKAMERIANA,22030,IMG-00068-45.jpg,66,68,64,4,2,0.9411764705882352,0.9696969696969696
2022,SAOUDA,CITRUS VOLKAMERIANA,23020,IMG-00024-45.jpg,47,48,44,4,3,0.9166666666666666,0.9361702127659576
2022,SAOUDA,CITRUS VOLKAMERIANA,23020,IMG-00032-45.jpg,33,35,32,3,1,0.9142857142857144,0.9696969696969696
2022,SAOUDA,CITRUS VOLKAMERIANA,23020,IMG-00074-45.jpg,28,30,25,5,3,0.8333333333333334,0.8928571428571429
2022,SAOUDA,CITRUS VOLKAMERIANA,23020,IMG-00079-45.jpg,28,33,28,5,0,0.8484848484848485,1.0
2022,SAOUDA,CITRUS VOLKAMERIANA,23030,IMG-00014-45.jpg,25,23,22,1,3,0.9565217391304348,0.88
2022,SAOUDA,CITRUS VOLKAMERIANA,23030,IMG-00034-45.jpg,43,42,39,3,4,0.9285714285714286,0.9069767441860463
2022,SAOUDA,CITRUS VOLKAMERIANA,23030,IMG-00069-45.jpg,28,32,24,8,4,0.75,0.8571428571428571
2022,SAOUDA,CITRUS VOLKAMERIANA,23030,IMG-00079-45.jpg,50,56,47,9,3,0.8392857142857143,0.94
2022,SAOUDA,CITRANGE CARRIZO,24010,IMG-00097-45.jpg,59,60,55,5,4,0.9166666666666666,0.9322033898305084
2022,SAOUDA,CITRANGE CARRIZO,24010,IMG-00101-45.jpg,27,31,26,5,1,0.8387096774193549,0.9629629629629628
2022,SAOUDA,CITRANGE CARRIZO,24010,IMG-00111-45.jpg,54,55,52,3,2,0.9454545454545454,0.9629629629629628
2022,SAOUDA,CITRANGE CARRIZO,24010,IMG-00112-45.jpg,40,43,38,5,2,0.8837209302325582,0.95
2022,SAOUDA,CITRANGE CARRIZO,25010,IMG-00006-45.jpg,55,51,48,3,7,0.9411764705882352,0.8727272727272727
2022,SAOUDA,CITRANGE CARRIZO,25010,IMG-00007-45.jpg,77,79,75,4,2,0.9493670886075948,0.974025974025974
2022,SAOUDA,CITRANGE CARRIZO,25010,IMG-00010-45.jpg,53,54,50,4,3,0.925925925925926,0.9433962264150944
2022,SAOUDA,CITRANGE CARRIZO,25010,IMG-00011-45.jpg,26,27,26,1,0,0.9629629629629628,1.0
2022,SAOUDA,CITRANGE CARRIZO,26010,IMG-00008-45.jpg,39,39,39,0,0,1.0,1.0
2022,SAOUDA,CITRANGE CARRIZO,26010,IMG-00013-45.jpg,36,39,36,3,0,0.9230769230769232,1.0
2022,SAOUDA,CITRANGE CARRIZO,26010,IMG-00018-45.jpg,43,45,41,4,2,0.9111111111111112,0.9534883720930232
2022,SAOUDA,CITRANGE CARRIZO,26010,IMG-00020-45.jpg,44,46,42,4,2,0.9130434782608696,0.9545454545454546
2022,KHOUALKA,CITRANGE CARRIZO,30138,IMG-00002-40.jpg,39,40,36,4,3,0.9,0.9230769230769232
2022,KHOUALKA,CITRANGE CARRIZO,30138,IMG-00003-40.jpg,59,59,55,4,4,0.9322033898305084,0.9322033898305084
2022,KHOUALKA,CITRANGE CARRIZO,30138,IMG-00005-40.jpg,58,63,56,7,2,0.8888888888888888,0.9655172413793104
2022,KHOUALKA,CITRANGE CARRIZO,30138,IMG-00008-40.jpg,32,32,29,3,3,0.90625,0.90625
2022,KHOUALKA,CITRANGE CARRIZO,30138,IMG-00011-40.jpg,26,26,26,0,0,1.0,1.0
2022,KHOUALKA,CITRANGE CARRIZO,30138,IMG-00019-40.jpg,2,2,2,0,0,1.0,1.0
2022,KHOUALKA,CITRANGE CARRIZO,30138,IMG-00037-40.jpg,30,33,28,5,2,0.8484848484848485,0.9333333333333332
2022,KHOUALKA,CITRANGE CARRIZO,30138,IMG-00040-40.jpg,41,41,40,1,1,0.975609756097561,0.975609756097561
2022,KHOUALKA,CITRANGE CARRIZO,30138,IMG-00043-40.jpg,28,30,25,5,3,0.8333333333333334,0.8928571428571429
2022,KHOUALKA,CITRANGE CARRIZO,30138,IMG-00044-40.jpg,99,100,96,4,3,0.96,0.9696969696969696
2022,KHOUALKA,CITRANGE CARRIZO,30138,IMG-00048-40.jpg,37,42,35,7,2,0.8333333333333334,0.945945945945946
2022,KHOUALKA,CITRANGE CARRIZO,30138,IMG-00057-40.jpg,73,76,71,5,2,0.9342105263157896,0.9726027397260274
2022,KHOUALKA,CITRANGE CARRIZO,30138,IMG-00063-40.jpg,89,82,79,3,10,0.9634146341463414,0.8876404494382022
2022,ONAGRI,CITRUS VOLKAMERIANA,30145,IMG-00018-39.jpg,219,196,188,8,31,0.9591836734693876,0.8584474885844748
2022,ONAGRI,CITRUS VOLKAMERIANA,30145,IMG-00043-39.jpg,64,65,60,5,4,0.9230769230769232,0.9375
2022,ONAGRI,CITRUS VOLKAMERIANA,30146,IMG-00008-39.jpg,262,243,229,14,33,0.9423868312757202,0.8740458015267175
2022,ONAGRI,CITRUS VOLKAMERIANA,30146,IMG-00045-39.jpg,190,194,176,18,14,0.9072164948453608,0.9263157894736842
2022,ONAGRI,CITRUS VOLKAMERIANA,30147,IMG-00002-39.jpg,269,255,243,12,26,0.9529411764705882,0.9033457249070632
2022,ONAGRI,CITRUS VOLKAMERIANA,30147,IMG-00008-39.jpg,172,159,152,7,20,0.9559748427672956,0.8837209302325582
2022,ONAGRI,CITRUS VOLKAMERIANA,30148,IMG-00016-40.jpg,88,82,79,3,9,0.9634146341463414,0.8977272727272727
2022,ONAGRI,CITRUS VOLKAMERIANA,30148,IMG-00047-40.jpg,34,24,24,0,10,1.0,0.7058823529411765
2022,ONAGRI,CITRUS VOLKAMERIANA,30149,IMG-00018-39.jpg,151,129,128,1,23,0.992248062015504,0.847682119205298
2022,ONAGRI,CITRUS VOLKAMERIANA,30149,IMG-00027-39.jpg,226,182,182,0,44,1.0,0.8053097345132744
2022,ONAGRI,CITRUS VOLKAMERIANA,30151,IMG-00012-39.jpg,185,155,150,5,35,0.967741935483871,0.8108108108108109
2022,ONAGRI,CITRUS VOLKAMERIANA,30151,IMG-00033-39.jpg,214,213,198,15,16,0.9295774647887324,0.9252336448598132
2024,ONAGRI,CITRUS VOLKAMERIANA,30151,IMG-21881.jpg,73,65,61,4,12,0.9384615384615383,0.8356164383561644
2024,ONAGRI,CITRUS VOLKAMERIANA,30151,IMG-21935.jpg,179,164,161,3,18,0.9817073170731708,0.8994413407821229
2024,ONAGRI,CITRUS VOLKAMERIANA,30151,IMG-21936.jpg,93,88,86,2,7,0.9772727272727272,0.9247311827956988
2022,ONAGRI,CITRUS VOLKAMERIANA,30152,IMG-00016-39.jpg,39,33,31,2,8,0.9393939393939394,0.7948717948717948
2022,ONAGRI,CITRUS VOLKAMERIANA,30152,IMG-00019-39.jpg,139,118,112,6,27,0.9491525423728814,0.8057553956834532
2022,ONAGRI,CITRUS VOLKAMERIANA,30153,IMG-00001.jpg,157,132,125,7,32,0.946969696969697,0.7961783439490446
2022,ONAGRI,CITRUS VOLKAMERIANA,30153,IMG-00007-39.jpg,127,116,111,5,16,0.956896551724138,0.8740157480314961
2022,ONAGRI,CITRUS VOLKAMERIANA,30153,IMG-00013-39.jpg,159,139,133,6,26,0.9568345323741008,0.8364779874213837
2022,ONAGRI,CITRUS VOLKAMERIANA,30153,IMG-00040-39.jpg,153,140,135,5,18,0.9642857142857144,0.8823529411764706
2022,ONAGRI,CITRUS VOLKAMERIANA,30154,IMG-00017-39.jpg,160,160,150,10,10,0.9375,0.9375
2022,ONAGRI,CITRUS VOLKAMERIANA,30154,IMG-00027-39.jpg,220,202,197,5,23,0.9752475247524752,0.8954545454545455
2022,ONAGRI,CITRUS VOLKAMERIANA,30154,IMG-00033-39.jpg,51,51,48,3,3,0.9411764705882352,0.9411764705882352
2022,ONAGRI,CITRUS VOLKAMERIANA,30154,IMG-00036-39.jpg,137,139,130,9,7,0.935251798561151,0.948905109489051
2022,ONAGRI,CITRUS VOLKAMERIANA,30154,IMG-00038-39.jpg,242,235,224,11,18,0.9531914893617022,0.9256198347107438
2022,ONAGRI,CITRUS VOLKAMERIANA,30154,IMG-00041-39.jpg,272,250,237,13,35,0.948,0.8713235294117647
2022,ONAGRI,CITRUS VOLKAMERIANA,30154,IMG-00044-39.jpg,141,146,131,15,10,0.8972602739726028,0.9290780141843972
2022,ONAGRI,BIGARADIER,30155,IMG-00002-39.jpg,139,138,131,7,8,0.9492753623188406,0.9424460431654677
2022,ONAGRI,BIGARADIER,30155,IMG-00003-39.jpg,115,111,106,5,9,0.954954954954955,0.9217391304347826
2022,ONAGRI,BIGARADIER,30155,IMG-00006-39.jpg,44,42,36,6,8,0.8571428571428571,0.8181818181818182
2022,ONAGRI,BIGARADIER,30155,IMG-00011-39.jpg,100,92,89,3,11,0.967391304347826,0.89
2022,ONAGRI,BIGARADIER,30155,IMG-00019-39.jpg,142,133,126,7,16,0.9473684210526316,0.8873239436619719
2022,ONAGRI,BIGARADIER,30155,IMG-00026-39.jpg,124,113,105,8,19,0.9292035398230089,0.8467741935483871
2022,ONAGRI,BIGARADIER,30155,IMG-00032-39.jpg,81,74,70,4,11,0.945945945945946,0.8641975308641975
2022,ONAGRI,BIGARADIER,30155,IMG-00039-39.jpg,19,18,14,4,5,0.7777777777777778,0.7368421052631579
2022,ONAGRI,BIGARADIER,30155,IMG-00043-39.jpg,130,132,121,11,9,0.9166666666666666,0.9307692307692308
2022,ONAGRI,CITRUS VOLKAMERIANA,30157,IMG-00003-39.jpg,227,216,206,10,21,0.9537037037037036,0.9074889867841408
2022,ONAGRI,CITRUS VOLKAMERIANA,30157,IMG-00012-39.jpg,283,271,260,11,23,0.959409594095941,0.9187279151943464
2022,ONAGRI,CITRUS VOLKAMERIANA,30157,IMG-00032-39.jpg,64,66,59,7,5,0.8939393939393939,0.921875
2022,ONAGRI,CITRUS VOLKAMERIANA,30157,IMG-00035-39.jpg,159,146,139,7,20,0.952054794520548,0.8742138364779874
2022,KHOUALKA,CITRUS VOLKAMERIANA,30235,IMG-00001.jpg,93,91,89,2,4,0.978021978021978,0.956989247311828
2022,KHOUALKA,CITRUS VOLKAMERIANA,30235,IMG-00003-40.jpg,37,40,37,3,0,0.925,1.0
2022,KHOUALKA,CITRUS VOLKAMERIANA,30235,IMG-00009-40.jpg,103,105,99,6,4,0.9428571428571428,0.9611650485436892
2022,KHOUALKA,CITRUS VOLKAMERIANA,30235,IMG-00013-40.jpg,90,91,87,4,3,0.956043956043956,0.9666666666666668
2022,KHOUALKA,CITRUS VOLKAMERIANA,30235,IMG-00026-40.jpg,122,127,118,9,4,0.9291338582677166,0.9672131147540984
2022,KHOUALKA,CITRUS VOLKAMERIANA,30235,IMG-00047-40.jpg,47,52,44,8,3,0.8461538461538461,0.9361702127659576
2022,KHOUALKA,CITRUS VOLKAMERIANA,30235,IMG-00048-40.jpg,90,92,84,8,6,0.9130434782608696,0.9333333333333332
2022,KHOUALKA,CITRUS VOLKAMERIANA,30235,IMG-00049-40.jpg,44,45,40,5,4,0.8888888888888888,0.9090909090909092
2022,KHOUALKA,CITRUS VOLKAMERIANA,30235,IMG-00050-40.jpg,84,85,79,6,5,0.9294117647058824,0.9404761904761904
2022,KHOUALKA,CITRUS VOLKAMERIANA,30235,IMG-00052-40.jpg,98,104,96,8,2,0.9230769230769232,0.979591836734694
2022,KHOUALKA,CITRUS VOLKAMERIANA,30235,IMG-00057-40.jpg,80,76,72,4,8,0.9473684210526316,0.9
2022,KHOUALKA,CITRUS VOLKAMERIANA,30235,IMG-00064-40.jpg,38,32,31,1,7,0.96875,0.8157894736842105
2022,KHOUALKA,CITRUS VOLKAMERIANA,30235,IMG-00067-40.jpg,107,103,99,4,8,0.9611650485436892,0.9252336448598132
2022,KHOUALKA,CITRUS VOLKAMERIANA,30235,IMG-00069-40.jpg,34,38,33,5,1,0.868421052631579,0.9705882352941176
2022,KHOUALKA,CITRUS VOLKAMERIANA,30235,IMG-00075-40.jpg,95,98,90,8,5,0.9183673469387756,0.9473684210526316
2022,KHOUALKA,BIGARADIER,40141,IMG-00006-40.jpg,7,7,6,1,1,0.8571428571428571,0.8571428571428571
2022,KHOUALKA,BIGARADIER,40141,IMG-00007-40.jpg,20,9,9,0,11,1.0,0.45
2022,KHOUALKA,BIGARADIER,40141,IMG-00008-40.jpg,15,13,12,1,3,0.9230769230769232,0.8
2022,ONAGRI,CITRANGE C35,40166,IMG-00009-39.jpg,38,37,35,2,3,0.945945945945946,0.9210526315789472
2022,ONAGRI,CITRANGE C35,40166,IMG-00011-39.jpg,173,173,160,13,13,0.9248554913294798,0.9248554913294798
2022,ONAGRI,CITRANGE C35,40166,IMG-00014-39.jpg,179,180,170,10,9,0.9444444444444444,0.9497206703910616
2022,ONAGRI,CITRANGE C35,40166,IMG-00015-39.jpg,122,121,114,7,8,0.9421487603305784,0.9344262295081968
2022,ONAGRI,CITRANGE C35,40166,IMG-00041-39.jpg,102,99,96,3,6,0.9696969696969696,0.9411764705882352
2022,ONAGRI,CITRANGE C35,40167,IMG-00019-39.jpg,197,194,188,6,9,0.9690721649484536,0.9543147208121828
2022,ONAGRI,CITRANGE C35,40167,IMG-00030-39.jpg,126,120,116,4,10,0.9666666666666668,0.9206349206349206
2022,ONAGRI,CITRANGE C35,40167,IMG-00039-39.jpg,217,201,191,10,26,0.9502487562189056,0.880184331797235
2022,ONAGRI,CITRANGE C35,40171,IMG-00008-39.jpg,109,101,98,3,11,0.9702970297029704,0.8990825688073395
2022,ONAGRI,CITRANGE C35,40171,IMG-00037-39.jpg,94,89,84,5,10,0.9438202247191012,0.8936170212765957
2022,ONAGRI,CITRANGE C35,40171,IMG-00040-39.jpg,149,142,132,10,17,0.9295774647887324,0.8859060402684564
2022,ONAGRI,CITRANGE C35,40172,IMG-00012-39.jpg,89,81,79,2,10,0.9753086419753086,0.8876404494382022
2022,ONAGRI,CITRANGE C35,40172,IMG-00025-39.jpg,109,98,96,2,13,0.979591836734694,0.8807339449541285
2022,ONAGRI,CITRANGE C35,40172,IMG-00027-39.jpg,103,95,91,4,12,0.9578947368421052,0.883495145631068
2022,ONAGRI,CITRANGE C35,40173,IMG-00004-39.jpg,133,119,117,2,16,0.9831932773109244,0.8796992481203008
2022,ONAGRI,CITRANGE C35,40173,IMG-00008-39.jpg,57,44,44,0,13,1.0,0.7719298245614035
2022,ONAGRI,CITRANGE C35,40173,IMG-00010-39.jpg,53,58,51,7,2,0.8793103448275862,0.9622641509433962
2022,ONAGRI,CITRANGE C35,40175,IMG-00005-39.jpg,95,85,79,6,16,0.9294117647058824,0.8315789473684211
2022,ONAGRI,CITRANGE C35,40175,IMG-00006-39.jpg,64,64,59,5,5,0.921875,0.921875
2022,ONAGRI,CITRANGE C35,40176,IMG-00004-39.jpg,79,77,72,5,7,0.935064935064935,0.9113924050632912
2022,ONAGRI,CITRANGE C35,40176,IMG-00012-39.jpg,105,107,101,6,4,0.9439252336448598,0.961904761904762
2022,ONAGRI,CITRANGE C35,40176,IMG-00014-39.jpg,91,93,85,8,6,0.913978494623656,0.934065934065934
2022,ONAGRI,CITRUMELO SACCATON,40177,IMG-00012-39.jpg,89,90,84,6,5,0.9333333333333332,0.9438202247191012
2022,ONAGRI,CITRUMELO SACCATON,40177,IMG-00015-39.jpg,213,222,209,13,4,0.9414414414414416,0.9812206572769951
2022,ONAGRI,CITRUMELO SACCATON,40177,IMG-00037-39.jpg,95,94,89,5,6,0.946808510638298,0.936842105263158
2022,ONAGRI,CITRANGE C35,40178,IMG-00013-39.jpg,76,73,73,0,3,1.0,0.9605263157894736
2022,ONAGRI,CITRANGE C35,40178,IMG-00027-39.jpg,56,56,54,2,2,0.9642857142857144,0.9642857142857144
2022,ONAGRI,CITRANGE C35,40178,IMG-00031-39.jpg,30,32,30,2,0,0.9375,1.0
2022,ONAGRI,CITRANGE C35,40178,IMG-00032-39.jpg,27,30,27,3,0,0.9,1.0
2022,ONAGRI,CITRANGE C35,40178,IMG-00033-39.jpg,34,35,33,2,1,0.9428571428571428,0.9705882352941176
2022,ONAGRI,CITRANGE C35,40179,IMG-00001.jpg,83,87,79,8,4,0.9080459770114944,0.9518072289156626
2022,ONAGRI,CITRANGE C35,40179,IMG-00010-39.jpg,161,157,151,6,10,0.961783439490446,0.937888198757764
2022,ONAGRI,CITRANGE C35,40179,IMG-00011-39.jpg,102,98,94,4,8,0.9591836734693876,0.9215686274509804
2022,ONAGRI,CITRANGE C35,40179,IMG-00018-39.jpg,9,10,8,2,1,0.8,0.8888888888888888
2022,ONAGRI,CITRUMELO SACCATON,40182,IMG-00004-39.jpg,35,39,35,4,0,0.8974358974358975,1.0
2022,ONAGRI,CITRUMELO SACCATON,40182,IMG-00010-39.jpg,52,52,49,3,3,0.9423076923076924,0.9423076923076924
2022,ONAGRI,CITRUMELO SACCATON,40182,IMG-00015-39.jpg,85,82,77,5,8,0.9390243902439024,0.9058823529411764
2022,ONAGRI,CITRUMELO SACCATON,40183,IMG-00005-39.jpg,68,66,65,1,3,0.9848484848484848,0.9558823529411764
2022,ONAGRI,CITRUMELO SACCATON,40183,IMG-00009-39.jpg,57,60,55,5,2,0.9166666666666666,0.9649122807017544
2022,ONAGRI,CITRUMELO SACCATON,40183,IMG-00010-39.jpg,48,47,45,2,3,0.9574468085106383,0.9375
2024,KHOUALKA,CITRUS VOLKAMERIANA,50152,IMG-17274.jpg,170,155,149,6,21,0.9612903225806452,0.8764705882352941
2024,KHOUALKA,CITRUS VOLKAMERIANA,50152,IMG-17306.jpg,105,98,97,1,8,0.9897959183673468,0.923809523809524
2024,KHOUALKA,CITRUS VOLKAMERIANA,50152,IMG-17330.jpg,41,38,36,2,5,0.9473684210526316,0.8780487804878049
2024,KHOUALKA,CITRUS VOLKAMERIANA,50152,IMG-17335.jpg,44,41,40,1,4,0.975609756097561,0.9090909090909092
2024,KHOUALKA,CITRUS VOLKAMERIANA,50152,IMG-17340.jpg,108,94,90,4,18,0.9574468085106383,0.8333333333333334
2024,KHOUALKA,CITRUS VOLKAMERIANA,50152,IMG-17356.jpg,60,55,50,5,10,0.9090909090909092,0.8333333333333334
2024,KHOUALKA,CITRUS VOLKAMERIANA,50152,IMG-17384.jpg,53,46,43,3,10,0.9347826086956522,0.8113207547169812
2024,KHOUALKA,CITRUS VOLKAMERIANA,50154,IMG-17440.jpg,76,70,70,0,6,1.0,0.9210526315789472
2024,KHOUALKA,CITRUS VOLKAMERIANA,50154,IMG-17490.jpg,107,93,92,1,15,0.989247311827957,0.8598130841121495
2024,KHOUALKA,CITRUS VOLKAMERIANA,50154,IMG-17543.jpg,100,84,82,2,18,0.9761904761904762,0.82
2024,KHOUALKA,CITRUS VOLKAMERIANA,50154,IMG-17545.jpg,94,83,81,2,13,0.9759036144578314,0.8617021276595744
2024,KHOUALKA,CITRUS VOLKAMERIANA,50154,IMG-17562.jpg,129,122,118,4,11,0.9672131147540984,0.9147286821705426
2024,KHOUALKA,CITRUS VOLKAMERIANA,50154,IMG-17576.jpg,121,113,109,4,12,0.9646017699115044,0.9008264462809916
2024,KHOUALKA,CITRUS VOLKAMERIANA,50154,IMG-17585.jpg,171,154,150,4,21,0.974025974025974,0.8771929824561403
2024,KHOUALKA,CITRUS VOLKAMERIANA,50168,IMG-13980.jpg,174,155,154,1,20,0.9935483870967742,0.8850574712643678
2024,KHOUALKA,CITRUS VOLKAMERIANA,50168,IMG-15749.jpg,147,142,137,5,10,0.9647887323943662,0.9319727891156464
2024,KHOUALKA,CITRUS VOLKAMERIANA,50168,IMG-15758.jpg,163,155,151,4,12,0.9741935483870968,0.9263803680981596
2024,KHOUALKA,CITRUS VOLKAMERIANA,50168,IMG-15981.jpg,210,192,185,7,25,0.9635416666666666,0.8809523809523809
2024,KHOUALKA,CITRUS VOLKAMERIANA,50168,IMG-15983.jpg,120,108,105,3,15,0.9722222222222222,0.875
2024,KHOUALKA,CITRUS VOLKAMERIANA,50176,IMG-16025.jpg,81,72,69,3,12,0.9583333333333334,0.8518518518518519
2024,KHOUALKA,CITRUS VOLKAMERIANA,50176,IMG-16051.jpg,85,80,76,4,9,0.95,0.8941176470588236
2024,KHOUALKA,CITRUS VOLKAMERIANA,50176,IMG-16079.jpg,161,142,137,5,24,0.9647887323943662,0.8509316770186336
2024,KHOUALKA,CITRUS VOLKAMERIANA,50176,IMG-16095.jpg,101,95,92,3,9,0.968421052631579,0.9108910891089108
2024,KHOUALKA,CITRUS VOLKAMERIANA,50176,IMG-16105.jpg,43,37,36,1,7,0.972972972972973,0.8372093023255814
2022,ONAGRI,CITRUMELO SACCATON,50193,IMG-00007-39.jpg,218,210,208,2,10,0.9904761904761904,0.9541284403669724
2022,ONAGRI,CITRUMELO SACCATON,50193,IMG-00016-39.jpg,64,64,59,5,5,0.921875,0.921875
2022,ONAGRI,CITRUMELO SACCATON,50193,IMG-00018-39.jpg,115,118,112,6,3,0.9491525423728814,0.9739130434782608
2022,ONAGRI,CITRUMELO SACCATON,50193,IMG-00021-39.jpg,62,62,59,3,3,0.9516129032258064,0.9516129032258064
2022,ONAGRI,CITRUMELO SACCATON,50193,IMG-00023-39.jpg,113,117,108,9,5,0.9230769230769232,0.9557522123893806
2022,ONAGRI,CITRUMELO SACCATON,50194,IMG-00032-39.jpg,162,166,152,14,10,0.9156626506024096,0.9382716049382716
2022,ONAGRI,CITRUMELO SACCATON,50194,IMG-00034-39.jpg,105,110,103,7,2,0.9363636363636364,0.9809523809523808
2022,ONAGRI,CITRUMELO SACCATON,50194,IMG-00036-39.jpg,161,163,151,12,10,0.9263803680981596,0.937888198757764
2022,ONAGRI,CITRUMELO SACCATON,50194,IMG-00038-39.jpg,100,105,98,7,2,0.9333333333333332,0.98
2022,ONAGRI,CITRUMELO SACCATON,50194,IMG-00039-39.jpg,65,65,63,2,2,0.9692307692307692,0.9692307692307692
2022,ONAGRI,CITRUMELO SACCATON,50194,IMG-00041-39.jpg,153,157,148,9,5,0.9426751592356688,0.9673202614379084
2022,ONAGRI,CITRUMELO SACCATON,50194,IMG-00051-39.jpg,137,137,131,6,6,0.9562043795620438,0.9562043795620438
2022,ONAGRI,CITRUMELO SACCATON,50194,IMG-00054-39.jpg,111,109,104,5,7,0.9541284403669724,0.9369369369369368
2022,ONAGRI,CITRUMELO SACCATON,51091,IMG-00015-39.jpg,85,87,81,6,4,0.9310344827586208,0.9529411764705882
2022,ONAGRI,CITRUMELO SACCATON,51091,IMG-00016-39.jpg,170,173,165,8,5,0.953757225433526,0.9705882352941176
2022,ONAGRI,CITRUMELO SACCATON,51091,IMG-00018-39.jpg,185,196,179,17,6,0.9132653061224488,0.9675675675675676
2022,ONAGRI,CITRUMELO SACCATON,51091,IMG-00022-39.jpg,135,147,132,15,3,0.8979591836734694,0.9777777777777776
2022,ONAGRI,CITRUMELO SACCATON,51091,IMG-00023-39.jpg,140,137,132,5,8,0.9635036496350364,0.9428571428571428
2022,ONAGRI,CITRUMELO SACCATON,51091,IMG-00026-39.jpg,149,145,141,4,8,0.9724137931034482,0.9463087248322148
2022,ONAGRI,CITRUMELO SACCATON,51091,IMG-00044-39.jpg,168,172,164,8,4,0.9534883720930232,0.9761904761904762
2022,ONAGRI,CITRUMELO SACCATON,51095,IMG-00004-39.jpg,201,203,188,15,13,0.9261083743842364,0.9353233830845772
2022,ONAGRI,CITRUMELO SACCATON,51095,IMG-00013-39.jpg,154,152,144,8,10,0.9473684210526316,0.935064935064935
2022,ONAGRI,CITRUMELO SACCATON,51095,IMG-00014-39.jpg,140,144,132,12,8,0.9166666666666666,0.9428571428571428
2022,ONAGRI,CITRUMELO SACCATON,51095,IMG-00015-39.jpg,196,195,190,5,6,0.9743589743589745,0.9693877551020408
2022,ONAGRI,CITRUMELO SACCATON,51095,IMG-00024-39.jpg,234,226,220,6,14,0.9734513274336284,0.9401709401709402
2022,ONAGRI,CITRUMELO SACCATON,51095,IMG-00025-39.jpg,198,200,192,8,6,0.96,0.9696969696969696
2022,ONAGRI,CITRUMELO SACCATON,51096,IMG-00009-39.jpg,219,211,204,7,15,0.966824644549763,0.9315068493150684
2022,ONAGRI,CITRUMELO SACCATON,51096,IMG-00011-39.jpg,145,153,139,14,6,0.9084967320261438,0.9586206896551724
2022,ONAGRI,CITRUMELO SACCATON,51096,IMG-00012-39.jpg,114,108,104,4,10,0.9629629629629628,0.912280701754386
2022,ONAGRI,CITRUMELO SACCATON,51096,IMG-00055-39.jpg,217,204,199,5,18,0.9754901960784312,0.9170506912442395
2022,ONAGRI,MC PONSIRUCE TRIFOLIATA,51097,IMG-00025-39.jpg,121,122,112,10,9,0.918032786885246,0.9256198347107438
2022,ONAGRI,MC PONSIRUCE TRIFOLIATA,51097,IMG-00029-39.jpg,106,111,102,9,4,0.918918918918919,0.9622641509433962
2022,ONAGRI,MC PONSIRUCE TRIFOLIATA,51097,IMG-00044-39.jpg,182,185,172,13,10,0.9297297297297298,0.945054945054945
2022,ONAGRI,MC PONSIRUCE TRIFOLIATA,51098,IMG-00003-39.jpg,65,68,59,9,6,0.8676470588235294,0.9076923076923076
2022,ONAGRI,MC PONSIRUCE TRIFOLIATA,51098,IMG-00010-39.jpg,184,181,173,8,11,0.9558011049723756,0.9402173913043478
2022,ONAGRI,MC PONSIRUCE TRIFOLIATA,51098,IMG-00015-39.jpg,162,164,154,10,8,0.9390243902439024,0.9506172839506172
2022,ONAGRI,MC PONSIRUCE TRIFOLIATA,51099,IMG-00012-39.jpg,133,140,128,12,5,0.9142857142857144,0.962406015037594
2024,ONAGRI,MC PONSIRUCE TRIFOLIATA,51101,IMG-12118.jpg,177,164,163,1,14,0.9939024390243902,0.9209039548022598
2024,ONAGRI,MC PONSIRUCE TRIFOLIATA,51101,IMG-14223.jpg,153,135,133,2,20,0.9851851851851852,0.869281045751634
2024,ONAGRI,MC PONSIRUCE TRIFOLIATA,51101,IMG-14226.jpg,151,141,135,6,16,0.9574468085106383,0.8940397350993378
2024,ONAGRI,MC PONSIRUCE TRIFOLIATA,51101,IMG-14255.jpg,189,177,175,2,14,0.9887005649717514,0.925925925925926
2024,ONAGRI,MC PONSIRUCE TRIFOLIATA,51101,IMG-14281.jpg,150,140,135,5,15,0.9642857142857144,0.9
2022,ONAGRI,CITRUS VOLKAMERIANA,101020,IMG-00001.jpg,6,8,6,2,0,0.75,1.0
2022,ONAGRI,CITRUS VOLKAMERIANA,101020,IMG-00004-44.jpg,53,48,46,2,7,0.9583333333333334,0.8679245283018868
2022,ONAGRI,CITRUS VOLKAMERIANA,101030,IMG-00003-44.jpg,29,32,27,5,2,0.84375,0.9310344827586208
2022,ONAGRI,CITRUS VOLKAMERIANA,101030,IMG-00004-44.jpg,110,102,100,2,10,0.9803921568627452,0.9090909090909092
2022,ONAGRI,CITRUS VOLKAMERIANA,101030,IMG-00005-44.jpg,134,127,120,7,14,0.9448818897637796,0.8955223880597015
2022,ONAGRI,CITRUS VOLKAMERIANA,101030,IMG-00017-44.jpg,79,68,65,3,14,0.9558823529411764,0.8227848101265823
2022,ONAGRI,CITRUS VOLKAMERIANA,101040,IMG-00005-44.jpg,172,154,147,7,25,0.9545454545454546,0.8546511627906976
2022,ONAGRI,CITRUS VOLKAMERIANA,101040,IMG-00009-44.jpg,131,134,124,10,7,0.9253731343283582,0.9465648854961832
2022,ONAGRI,CITRUS VOLKAMERIANA,101040,IMG-00011-44.jpg,64,63,58,5,6,0.9206349206349206,0.90625
2022,ONAGRI,CITRUS VOLKAMERIANA,101040,IMG-00012-44.jpg,139,125,115,10,24,0.92,0.8273381294964028
2022,ONAGRI,CITRUS VOLKAMERIANA,101050,IMG-00002-44.jpg,95,90,84,6,11,0.9333333333333332,0.8842105263157894
2022,ONAGRI,CITRUS VOLKAMERIANA,101050,IMG-00005-44.jpg,59,51,50,1,9,0.9803921568627452,0.847457627118644
2022,ONAGRI,CITRUS VOLKAMERIANA,101050,IMG-00011-44.jpg,46,37,37,0,9,1.0,0.8043478260869565
2022,ONAGRI,CITRUS VOLKAMERIANA,101050,IMG-00024-44.jpg,40,40,37,3,3,0.925,0.925
2022,ONAGRI,CITRUS VOLKAMERIANA,101080,IMG-00005-44.jpg,42,37,33,4,9,0.8918918918918919,0.7857142857142857
2022,ONAGRI,CITRUS VOLKAMERIANA,101080,IMG-00006-44.jpg,79,69,66,3,13,0.9565217391304348,0.8354430379746836
2022,ONAGRI,CITRUS VOLKAMERIANA,101080,IMG-00023-44.jpg,7,8,7,1,0,0.875,1.0
2022,ONAGRI,CITRUS VOLKAMERIANA,101080,IMG-00024-44.jpg,27,23,22,1,5,0.9565217391304348,0.8148148148148148
2022,ONAGRI,CITRUS VOLKAMERIANA,101090,IMG-00003-44.jpg,66,62,59,3,7,0.9516129032258064,0.8939393939393939
2022,ONAGRI,CITRUS VOLKAMERIANA,101090,IMG-00006-44.jpg,41,35,33,2,8,0.9428571428571428,0.8048780487804879
2022,ONAGRI,CITRUS VOLKAMERIANA,101090,IMG-00019-44.jpg,35,35,32,3,3,0.9142857142857144,0.9142857142857144
2022,ONAGRI,CITRUS VOLKAMERIANA,101090,IMG-00020-44.jpg,42,45,39,6,3,0.8666666666666667,0.9285714285714286
2022,KHOUALKA,CITRANGE CARRIZO,102130,IMG-00001.jpg,5,5,4,1,1,0.8,0.8
2022,KHOUALKA,CITRANGE CARRIZO,102130,IMG-00004-43.jpg,24,18,18,0,6,1.0,0.75
2022,KHOUALKA,CITRANGE CARRIZO,102130,IMG-00019-43.jpg,33,34,31,3,2,0.9117647058823528,0.9393939393939394
2022,KHOUALKA,CITRANGE CARRIZO,102130,IMG-00020-43.jpg,18,23,16,7,2,0.6956521739130435,0.8888888888888888
2022,KHOUALKA,MACROPHYLLA,201180,IMG-00007-43.jpg,38,49,38,11,0,0.7755102040816326,1.0
2022,KHOUALKA,MACROPHYLLA,201180,IMG-00011-43.jpg,64,65,57,8,7,0.8769230769230769,0.890625
2022,KHOUALKA,MACROPHYLLA,201180,IMG-00019-43.jpg,64,59,56,3,8,0.9491525423728814,0.875
2022,KHOUALKA,MACROPHYLLA,201180,IMG-00020-43.jpg,43,47,40,7,3,0.851063829787234,0.9302325581395348
2022,KHOUALKA,MACROPHYLLA,201190,IMG-00004-43.jpg,101,85,83,2,18,0.976470588235294,0.8217821782178217
2022,KHOUALKA,MACROPHYLLA,201190,IMG-00010-43.jpg,90,80,76,4,14,0.95,0.8444444444444444
2022,KHOUALKA,MACROPHYLLA,201190,IMG-00011-43.jpg,134,118,112,6,22,0.9491525423728814,0.835820895522388
2022,KHOUALKA,MACROPHYLLA,201190,IMG-00020-43.jpg,95,77,74,3,21,0.961038961038961,0.7789473684210526
2022,KHOUALKA,CITRUS VOLKAMERIANA,201210,IMG-00011-43.jpg,103,96,93,3,10,0.96875,0.9029126213592232
2022,KHOUALKA,CITRUS VOLKAMERIANA,201210,IMG-00012-43.jpg,42,38,37,1,5,0.9736842105263158,0.8809523809523809
2022,KHOUALKA,CITRUS VOLKAMERIANA,201210,IMG-00015-43.jpg,77,69,67,2,10,0.9710144927536232,0.8701298701298701
2022,KHOUALKA,CITRUS VOLKAMERIANA,201210,IMG-00019-43.jpg,31,30,30,0,1,1.0,0.967741935483871
2022,KHOUALKA,BIGARADIER,201320,IMG-00006-43.jpg,87,72,71,1,16,0.9861111111111112,0.8160919540229885
2022,KHOUALKA,BIGARADIER,201320,IMG-00016-43.jpg,97,92,88,4,9,0.9565217391304348,0.9072164948453608
2022,KHOUALKA,BIGARADIER,201320,IMG-00017-43.jpg,49,49,43,6,6,0.8775510204081632,0.8775510204081632
2022,KHOUALKA,BIGARADIER,201320,IMG-00020-43.jpg,88,89,86,3,2,0.9662921348314608,0.9772727272727272
2022,ONAGRI,BIGARADIER,201390,IMG-00008-44.jpg,62,62,58,4,4,0.935483870967742,0.935483870967742
2022,ONAGRI,BIGARADIER,201390,IMG-00011-44.jpg,90,82,79,3,11,0.9634146341463414,0.8777777777777778
2022,ONAGRI,BIGARADIER,201390,IMG-00013-44.jpg,77,61,58,3,19,0.9508196721311476,0.7532467532467533
2022,ONAGRI,BIGARADIER,201390,IMG-00016-44.jpg,69,62,59,3,10,0.9516129032258064,0.855072463768116
2022,KHOUALKA,CITRUS VOLKAMERIANA,202050,IMG-00006-43.jpg,89,85,82,3,7,0.9647058823529412,0.9213483146067416
2022,KHOUALKA,CITRUS VOLKAMERIANA,202050,IMG-00010-43.jpg,94,90,89,1,5,0.9888888888888888,0.946808510638298
2022,KHOUALKA,CITRUS VOLKAMERIANA,202050,IMG-00011-43.jpg,151,145,140,5,11,0.9655172413793104,0.9271523178807948
2022,KHOUALKA,CITRUS VOLKAMERIANA,202050,IMG-00020-43.jpg,129,120,117,3,12,0.975,0.9069767441860463
2022,KHOUALKA,CITRUS VOLKAMERIANA,202070,IMG-00006-43.jpg,68,65,63,2,5,0.9692307692307692,0.9264705882352942
2022,KHOUALKA,CITRUS VOLKAMERIANA,202070,IMG-00009-43.jpg,120,115,111,4,9,0.9652173913043478,0.925
2022,KHOUALKA,CITRUS VOLKAMERIANA,202070,IMG-00013-43.jpg,95,80,78,2,17,0.975,0.8210526315789474
2022,KHOUALKA,CITRUS VOLKAMERIANA,202070,IMG-00019-43.jpg,57,53,51,2,6,0.9622641509433962,0.8947368421052632
2022,KHOUALKA,CITRUS VOLKAMERIANA,202080,IMG-00005-43.jpg,65,60,60,0,5,1.0,0.9230769230769232
2022,KHOUALKA,CITRUS VOLKAMERIANA,202080,IMG-00008-43.jpg,31,29,29,0,2,1.0,0.935483870967742
2022,KHOUALKA,CITRUS VOLKAMERIANA,202080,IMG-00015-43.jpg,220,216,207,9,13,0.9583333333333334,0.9409090909090908
2022,KHOUALKA,CITRUS VOLKAMERIANA,202080,IMG-00016-43.jpg,131,129,124,5,7,0.9612403100775194,0.9465648854961832
2022,KHOUALKA,CITRANGE CARRIZO,301380,IMG-00007-43.jpg,30,31,26,5,4,0.8387096774193549,0.8666666666666667
2022,KHOUALKA,CITRANGE CARRIZO,301380,IMG-00011-43.jpg,53,56,52,4,1,0.9285714285714286,0.981132075471698
2022,KHOUALKA,CITRANGE CARRIZO,301380,IMG-00014-43.jpg,7,8,6,2,1,0.75,0.8571428571428571
2022,KHOUALKA,CITRANGE CARRIZO,301380,IMG-00020-43.jpg,91,96,86,10,5,0.8958333333333334,0.945054945054945
2022,ONAGRI,CITRUS VOLKAMERIANA,301470,IMG-00003-44.jpg,148,150,142,8,6,0.9466666666666668,0.9594594594594594
2022,ONAGRI,CITRUS VOLKAMERIANA,301470,IMG-00004-44.jpg,163,157,146,11,17,0.929936305732484,0.8957055214723927
2022,ONAGRI,CITRUS VOLKAMERIANA,301470,IMG-00005-44.jpg,160,151,145,6,15,0.9602649006622516,0.90625
2022,ONAGRI,CITRUS VOLKAMERIANA,301480,IMG-00001.jpg,92,73,73,0,19,1.0,0.7934782608695652
2022,ONAGRI,CITRUS VOLKAMERIANA,301480,IMG-00003-43.jpg,26,18,18,0,8,1.0,0.6923076923076923
2022,ONAGRI,CITRUS VOLKAMERIANA,301480,IMG-00012-43.jpg,50,42,40,2,10,0.9523809523809524,0.8
2022,ONAGRI,CITRUS VOLKAMERIANA,301480,IMG-00014-43.jpg,77,68,68,0,9,1.0,0.8831168831168831
2022,ONAGRI,CITRUS VOLKAMERIANA,301490,IMG-00005-44.jpg,108,92,88,4,20,0.9565217391304348,0.8148148148148148
2022,ONAGRI,CITRUS VOLKAMERIANA,301490,IMG-00009-44.jpg,185,167,159,8,26,0.9520958083832336,0.8594594594594595
2022,ONAGRI,CITRUS VOLKAMERIANA,301490,IMG-00012-44.jpg,162,151,145,6,17,0.9602649006622516,0.8950617283950617
2022,ONAGRI,CITRUS VOLKAMERIANA,301490,IMG-00015-44.jpg,109,103,97,6,12,0.941747572815534,0.8899082568807339
2022,ONAGRI,CITRUS VOLKAMERIANA,301510,IMG-00001.jpg,252,227,221,6,31,0.973568281938326,0.876984126984127
2022,ONAGRI,CITRUS VOLKAMERIANA,301510,IMG-00006-44.jpg,137,131,126,5,11,0.9618320610687024,0.9197080291970804
2022,ONAGRI,CITRUS VOLKAMERIANA,301510,IMG-00007-44.jpg,115,116,102,14,13,0.8793103448275862,0.8869565217391304
2022,ONAGRI,CITRUS VOLKAMERIANA,301510,IMG-00008-44.jpg,150,134,124,10,26,0.9253731343283582,0.8266666666666667
2022,ONAGRI,BIGARADIER,301550,IMG-00008-44.jpg,144,130,127,3,17,0.9769230769230768,0.8819444444444444
2022,ONAGRI,BIGARADIER,301550,IMG-00011-44.jpg,40,37,36,1,4,0.972972972972973,0.9
2022,ONAGRI,BIGARADIER,301550,IMG-00013-44.jpg,76,70,65,5,11,0.9285714285714286,0.8552631578947368
2022,ONAGRI,BIGARADIER,301550,IMG-00014-44.jpg,80,81,76,5,4,0.9382716049382716,0.95
2022,ONAGRI,CITRUS VOLKAMERIANA,301570,IMG-00004-44.jpg,158,146,144,2,14,0.9863013698630136,0.9113924050632912
2022,ONAGRI,CITRUS VOLKAMERIANA,301570,IMG-00007-44.jpg,152,137,132,5,20,0.9635036496350364,0.868421052631579
2022,ONAGRI,CITRUS VOLKAMERIANA,301570,IMG-00008-44.jpg,103,93,84,9,19,0.9032258064516128,0.8155339805825242
2022,ONAGRI,CITRUS VOLKAMERIANA,301570,IMG-00017-44.jpg,218,206,197,9,21,0.9563106796116504,0.9036697247706422
2022,KHOUALKA,CITRUS VOLKAMERIANA,302340,IMG-00004-43.jpg,106,88,88,0,18,1.0,0.8301886792452831
2022,KHOUALKA,CITRUS VOLKAMERIANA,302340,IMG-00005-43.jpg,105,83,81,2,24,0.9759036144578314,0.7714285714285715
2022,KHOUALKA,CITRUS VOLKAMERIANA,302340,IMG-00011-43.jpg,75,63,63,0,12,1.0,0.84
2022,KHOUALKA,CITRUS VOLKAMERIANA,302340,IMG-00015-43.jpg,92,76,73,3,19,0.9605263157894736,0.7934782608695652
2022,KHOUALKA,CITRUS VOLKAMERIANA,302350,IMG-00008-43.jpg,33,32,30,2,3,0.9375,0.9090909090909092
2022,KHOUALKA,CITRUS VOLKAMERIANA,302350,IMG-00013-43.jpg,80,76,68,8,12,0.8947368421052632,0.85
2022,KHOUALKA,CITRUS VOLKAMERIANA,302350,IMG-00014-43.jpg,76,73,65,8,11,0.8904109589041096,0.8552631578947368
2022,KHOUALKA,CITRUS VOLKAMERIANA,302350,IMG-00018-43.jpg,44,42,39,3,5,0.9285714285714286,0.8863636363636364
2022,KHOUALKA,CITRUS VOLKAMERIANA,302360,IMG-00005-43.jpg,97,91,89,2,8,0.978021978021978,0.9175257731958762
2022,KHOUALKA,CITRUS VOLKAMERIANA,302360,IMG-00006-43.jpg,118,107,106,1,12,0.9906542056074766,0.8983050847457628
2022,KHOUALKA,CITRUS VOLKAMERIANA,302360,IMG-00016-43.jpg,67,58,58,0,9,1.0,0.8656716417910447
2022,KHOUALKA,CITRUS VOLKAMERIANA,302360,IMG-00021-43.jpg,65,69,61,8,4,0.8840579710144928,0.9384615384615383
2022,KHOUALKA,CITRUS VOLKAMERIANA,302510,IMG-00001.jpg,73,61,61,0,12,1.0,0.8356164383561644
2022,KHOUALKA,CITRUS VOLKAMERIANA,302510,IMG-00002-43.jpg,44,40,38,2,6,0.95,0.8636363636363636
2022,KHOUALKA,CITRUS VOLKAMERIANA,302510,IMG-00003-43.jpg,78,78,74,4,4,0.9487179487179488,0.9487179487179488
2022,KHOUALKA,CITRUS VOLKAMERIANA,302510,IMG-00015-43.jpg,49,35,35,0,14,1.0,0.7142857142857143
2022,KHOUALKA,BIGARADIER,401410,IMG-00093-43.jpg,35,26,25,1,10,0.9615384615384616,0.7142857142857143
2022,KHOUALKA,BIGARADIER,401410,IMG-00099-43.jpg,6,4,4,0,2,1.0,0.6666666666666666
2022,KHOUALKA,BIGARADIER,401410,IMG-00102-43.jpg,78,64,64,0,14,1.0,0.8205128205128205
2022,KHOUALKA,BIGARADIER,401410,IMG-00104-43.jpg,81,64,63,1,18,0.984375,0.7777777777777778
2022,ONAGRI,CITRANGE C35,401660,IMG-00001.jpg,56,60,54,6,2,0.9,0.9642857142857144
2022,ONAGRI,CITRANGE C35,401660,IMG-00008-44.jpg,42,39,37,2,5,0.9487179487179488,0.8809523809523809
2022,ONAGRI,CITRANGE C35,401660,IMG-00010-44.jpg,29,24,23,1,6,0.9583333333333334,0.7931034482758621
2022,ONAGRI,CITRANGE C35,401660,IMG-00016-44.jpg,64,62,59,3,5,0.9516129032258064,0.921875
2022,ONAGRI,CITRANGE C35,401710,IMG-00003-44.jpg,51,40,40,0,11,1.0,0.7843137254901961
2022,ONAGRI,CITRANGE C35,401710,IMG-00012-44.jpg,19,17,17,0,2,1.0,0.8947368421052632
2022,ONAGRI,CITRANGE C35,401710,IMG-00013-44.jpg,33,29,28,1,5,0.9655172413793104,0.8484848484848485
2022,ONAGRI,CITRANGE C35,401710,IMG-00019-44.jpg,76,69,67,2,9,0.9710144927536232,0.881578947368421
2022,ONAGRI,CITRANGE C35,401720,IMG-00007-44.jpg,93,97,91,6,2,0.9381443298969072,0.978494623655914
2022,ONAGRI,CITRANGE C35,401720,IMG-00008-44.jpg,38,34,33,1,5,0.9705882352941176,0.868421052631579
2022,ONAGRI,CITRANGE C35,401720,IMG-00010-44.jpg,50,40,39,1,11,0.975,0.78
2022,ONAGRI,CITRANGE C35,401720,IMG-00017-44.jpg,68,59,57,2,11,0.9661016949152542,0.8382352941176471
2022,ONAGRI,CITRANGE C35,401730,IMG-00001.jpg,19,18,18,0,1,1.0,0.9473684210526316
2022,ONAGRI,CITRANGE C35,401730,IMG-00010-44.jpg,50,48,47,1,3,0.9791666666666666,0.94
2022,ONAGRI,CITRANGE C35,401730,IMG-00013-44.jpg,75,72,70,2,5,0.9722222222222222,0.9333333333333332
2022,ONAGRI,CITRANGE C35,401730,IMG-00016-44.jpg,36,35,34,1,2,0.9714285714285714,0.9444444444444444
2022,ONAGRI,CITRANGE C35,401750,IMG-00005-44.jpg,88,68,63,5,25,0.9264705882352942,0.7159090909090909
2022,ONAGRI,CITRANGE C35,401750,IMG-00009-44.jpg,127,109,107,2,20,0.981651376146789,0.84251968503937
2022,ONAGRI,CITRANGE C35,401750,IMG-00016-44.jpg,107,91,89,2,18,0.978021978021978,0.8317757009345794
2022,ONAGRI,CITRANGE C35,401750,IMG-00024-44.jpg,50,43,39,4,11,0.9069767441860463,0.78
2022,ONAGRI,CITRUMELO SACCATON,401770,IMG-00003-44.jpg,24,24,21,3,3,0.875,0.875
2022,ONAGRI,CITRUMELO SACCATON,401770,IMG-00008-44.jpg,72,75,70,5,2,0.9333333333333332,0.9722222222222222
2022,ONAGRI,CITRUMELO SACCATON,401770,IMG-00009-44.jpg,14,15,13,2,1,0.8666666666666667,0.9285714285714286
2022,ONAGRI,CITRUMELO SACCATON,401770,IMG-00017-44.jpg,20,16,15,1,5,0.9375,0.75
2022,KHOUALKA,BIGARADIER,402440,IMG-00005-43.jpg,17,12,11,1,6,0.9166666666666666,0.6470588235294118
2022,KHOUALKA,BIGARADIER,402440,IMG-00012-43.jpg,46,36,36,0,10,1.0,0.782608695652174
2022,KHOUALKA,BIGARADIER,402440,IMG-00014-43.jpg,11,9,8,1,3,0.8888888888888888,0.7272727272727273
2022,KHOUALKA,BIGARADIER,402440,IMG-00015-43.jpg,22,11,11,0,11,1.0,0.5
2022,KHOUALKA,BIGARADIER,402590,IMG-00007-43.jpg,104,85,83,2,21,0.976470588235294,0.7980769230769231
2022,KHOUALKA,BIGARADIER,402590,IMG-00012-43.jpg,45,43,40,3,5,0.9302325581395348,0.8888888888888888
2022,KHOUALKA,BIGARADIER,402590,IMG-00015-43.jpg,58,56,50,6,8,0.8928571428571429,0.8620689655172413
2022,KHOUALKA,BIGARADIER,402590,IMG-00019-43.jpg,64,62,62,0,2,1.0,0.96875
2022,KHOUALKA,CITRUS VOLKAMERIANA,501520,IMG-00004-43.jpg,39,32,31,1,8,0.96875,0.7948717948717948
2022,KHOUALKA,CITRUS VOLKAMERIANA,501520,IMG-00007-43.jpg,43,39,38,1,5,0.9743589743589745,0.8837209302325582
2022,KHOUALKA,CITRUS VOLKAMERIANA,501520,IMG-00015-43.jpg,18,10,10,0,8,1.0,0.5555555555555556
2022,KHOUALKA,CITRUS VOLKAMERIANA,501520,IMG-00020-43.jpg,48,44,42,2,6,0.9545454545454546,0.875
2022,KHOUALKA,CITRUS VOLKAMERIANA,501540,IMG-00006-43.jpg,38,38,35,3,3,0.9210526315789472,0.9210526315789472
2022,KHOUALKA,CITRUS VOLKAMERIANA,501540,IMG-00012-43.jpg,102,99,96,3,6,0.9696969696969696,0.9411764705882352
2022,KHOUALKA,CITRUS VOLKAMERIANA,501540,IMG-00017-43.jpg,138,128,125,3,13,0.9765625,0.9057971014492754
2022,KHOUALKA,CITRUS VOLKAMERIANA,501540,IMG-00018-43.jpg,51,49,46,3,5,0.9387755102040816,0.9019607843137256
2022,KHOUALKA,CITRUS VOLKAMERIANA,501660,IMG-00006-43.jpg,60,59,55,4,5,0.9322033898305084,0.9166666666666666
2022,KHOUALKA,CITRUS VOLKAMERIANA,501660,IMG-00016-43.jpg,63,56,52,4,11,0.9285714285714286,0.8253968253968254
2022,KHOUALKA,CITRUS VOLKAMERIANA,501660,IMG-00018-43.jpg,112,101,94,7,18,0.9306930693069309,0.8392857142857143
2022,KHOUALKA,CITRUS VOLKAMERIANA,501660,IMG-00021-43.jpg,90,101,89,12,1,0.8811881188118812,0.9888888888888888
2022,KHOUALKA,CITRUS VOLKAMERIANA,501680,IMG-00005-43.jpg,179,159,156,3,23,0.981132075471698,0.8715083798882681
2022,KHOUALKA,CITRUS VOLKAMERIANA,501680,IMG-00011-43.jpg,101,78,77,1,24,0.9871794871794872,0.7623762376237624
2022,KHOUALKA,CITRUS VOLKAMERIANA,501680,IMG-00012-43.jpg,76,61,57,4,19,0.9344262295081968,0.75
2022,KHOUALKA,CITRUS VOLKAMERIANA,501680,IMG-00016-43.jpg,113,99,98,1,15,0.98989898989899,0.8672566371681416
2022,KHOUALKA,CITRUS VOLKAMERIANA,501690,IMG-00032-43.jpg,34,25,24,1,10,0.96,0.7058823529411765
2022,KHOUALKA,CITRUS VOLKAMERIANA,501690,IMG-00039-43.jpg,186,162,158,4,28,0.9753086419753086,0.8494623655913979
2022,KHOUALKA,CITRUS VOLKAMERIANA,501690,IMG-00047-43.jpg,103,74,74,0,29,1.0,0.7184466019417476
2022,KHOUALKA,CITRUS VOLKAMERIANA,501690,IMG-00049-43.jpg,166,144,142,2,24,0.9861111111111112,0.8554216867469879
2022,KHOUALKA,CITRUS VOLKAMERIANA,501760,IMG-00001.jpg,94,63,62,1,32,0.984126984126984,0.6595744680851063
2022,KHOUALKA,CITRUS VOLKAMERIANA,501760,IMG-00034-43.jpg,45,28,27,1,18,0.9642857142857144,0.6
2022,KHOUALKA,CITRUS VOLKAMERIANA,501760,IMG-00036-43.jpg,40,32,32,0,8,1.0,0.8
2022,KHOUALKA,CITRUS VOLKAMERIANA,501760,IMG-00051-43.jpg,92,71,68,3,24,0.9577464788732394,0.7391304347826086
2022,ONAGRI,CITRUMELO SACCATON,510910,IMG-00004-44.jpg,73,70,68,2,5,0.9714285714285714,0.9315068493150684
2022,ONAGRI,CITRUMELO SACCATON,510910,IMG-00008-44.jpg,152,124,120,4,32,0.967741935483871,0.7894736842105263
2022,ONAGRI,CITRUMELO SACCATON,510910,IMG-00010-44.jpg,107,96,92,4,15,0.9583333333333334,0.8598130841121495
2022,ONAGRI,CITRUMELO SACCATON,510910,IMG-00011-44.jpg,92,84,82,2,10,0.9761904761904762,0.8913043478260869
2022,ONAGRI,CITRUMELO SACCATON,510950,IMG-00006-44.jpg,70,61,61,0,9,1.0,0.8714285714285714
2022,ONAGRI,CITRUMELO SACCATON,510950,IMG-00008-44.jpg,75,69,65,4,10,0.9420289855072465,0.8666666666666667
2022,ONAGRI,CITRUMELO SACCATON,510950,IMG-00009-44.jpg,85,72,71,1,14,0.9861111111111112,0.8352941176470589
2022,ONAGRI,CITRUMELO SACCATON,510950,IMG-00011-44.jpg,135,115,113,2,22,0.982608695652174,0.837037037037037
2022,ONAGRI,MC PONSIRUCE TRIFOLIATA,510980,IMG-00014-44.jpg,67,64,61,3,6,0.953125,0.9104477611940298
2022,ONAGRI,MC PONSIRUCE TRIFOLIATA,510980,IMG-00015-44.jpg,51,50,48,2,3,0.96,0.9411764705882352
2022,ONAGRI,MC PONSIRUCE TRIFOLIATA,510980,IMG-00016-44.jpg,99,90,88,2,11,0.9777777777777776,0.8888888888888888
2022,ONAGRI,MC PONSIRUCE TRIFOLIATA,510980,IMG-00019-44.jpg,102,87,85,2,17,0.9770114942528736,0.8333333333333334
2022,ONAGRI,MC PONSIRUCE TRIFOLIATA,510990,IMG-00006-44.jpg,135,123,121,2,14,0.983739837398374,0.8962962962962963
2022,ONAGRI,MC PONSIRUCE TRIFOLIATA,510990,IMG-00008-44.jpg,110,109,105,4,5,0.963302752293578,0.9545454545454546
2022,ONAGRI,MC PONSIRUCE TRIFOLIATA,510990,IMG-00009-44.jpg,85,74,73,1,12,0.9864864864864864,0.8588235294117647
2022,ONAGRI,MC PONSIRUCE TRIFOLIATA,510990,IMG-00024-44.jpg,65,57,57,0,8,1.0,0.8769230769230769
2022,ONAGRI,MC PONSIRUCE TRIFOLIATA,511030,IMG-00007-44.jpg,100,91,88,3,12,0.967032967032967,0.88
2022,ONAGRI,MC PONSIRUCE TRIFOLIATA,511030,IMG-00016-44.jpg,63,58,56,2,7,0.9655172413793104,0.8888888888888888
2022,ONAGRI,MC PONSIRUCE TRIFOLIATA,511030,IMG-00022-44.jpg,98,95,88,7,10,0.9263157894736842,0.8979591836734694
2022,ONAGRI,MC PONSIRUCE TRIFOLIATA,511030,IMG-00027-44.jpg,82,79,78,1,4,0.9873417721518988,0.951219512195122
2022,ONAGRI,MS PONSIRUCE TRIFOLIATA,511040,IMG-00004-44.jpg,77,67,67,0,10,1.0,0.8701298701298701
2022,ONAGRI,MS PONSIRUCE TRIFOLIATA,511040,IMG-00014-44.jpg,48,44,40,4,8,0.9090909090909092,0.8333333333333334
2022,ONAGRI,MS PONSIRUCE TRIFOLIATA,511040,IMG-00016-44.jpg,71,69,67,2,4,0.9710144927536232,0.943661971830986
2022,ONAGRI,MS PONSIRUCE TRIFOLIATA,511040,IMG-00025-44.jpg,56,50,45,5,11,0.9,0.8035714285714286
2022,ONAGRI,FUZHU,511050,IMG-00004-44.jpg,109,99,93,6,16,0.9393939393939394,0.8532110091743119
2022,ONAGRI,FUZHU,511050,IMG-00006-44.jpg,142,129,121,8,21,0.937984496124031,0.852112676056338
2022,ONAGRI,FUZHU,511050,IMG-00011-44.jpg,172,160,152,8,20,0.95,0.8837209302325582
2022,ONAGRI,FUZHU,511050,IMG-00022-44.jpg,194,178,174,4,20,0.9775280898876404,0.8969072164948454
2022,ONAGRI,MS PONSIRUCE TRIFOLIATA,511060,IMG-00007-44.jpg,115,110,106,4,9,0.9636363636363636,0.9217391304347826
2022,ONAGRI,MS PONSIRUCE TRIFOLIATA,511060,IMG-00016-44.jpg,102,86,82,4,20,0.9534883720930232,0.803921568627451
2022,ONAGRI,MS PONSIRUCE TRIFOLIATA,511060,IMG-00017-44.jpg,59,53,52,1,7,0.981132075471698,0.8813559322033898
2022,ONAGRI,MS PONSIRUCE TRIFOLIATA,511060,IMG-00019-44.jpg,108,97,92,5,16,0.9484536082474226,0.8518518518518519
2022,ONAGRI,FUZHU,511070,IMG-00006-44.jpg,82,82,76,6,6,0.926829268292683,0.926829268292683
2022,ONAGRI,FUZHU,511070,IMG-00016-44.jpg,96,92,83,9,13,0.9021739130434784,0.8645833333333334
2022,ONAGRI,FUZHU,511070,IMG-00018-44.jpg,93,85,82,3,11,0.9647058823529412,0.8817204301075269
2022,ONAGRI,FUZHU,511070,IMG-00019-44.jpg,142,129,125,4,17,0.9689922480620154,0.8802816901408451
