compagnie,Domaine,Porte-greffe,parcelle,Filename,True_count,detect_count,TP,FP,FN,Precision,Recall
2022,SAOUDA,BIGARADIER,10010,IMG-00011-45.jpg,28,28,26,2,2,0.9285714285714286,0.9285714285714286
2022,SAOUDA,BIGARADIER,10010,IMG-00012-45.jpg,27,27,26,1,1,0.9629629629629628,0.9629629629629628
2022,SAOUDA,BIGARADIER,10010,IMG-00014-45.jpg,50,51,48,3,2,0.9411764705882352,0.96
2022,SAOUDA,BIGARADIER,10010,IMG-00018-45.jpg,30,29,28,1,2,0.9655172413793104,0.9333333333333332
2022,SAOUDA,BIGARADIER,10010,IMG-00020-45.jpg,31,33,30,3,1,0.9090909090909092,0.967741935483871
2024,SAOUDA,BIGARADIER,10010,IMG-23410.jpg,85,72,69,3,16,0.9583333333333334,0.8117647058823529
2024,SAOUDA,BIGARADIER,10010,IMG-23417.jpg,86,70,68,2,18,0.9714285714285714,0.7906976744186046
2024,SAOUDA,BIGARADIER,10010,IMG-23430.jpg,74,62,62,0,12,1.0,0.8378378378378378
2024,SAOUDA,BIGARADIER,10010,IMG-23647.jpg,95,83,81,2,14,0.9759036144578314,0.8526315789473684
2024,SAOUDA,BIGARADIER,10010,IMG-23672.jpg,47,35,35,0,12,1.0,0.7446808510638298
2024,SAOUDA,BIGARADIER,10010,IMG-23707.jpg,30,26,26,0,4,1.0,0.8666666666666667
2024,SAOUDA,BIGARADIER,10010,IMG-23709.jpg,31,23,23,0,8,1.0,0.7419354838709677
2024,SAOUDA,BIGARADIER,10010,IMG-23711.jpg,79,68,63,5,16,0.9264705882352942,0.7974683544303798
2022,SAOUDA,MACROPHYLLA,10030,IMG-00158-45.jpg,101,102,95,7,6,0.931372549019608,0.9405940594059404
2022,SAOUDA,MACROPHYLLA,10030,IMG-00159-45.jpg,155,154,139,15,16,0.9025974025974026,0.896774193548387
2022,SAOUDA,MACROPHYLLA,10030,IMG-00162-45.jpg,119,118,112,6,7,0.9491525423728814,0.9411764705882352
2022,SAOUDA,MACROPHYLLA,10030,IMG-00169-45.jpg,72,74,68,6,4,0.918918918918919,0.9444444444444444
2022,SAOUDA,MACROPHYLLA,10031,IMG-00002-45.jpg,46,46,41,5,5,0.8913043478260869,0.8913043478260869
2022,SAOUDA,MACROPHYLLA,10031,IMG-00084-45.jpg,41,44,39,5,2,0.8863636363636364,0.951219512195122
2022,SAOUDA,MACROPHYLLA,10031,IMG-00450-45.jpg,27,32,25,7,2,0.78125,0.925925925925926
2022,SAOUDA,MACROPHYLLA,10031,IMG-00451-45.jpg,34,35,29,6,5,0.8285714285714286,0.8529411764705882
2022,SAOUDA,MACROPHYLLA,10031,IMG-00464-45.jpg,33,33,31,2,2,0.9393939393939394,0.9393939393939394
2022,ONAGRI,CITRUS VOLKAMERIANA,10101,IMG-00003-39.jpg,120,116,111,5,9,0.956896551724138,0.925
2022,ONAGRI,CITRUS VOLKAMERIANA,10101,IMG-00010-39.jpg,85,77,71,6,14,0.922077922077922,0.8352941176470589
2024,ONAGRI,CITRUS VOLKAMERIANA,10101,IMG-10523.jpg,288,270,266,4,22,0.9851851851851852,0.9236111111111112
2024,ONAGRI,CITRUS VOLKAMERIANA,10101,IMG-10545.jpg,98,99,92,7,6,0.9292929292929292,0.9387755102040816
2024,ONAGRI,CITRUS VOLKAMERIANA,10101,IMG-10558.jpg,143,135,129,6,14,0.9555555555555556,0.902097902097902
2022,ONAGRI,CITRUS VOLKAMERIANA,10102,IMG-00003-39.jpg,48,35,35,0,13,1.0,0.7291666666666666
2024,ONAGRI,CITRUS VOLKAMERIANA,10102,IMG-10637.jpg,140,143,130,13,10,0.9090909090909092,0.9285714285714286
2024,ONAGRI,CITRUS VOLKAMERIANA,10102,IMG-10658.jpg,163,151,141,10,22,0.933774834437086,0.8650306748466258
2022,ONAGRI,CITRUS VOLKAMERIANA,10103,IMG-00003-39.jpg,215,183,177,6,38,0.9672131147540984,0.8232558139534883
2022,ONAGRI,CITRUS VOLKAMERIANA,10103,IMG-00008-39.jpg,195,184,173,11,22,0.9402173913043478,0.8871794871794871
2024,ONAGRI,CITRUS VOLKAMERIANA,10103,IMG-10614.jpg,134,135,125,10,9,0.925925925925926,0.9328358208955224
2024,ONAGRI,CITRUS VOLKAMERIANA,10103,IMG-10630.jpg,213,203,193,10,20,0.9507389162561576,0.9061032863849764
2024,ONAGRI,CITRUS VOLKAMERIANA,10103,IMG-10631.jpg,134,125,119,6,15,0.952,0.8880597014925373
2022,ONAGRI,CITRUS VOLKAMERIANA,10104,IMG-00004-39.jpg,65,63,58,5,7,0.9206349206349206,0.8923076923076924
2022,ONAGRI,CITRUS VOLKAMERIANA,10104,IMG-00008-39.jpg,69,59,55,4,14,0.9322033898305084,0.7971014492753623
2024,ONAGRI,CITRUS VOLKAMERIANA,10104,IMG-11267.jpg,22,18,18,0,4,1.0,0.8181818181818182
2024,ONAGRI,CITRUS VOLKAMERIANA,10104,IMG-11327.jpg,128,120,117,3,11,0.975,0.9140625
2024,ONAGRI,CITRUS VOLKAMERIANA,10104,IMG-11347.jpg,118,115,109,6,9,0.9478260869565216,0.923728813559322
2024,ONAGRI,CITRUS VOLKAMERIANA,10104,IMG-11366.jpg,351,300,293,7,58,0.9766666666666668,0.8347578347578347
2024,ONAGRI,CITRUS VOLKAMERIANA,10104,IMG-11386.jpg,99,89,85,4,14,0.9550561797752808,0.8585858585858586
2022,ONAGRI,CITRUS VOLKAMERIANA,10105,IMG-00004-39.jpg,17,17,12,5,5,0.7058823529411765,0.7058823529411765
2022,ONAGRI,CITRUS VOLKAMERIANA,10105,IMG-00005-39.jpg,68,69,60,9,8,0.8695652173913043,0.8823529411764706
2022,ONAGRI,CITRUS VOLKAMERIANA,10108,IMG-00003-39.jpg,61,54,52,2,9,0.9629629629629628,0.8524590163934426
2022,ONAGRI,CITRUS VOLKAMERIANA,10108,IMG-00007-39.jpg,69,57,56,1,13,0.9824561403508772,0.8115942028985508
2022,ONAGRI,CITRUS VOLKAMERIANA,10109,IMG-00003-39.jpg,4,4,4,0,0,1.0,1.0
2022,ONAGRI,CITRUS VOLKAMERIANA,10109,IMG-00008-39.jpg,105,103,93,10,12,0.9029126213592232,0.8857142857142857
2022,KHOUALKA,CITRANGE CARRIZO,10213,IMG-00001.jpg,77,78,72,6,5,0.9230769230769232,0.935064935064935
2022,KHOUALKA,CITRANGE CARRIZO,10213,IMG-00005-40.jpg,73,72,71,1,2,0.9861111111111112,0.9726027397260274
2022,KHOUALKA,CITRANGE CARRIZO,10213,IMG-00009-40.jpg,14,16,14,2,0,0.875,1.0
2022,KHOUALKA,CITRANGE CARRIZO,10213,IMG-00014-40.jpg,21,19,17,2,4,0.8947368421052632,0.8095238095238095
2022,KHOUALKA,CITRANGE CARRIZO,10213,IMG-00028-40.jpg,47,48,45,3,2,0.9375,0.9574468085106383
2022,KHOUALKA,CITRANGE CARRIZO,10213,IMG-00034-40.jpg,48,49,47,2,1,0.9591836734693876,0.9791666666666666
2022,KHOUALKA,CITRANGE CARRIZO,10213,IMG-00035-40.jpg,37,40,35,5,2,0.875,0.945945945945946
2022,KHOUALKA,CITRANGE CARRIZO,10213,IMG-00036-40.jpg,47,49,45,4,2,0.9183673469387756,0.9574468085106383
2022,KHOUALKA,CITRANGE CARRIZO,10213,IMG-00042-40.jpg,22,24,22,2,0,0.9166666666666666,1.0
2022,KHOUALKA,CITRANGE CARRIZO,10213,IMG-00047-40.jpg,70,70,68,2,2,0.9714285714285714,0.9714285714285714
2022,KHOUALKA,CITRANGE CARRIZO,10213,IMG-00054-40.jpg,33,38,32,6,1,0.8421052631578947,0.9696969696969696
2022,KHOUALKA,CITRANGE CARRIZO,10213,IMG-00055-40.jpg,93,90,87,3,6,0.9666666666666668,0.935483870967742
2022,KHOUALKA,CITRANGE CARRIZO,10213,IMG-00061-40.jpg,113,117,110,7,3,0.9401709401709402,0.9734513274336284
2022,KHOUALKA,CITRANGE CARRIZO,10213,IMG-00066-40.jpg,48,49,44,5,4,0.8979591836734694,0.9166666666666666
2024,KHOUALKA,CITRANGE CARRIZO,10213,IMG-12628.jpg,119,107,105,2,14,0.9813084112149532,0.8823529411764706
2024,KHOUALKA,CITRANGE CARRIZO,10213,IMG-12774.jpg,118,103,102,1,16,0.9902912621359224,0.864406779661017
2024,KHOUALKA,CITRANGE CARRIZO,10213,IMG-12780.jpg,44,39,39,0,5,1.0,0.8863636363636364
2024,KHOUALKA,CITRANGE CARRIZO,10213,IMG-12791.jpg,166,145,141,4,25,0.9724137931034482,0.8493975903614458
2024,KHOUALKA,CITRANGE CARRIZO,10213,IMG-12834.jpg,57,48,47,1,10,0.9791666666666666,0.8245614035087719
2024,KHOUALKA,CITRANGE CARRIZO,10213,IMG-12945.jpg,130,111,111,0,19,1.0,0.8538461538461538
2022,OUARGHA,MACROPHYLLA,11010,IMG-00001.jpg,40,37,37,0,3,1.0,0.925
2022,OUARGHA,MACROPHYLLA,11010,IMG-00015-41.jpg,24,23,21,2,3,0.9130434782608696,0.875
2022,OUARGHA,MACROPHYLLA,11010,IMG-00019-41.jpg,20,21,17,4,3,0.8095238095238095,0.85
2022,OUARGHA,MACROPHYLLA,11010,IMG-00024-41.jpg,21,22,21,1,0,0.9545454545454546,1.0
2022,OUARGHA,MACROPHYLLA,11020,IMG-00017-41.jpg,51,55,50,5,1,0.9090909090909092,0.9803921568627452
2022,OUARGHA,MACROPHYLLA,11020,IMG-00018-41.jpg,13,12,12,0,1,1.0,0.9230769230769232
2022,OUARGHA,CITRANGE CARRIZO,13010,IMG-00067-41.jpg,55,54,51,3,4,0.9444444444444444,0.9272727272727272
2022,OUARGHA,CITRANGE CARRIZO,13010,IMG-00086-41.jpg,49,51,47,4,2,0.9215686274509804,0.9591836734693876
2022,OUARGHA,CITRANGE CARRIZO,13010,IMG-00194-41.jpg,33,35,33,2,0,0.9428571428571428,1.0
2022,OUARGHA,CITRANGE CARRIZO,13020,IMG-00023-41.jpg,31,28,28,0,3,1.0,0.9032258064516128
2022,OUARGHA,CITRANGE CARRIZO,13020,IMG-00024-41.jpg,18,19,18,1,0,0.9473684210526316,1.0
2022,OUARGHA,CITRANGE CARRIZO,13020,IMG-00039-41.jpg,4,5,3,2,1,0.6,0.75
2022,OUARGHA,CITRANGE CARRIZO,13020,IMG-00040-41.jpg,6,8,6,2,0,0.75,1.0
2022,OUARGHA,CITRUS VOLKAMERIANA,13030,IMG-00009-41.jpg,18,17,16,1,2,0.9411764705882352,0.8888888888888888
2022,OUARGHA,CITRUS VOLKAMERIANA,13030,IMG-00013-41.jpg,46,44,42,2,4,0.9545454545454546,0.9130434782608696
2022,OUARGHA,CITRUS VOLKAMERIANA,13030,IMG-00027-41.jpg,12,10,10,0,2,1.0,0.8333333333333334
2022,OUARGHA,CITRUS VOLKAMERIANA,13030,IMG-00029-41.jpg,18,17,15,2,3,0.8823529411764706,0.8333333333333334
2022,OUARGHA,CITRUS VOLKAMERIANA,13030,IMG-00036-41.jpg,16,22,15,7,1,0.6818181818181818,0.9375
2022,OUARGHA,CITRUS VOLKAMERIANA,14010,IMG-00008-41.jpg,40,41,37,4,3,0.902439024390244,0.925
2022,OUARGHA,CITRUS VOLKAMERIANA,14010,IMG-00010-41.jpg,49,48,47,1,2,0.9791666666666666,0.9591836734693876
2022,OUARGHA,CITRUS VOLKAMERIANA,14010,IMG-00011-41.jpg,47,46,44,2,3,0.9565217391304348,0.9361702127659576
2022,OUARGHA,CITRUS VOLKAMERIANA,14010,IMG-00018-41.jpg,44,45,40,5,4,0.8888888888888888,0.9090909090909092
2022,KHOUALKA,MACROPHYLLA,20118,IMG-00007-40.jpg,44,45,41,4,3,0.9111111111111112,0.9318181818181818
2022,KHOUALKA,MACROPHYLLA,20118,IMG-00008-40.jpg,115,119,111,8,4,0.9327731092436976,0.9652173913043478
2022,KHOUALKA,MACROPHYLLA,20118,IMG-00022-40.jpg,113,109,106,3,7,0.9724770642201837,0.9380530973451328
2022,KHOUALKA,MACROPHYLLA,20118,IMG-00033-40.jpg,58,62,56,6,2,0.9032258064516128,0.9655172413793104
2022,KHOUALKA,MACROPHYLLA,20118,IMG-00037-40.jpg,29,31,27,4,2,0.8709677419354839,0.9310344827586208
2022,KHOUALKA,MACROPHYLLA,20118,IMG-00042-40.jpg,137,135,131,4,6,0.9703703703703704,0.9562043795620438
2022,KHOUALKA,MACROPHYLLA,20118,IMG-00046-40.jpg,45,46,43,3,2,0.9347826086956522,0.9555555555555556
2022,KHOUALKA,MACROPHYLLA,20118,IMG-00050-40.jpg,48,47,45,2,3,0.9574468085106383,0.9375
2022,KHOUALKA,MACROPHYLLA,20118,IMG-00055-40.jpg,52,52,49,3,3,0.9423076923076924,0.9423076923076924
2022,KHOUALKA,MACROPHYLLA,20118,IMG-00061-40.jpg,120,126,112,14,8,0.8888888888888888,0.9333333333333332
2022,KHOUALKA,MACROPHYLLA,20118,IMG-00062-40.jpg,63,62,60,2,3,0.967741935483871,0.9523809523809524
2022,KHOUALKA,MACROPHYLLA,20118,IMG-00063-40.jpg,47,53,46,7,1,0.8679245283018868,0.9787234042553192
2022,KHOUALKA,MACROPHYLLA,20118,IMG-00066-40.jpg,84,87,81,6,3,0.9310344827586208,0.9642857142857144
2024,KHOUALKA,MACROPHYLLA,20118,IMG-12691.jpg,22,14,14,0,8,1.0,0.6363636363636364
2024,KHOUALKA,MACROPHYLLA,20118,IMG-12729.jpg,56,49,47,2,9,0.9591836734693876,0.8392857142857143
2024,KHOUALKA,MACROPHYLLA,20118,IMG-12735.jpg,88,75,72,3,16,0.96,0.8181818181818182
2024,KHOUALKA,MACROPHYLLA,20118,IMG-12748.jpg,107,100,96,4,11,0.96,0.897196261682243
2024,KHOUALKA,MACROPHYLLA,20118,IMG-12764.jpg,111,100,97,3,14,0.97,0.8738738738738738
2024,KHOUALKA,MACROPHYLLA,20118,IMG-12808.jpg,113,101,94,7,19,0.9306930693069309,0.831858407079646
2024,KHOUALKA,MACROPHYLLA,20118,IMG-12851.jpg,24,12,12,0,12,1.0,0.5
2022,KHOUALKA,MACROPHYLLA,20119,IMG-00005-40.jpg,106,107,95,12,11,0.8878504672897196,0.8962264150943396
2022,KHOUALKA,MACROPHYLLA,20119,IMG-00008-40.jpg,142,147,131,16,11,0.891156462585034,0.9225352112676056
2022,KHOUALKA,MACROPHYLLA,20119,IMG-00014-40.jpg,132,130,125,5,7,0.9615384615384616,0.946969696969697
2022,KHOUALKA,BIGARADIER,20132,IMG-00004-40.jpg,181,175,171,4,10,0.9771428571428572,0.9447513812154696
2022,KHOUALKA,BIGARADIER,20132,IMG-00025-40.jpg,91,90,83,7,8,0.9222222222222224,0.912087912087912
2022,KHOUALKA,BIGARADIER,20132,IMG-00028-40.jpg,49,47,45,2,4,0.9574468085106383,0.9183673469387756
2022,KHOUALKA,BIGARADIER,20132,IMG-00035-40.jpg,103,114,103,11,0,0.9035087719298246,1.0
2022,KHOUALKA,BIGARADIER,20132,IMG-00039-40.jpg,119,125,114,11,5,0.912,0.957983193277311
2022,KHOUALKA,BIGARADIER,20132,IMG-00046-40.jpg,156,160,151,9,5,0.94375,0.967948717948718
2022,KHOUALKA,BIGARADIER,20132,IMG-00051-40.jpg,108,106,100,6,8,0.9433962264150944,0.925925925925926
2022,KHOUALKA,BIGARADIER,20132,IMG-00055-40.jpg,67,63,60,3,7,0.9523809523809524,0.8955223880597015
2022,KHOUALKA,BIGARADIER,20132,IMG-00058-40.jpg,89,88,87,1,2,0.9886363636363636,0.9775280898876404
2022,KHOUALKA,BIGARADIER,20132,IMG-00059-40.jpg,139,136,131,5,8,0.9632352941176472,0.9424460431654677
2022,KHOUALKA,BIGARADIER,20132,IMG-00060-40.jpg,57,51,49,2,8,0.9607843137254902,0.8596491228070176
2022,KHOUALKA,BIGARADIER,20132,IMG-00064-40.jpg,117,118,112,6,5,0.9491525423728814,0.9572649572649572
2022,KHOUALKA,BIGARADIER,20132,IMG-00075-40.jpg,69,74,69,5,0,0.9324324324324323,1.0
2022,ONAGRI,BIGARADIER,20139,IMG-00021-39.jpg,93,89,84,5,9,0.9438202247191012,0.9032258064516128
2024,KHOUALKA,CITRUS VOLKAMERIANA,20205,IMG-12040.jpg,123,112,107,5,16,0.9553571428571428,0.8699186991869918
2024,KHOUALKA,CITRUS VOLKAMERIANA,20205,IMG-12058.jpg,116,107,107,0,9,1.0,0.9224137931034484
2024,KHOUALKA,CITRUS VOLKAMERIANA,20207,IMG-11892.jpg,94,73,69,4,25,0.9452054794520548,0.7340425531914894
2024,KHOUALKA,CITRUS VOLKAMERIANA,20207,IMG-11921.jpg,264,225,220,5,44,0.9777777777777776,0.8333333333333334
2024,KHOUALKA,CITRUS VOLKAMERIANA,20207,IMG-11927.jpg,195,168,160,8,35,0.9523809523809524,0.8205128205128205
2024,KHOUALKA,CITRUS VOLKAMERIANA,20207,IMG-11961.jpg,113,94,94,0,19,1.0,0.831858407079646
2024,KHOUALKA,CITRUS VOLKAMERIANA,20207,IMG-11972.jpg,94,79,74,5,20,0.9367088607594936,0.7872340425531915
2024,KHOUALKA,CITRUS VOLKAMERIANA,20207,IMG-11981.jpg,81,57,56,1,25,0.9824561403508772,0.691358024691358
2022,SAOUDA,CITRUS VOLKAMERIANA,21020,IMG-00033-45.jpg,67,70,63,7,4,0.9,0.9402985074626866
2022,SAOUDA,CITRUS VOLKAMERIANA,21020,IMG-00087-45.jpg,21,16,16,0,5,1.0,0.7619047619047619
2022,SAOUDA,CITRUS VOLKAMERIANA,21020,IMG-00138-45.jpg,40,41,39,2,1,0.951219512195122,0.975
2022,SAOUDA,CITRUS VOLKAMERIANA,21020,IMG-00145-45.jpg,37,38,35,3,2,0.9210526315789472,0.945945945945946
2022,SAOUDA,CITRUS VOLKAMERIANA,21020,IMG-00155-45.jpg,38,39,35,4,3,0.8974358974358975,0.9210526315789472
2022,SAOUDA,CITRUS VOLKAMERIANA,21030,IMG-00521-45.jpg,31,38,31,7,0,0.8157894736842105,1.0
2022,SAOUDA,CITRUS VOLKAMERIANA,21030,IMG-00524-45.jpg,71,77,69,8,2,0.8961038961038961,0.971830985915493
2022,SAOUDA,CITRUS VOLKAMERIANA,21030,IMG-00536-45.jpg,41,47,39,8,2,0.8297872340425532,0.951219512195122
2022,SAOUDA,CITRUS VOLKAMERIANA,21030,IMG-00537-45.jpg,52,47,42,5,10,0.8936170212765957,0.8076923076923077
2022,SAOUDA,CITRUS VOLKAMERIANA,22020,IMG-00053-45.jpg,39,44,38,6,1,0.8636363636363636,0.9743589743589745
2022,SAOUDA,CITRUS VOLKAMERIANA,22020,IMG-00059-45.jpg,46,50,43,7,3,0.86,0.9347826086956522
2022,SAOUDA,CITRUS VOLKAMERIANA,22020,IMG-00060-45.jpg,48,51,47,4,1,0.9215686274509804,0.9791666666666666
2022,SAOUDA,CITRUS VOLKAMERIANA,22020,IMG-00062-45.jpg,50,54,49,5,1,0.9074074074074074,0.98
2022,SAOUDA,CITRUS VOLKAMERIANA,22030,IMG-00062-45.jpg,62,64,60,4,2,0.9375,0.967741935483871
2022,SAOUDA,CITRUS VOLKAMERIANA,22030,IMG-00063-45.jpg,83,80,76,4,7,0.95,0.9156626506024096
2022,SAOUDA,CITRUS VOLKAMERIANA,22030,IMG-00065-45.jpg,58,60,55,5,3,0.9166666666666666,0.9482758620689656
2022,SAOUDA,CITRUS VOLKAMERIANA,22030,IMG-00068-45.jpg,66,70,63,7,3,0.9,0.9545454545454546
2022,SAOUDA,CITRUS VOLKAMERIANA,23020,IMG-00024-45.jpg,47,47,43,4,4,0.9148936170212766,0.9148936170212766
2022,SAOUDA,CITRUS VOLKAMERIANA,23020,IMG-00032-45.jpg,33,34,33,1,0,0.9705882352941176,1.0
2022,SAOUDA,CITRUS VOLKAMERIANA,23020,IMG-00074-45.jpg,28,30,25,5,3,0.8333333333333334,0.8928571428571429
2022,SAOUDA,CITRUS VOLKAMERIANA,23020,IMG-00079-45.jpg,28,34,28,6,0,0.8235294117647058,1.0
2022,SAOUDA,CITRUS VOLKAMERIANA,23030,IMG-00014-45.jpg,25,27,23,4,2,0.8518518518518519,0.92
2022,SAOUDA,CITRUS VOLKAMERIANA,23030,IMG-00034-45.jpg,43,46,39,7,4,0.8478260869565217,0.9069767441860463
2022,SAOUDA,CITRUS VOLKAMERIANA,23030,IMG-00069-45.jpg,28,34,26,8,2,0.7647058823529411,0.9285714285714286
2022,SAOUDA,CITRUS VOLKAMERIANA,23030,IMG-00079-45.jpg,50,57,48,9,2,0.8421052631578947,0.96
2022,SAOUDA,CITRANGE CARRIZO,24010,IMG-00097-45.jpg,59,61,56,5,3,0.918032786885246,0.9491525423728814
2022,SAOUDA,CITRANGE CARRIZO,24010,IMG-00101-45.jpg,27,32,26,6,1,0.8125,0.9629629629629628
2022,SAOUDA,CITRANGE CARRIZO,24010,IMG-00111-45.jpg,54,56,52,4,2,0.9285714285714286,0.9629629629629628
2022,SAOUDA,CITRANGE CARRIZO,24010,IMG-00112-45.jpg,40,45,38,7,2,0.8444444444444444,0.95
2022,SAOUDA,CITRANGE CARRIZO,25010,IMG-00006-45.jpg,55,52,47,5,8,0.903846153846154,0.8545454545454545
2022,SAOUDA,CITRANGE CARRIZO,25010,IMG-00007-45.jpg,77,80,75,5,2,0.9375,0.974025974025974
2022,SAOUDA,CITRANGE CARRIZO,25010,IMG-00010-45.jpg,53,54,50,4,3,0.925925925925926,0.9433962264150944
2022,SAOUDA,CITRANGE CARRIZO,25010,IMG-00011-45.jpg,26,28,26,2,0,0.9285714285714286,1.0
2022,SAOUDA,CITRANGE CARRIZO,26010,IMG-00008-45.jpg,39,38,38,0,1,1.0,0.9743589743589745
2022,SAOUDA,CITRANGE CARRIZO,26010,IMG-00013-45.jpg,36,38,36,2,0,0.9473684210526316,1.0
2022,SAOUDA,CITRANGE CARRIZO,26010,IMG-00018-45.jpg,43,45,43,2,0,0.9555555555555556,1.0
2022,SAOUDA,CITRANGE CARRIZO,26010,IMG-00020-45.jpg,44,44,42,2,2,0.9545454545454546,0.9545454545454546
2022,KHOUALKA,CITRANGE CARRIZO,30138,IMG-00002-40.jpg,39,41,37,4,2,0.902439024390244,0.9487179487179488
2022,KHOUALKA,CITRANGE CARRIZO,30138,IMG-00003-40.jpg,59,60,55,5,4,0.9166666666666666,0.9322033898305084
2022,KHOUALKA,CITRANGE CARRIZO,30138,IMG-00005-40.jpg,58,61,56,5,2,0.918032786885246,0.9655172413793104
2022,KHOUALKA,CITRANGE CARRIZO,30138,IMG-00008-40.jpg,32,32,29,3,3,0.90625,0.90625
2022,KHOUALKA,CITRANGE CARRIZO,30138,IMG-00011-40.jpg,26,24,24,0,2,1.0,0.9230769230769232
2022,KHOUALKA,CITRANGE CARRIZO,30138,IMG-00019-40.jpg,2,2,2,0,0,1.0,1.0
2022,KHOUALKA,CITRANGE CARRIZO,30138,IMG-00037-40.jpg,30,33,29,4,1,0.8787878787878788,0.9666666666666668
2022,KHOUALKA,CITRANGE CARRIZO,30138,IMG-00040-40.jpg,41,41,40,1,1,0.975609756097561,0.975609756097561
2022,KHOUALKA,CITRANGE CARRIZO,30138,IMG-00043-40.jpg,28,32,27,5,1,0.84375,0.9642857142857144
2022,KHOUALKA,CITRANGE CARRIZO,30138,IMG-00044-40.jpg,99,100,96,4,3,0.96,0.9696969696969696
2022,KHOUALKA,CITRANGE CARRIZO,30138,IMG-00048-40.jpg,37,40,34,6,3,0.85,0.918918918918919
2022,KHOUALKA,CITRANGE CARRIZO,30138,IMG-00057-40.jpg,73,76,70,6,3,0.9210526315789472,0.958904109589041
2022,KHOUALKA,CITRANGE CARRIZO,30138,IMG-00063-40.jpg,89,83,79,4,10,0.9518072289156626,0.8876404494382022
2022,ONAGRI,CITRUS VOLKAMERIANA,30145,IMG-00018-39.jpg,219,198,191,7,28,0.9646464646464646,0.8721461187214612
2022,ONAGRI,CITRUS VOLKAMERIANA,30145,IMG-00043-39.jpg,64,63,60,3,4,0.9523809523809524,0.9375
2022,ONAGRI,CITRUS VOLKAMERIANA,30146,IMG-00008-39.jpg,262,248,235,13,27,0.9475806451612904,0.8969465648854962
2022,ONAGRI,CITRUS VOLKAMERIANA,30146,IMG-00045-39.jpg,190,192,174,18,16,0.90625,0.9157894736842104
2022,ONAGRI,CITRUS VOLKAMERIANA,30147,IMG-00002-39.jpg,269,262,248,14,21,0.9465648854961832,0.9219330855018588
2022,ONAGRI,CITRUS VOLKAMERIANA,30147,IMG-00008-39.jpg,172,170,160,10,12,0.9411764705882352,0.9302325581395348
2022,ONAGRI,CITRUS VOLKAMERIANA,30148,IMG-00016-40.jpg,88,86,81,5,7,0.9418604651162792,0.9204545454545454
2022,ONAGRI,CITRUS VOLKAMERIANA,30148,IMG-00047-40.jpg,34,24,24,0,10,1.0,0.7058823529411765
2022,ONAGRI,CITRUS VOLKAMERIANA,30149,IMG-00018-39.jpg,151,131,131,0,20,1.0,0.8675496688741722
2022,ONAGRI,CITRUS VOLKAMERIANA,30149,IMG-00027-39.jpg,226,191,189,2,37,0.9895287958115184,0.8362831858407079
2022,ONAGRI,CITRUS VOLKAMERIANA,30151,IMG-00012-39.jpg,185,157,151,6,34,0.961783439490446,0.8162162162162162
2022,ONAGRI,CITRUS VOLKAMERIANA,30151,IMG-00033-39.jpg,214,206,193,13,21,0.9368932038834952,0.9018691588785048
2024,ONAGRI,CITRUS VOLKAMERIANA,30151,IMG-21881.jpg,73,66,60,6,13,0.9090909090909092,0.821917808219178
2024,ONAGRI,CITRUS VOLKAMERIANA,30151,IMG-21935.jpg,179,156,154,2,25,0.9871794871794872,0.8603351955307262
2024,ONAGRI,CITRUS VOLKAMERIANA,30151,IMG-21936.jpg,93,79,79,0,14,1.0,0.8494623655913979
2022,ONAGRI,CITRUS VOLKAMERIANA,30152,IMG-00016-39.jpg,39,34,33,1,6,0.9705882352941176,0.8461538461538461
2022,ONAGRI,CITRUS VOLKAMERIANA,30152,IMG-00019-39.jpg,139,120,111,9,28,0.925,0.7985611510791367
2022,ONAGRI,CITRUS VOLKAMERIANA,30153,IMG-00001.jpg,157,131,125,6,32,0.9541984732824428,0.7961783439490446
2022,ONAGRI,CITRUS VOLKAMERIANA,30153,IMG-00007-39.jpg,127,115,108,7,19,0.9391304347826088,0.8503937007874016
2022,ONAGRI,CITRUS VOLKAMERIANA,30153,IMG-00013-39.jpg,159,144,139,5,20,0.9652777777777778,0.8742138364779874
2022,ONAGRI,CITRUS VOLKAMERIANA,30153,IMG-00040-39.jpg,153,138,133,5,20,0.9637681159420288,0.869281045751634
2022,ONAGRI,CITRUS VOLKAMERIANA,30154,IMG-00017-39.jpg,160,160,150,10,10,0.9375,0.9375
2022,ONAGRI,CITRUS VOLKAMERIANA,30154,IMG-00027-39.jpg,220,213,209,4,11,0.9812206572769951,0.95
2022,ONAGRI,CITRUS VOLKAMERIANA,30154,IMG-00033-39.jpg,51,51,48,3,3,0.9411764705882352,0.9411764705882352
2022,ONAGRI,CITRUS VOLKAMERIANA,30154,IMG-00036-39.jpg,137,142,132,10,5,0.9295774647887324,0.9635036496350364
2022,ONAGRI,CITRUS VOLKAMERIANA,30154,IMG-00038-39.jpg,242,245,229,16,13,0.9346938775510204,0.9462809917355371
2022,ONAGRI,CITRUS VOLKAMERIANA,30154,IMG-00041-39.jpg,272,256,238,18,34,0.9296875,0.875
2022,ONAGRI,CITRUS VOLKAMERIANA,30154,IMG-00044-39.jpg,141,147,131,16,10,0.891156462585034,0.9290780141843972
2022,ONAGRI,BIGARADIER,30155,IMG-00002-39.jpg,139,140,131,9,8,0.9357142857142856,0.9424460431654677
2022,ONAGRI,BIGARADIER,30155,IMG-00003-39.jpg,115,111,107,4,8,0.963963963963964,0.9304347826086956
2022,ONAGRI,BIGARADIER,30155,IMG-00006-39.jpg,44,44,38,6,6,0.8636363636363636,0.8636363636363636
2022,ONAGRI,BIGARADIER,30155,IMG-00011-39.jpg,100,89,87,2,13,0.9775280898876404,0.87
2022,ONAGRI,BIGARADIER,30155,IMG-00019-39.jpg,142,129,124,5,18,0.9612403100775194,0.8732394366197183
2022,ONAGRI,BIGARADIER,30155,IMG-00026-39.jpg,124,117,108,9,16,0.9230769230769232,0.8709677419354839
2022,ONAGRI,BIGARADIER,30155,IMG-00032-39.jpg,81,73,71,2,10,0.9726027397260274,0.8765432098765432
2022,ONAGRI,BIGARADIER,30155,IMG-00039-39.jpg,19,17,14,3,5,0.8235294117647058,0.7368421052631579
2022,ONAGRI,BIGARADIER,30155,IMG-00043-39.jpg,130,130,118,12,12,0.9076923076923076,0.9076923076923076
2022,ONAGRI,CITRUS VOLKAMERIANA,30157,IMG-00003-39.jpg,227,212,203,9,24,0.9575471698113208,0.8942731277533039
2022,ONAGRI,CITRUS VOLKAMERIANA,30157,IMG-00012-39.jpg,283,277,261,16,22,0.9422382671480144,0.92226148409894
2022,ONAGRI,CITRUS VOLKAMERIANA,30157,IMG-00032-39.jpg,64,71,62,9,2,0.8732394366197183,0.96875
2022,ONAGRI,CITRUS VOLKAMERIANA,30157,IMG-00035-39.jpg,159,148,141,7,18,0.9527027027027029,0.8867924528301887
2022,KHOUALKA,CITRUS VOLKAMERIANA,30235,IMG-00001.jpg,93,92,89,3,4,0.967391304347826,0.956989247311828
2022,KHOUALKA,CITRUS VOLKAMERIANA,30235,IMG-00003-40.jpg,37,40,37,3,0,0.925,1.0
2022,KHOUALKA,CITRUS VOLKAMERIANA,30235,IMG-00009-40.jpg,103,106,99,7,4,0.9339622641509434,0.9611650485436892
2022,KHOUALKA,CITRUS VOLKAMERIANA,30235,IMG-00013-40.jpg,90,94,88,6,2,0.9361702127659576,0.9777777777777776
2022,KHOUALKA,CITRUS VOLKAMERIANA,30235,IMG-00026-40.jpg,122,128,119,9,3,0.9296875,0.9754098360655736
2022,KHOUALKA,CITRUS VOLKAMERIANA,30235,IMG-00047-40.jpg,47,52,45,7,2,0.8653846153846154,0.9574468085106383
2022,KHOUALKA,CITRUS VOLKAMERIANA,30235,IMG-00048-40.jpg,90,91,85,6,5,0.934065934065934,0.9444444444444444
2022,KHOUALKA,CITRUS VOLKAMERIANA,30235,IMG-00049-40.jpg,44,47,41,6,3,0.8723404255319149,0.9318181818181818
2022,KHOUALKA,CITRUS VOLKAMERIANA,30235,IMG-00050-40.jpg,84,83,76,7,8,0.9156626506024096,0.9047619047619048
2022,KHOUALKA,CITRUS VOLKAMERIANA,30235,IMG-00052-40.jpg,98,100,94,6,4,0.94,0.9591836734693876
2022,KHOUALKA,CITRUS VOLKAMERIANA,30235,IMG-00057-40.jpg,80,79,73,6,7,0.9240506329113924,0.9125
2022,KHOUALKA,CITRUS VOLKAMERIANA,30235,IMG-00064-40.jpg,38,34,32,2,6,0.9411764705882352,0.8421052631578947
2022,KHOUALKA,CITRUS VOLKAMERIANA,30235,IMG-00067-40.jpg,107,101,98,3,9,0.9702970297029704,0.9158878504672896
2022,KHOUALKA,CITRUS VOLKAMERIANA,30235,IMG-00069-40.jpg,34,35,32,3,2,0.9142857142857144,0.9411764705882352
2022,KHOUALKA,CITRUS VOLKAMERIANA,30235,IMG-00075-40.jpg,95,98,88,10,7,0.8979591836734694,0.9263157894736842
2022,KHOUALKA,BIGARADIER,40141,IMG-00006-40.jpg,7,7,6,1,1,0.8571428571428571,0.8571428571428571
2022,KHOUALKA,BIGARADIER,40141,IMG-00007-40.jpg,20,9,9,0,11,1.0,0.45
2022,KHOUALKA,BIGARADIER,40141,IMG-00008-40.jpg,15,12,11,1,4,0.9166666666666666,0.7333333333333333
2022,ONAGRI,CITRANGE C35,40166,IMG-00009-39.jpg,38,36,34,2,4,0.9444444444444444,0.8947368421052632
2022,ONAGRI,CITRANGE C35,40166,IMG-00011-39.jpg,173,176,160,16,13,0.9090909090909092,0.9248554913294798
2022,ONAGRI,CITRANGE C35,40166,IMG-00014-39.jpg,179,179,171,8,8,0.9553072625698324,0.9553072625698324
2022,ONAGRI,CITRANGE C35,40166,IMG-00015-39.jpg,122,121,112,9,10,0.9256198347107438,0.918032786885246
2022,ONAGRI,CITRANGE C35,40166,IMG-00041-39.jpg,102,96,94,2,8,0.9791666666666666,0.9215686274509804
2022,ONAGRI,CITRANGE C35,40167,IMG-00019-39.jpg,197,193,188,5,9,0.9740932642487048,0.9543147208121828
2022,ONAGRI,CITRANGE C35,40167,IMG-00030-39.jpg,126,118,115,3,11,0.9745762711864406,0.9126984126984128
2022,ONAGRI,CITRANGE C35,40167,IMG-00039-39.jpg,217,201,187,14,30,0.9303482587064676,0.8617511520737328
2022,ONAGRI,CITRANGE C35,40171,IMG-00008-39.jpg,109,100,97,3,12,0.97,0.8899082568807339
2022,ONAGRI,CITRANGE C35,40171,IMG-00037-39.jpg,94,86,83,3,11,0.9651162790697676,0.8829787234042553
2022,ONAGRI,CITRANGE C35,40171,IMG-00040-39.jpg,149,140,133,7,16,0.95,0.8926174496644296
2022,ONAGRI,CITRANGE C35,40172,IMG-00012-39.jpg,89,81,79,2,10,0.9753086419753086,0.8876404494382022
2022,ONAGRI,CITRANGE C35,40172,IMG-00025-39.jpg,109,98,95,3,14,0.9693877551020408,0.8715596330275229
2022,ONAGRI,CITRANGE C35,40172,IMG-00027-39.jpg,103,92,87,5,16,0.9456521739130436,0.8446601941747572
2022,ONAGRI,CITRANGE C35,40173,IMG-00004-39.jpg,133,118,116,2,17,0.9830508474576272,0.8721804511278195
2022,ONAGRI,CITRANGE C35,40173,IMG-00008-39.jpg,57,44,44,0,13,1.0,0.7719298245614035
2022,ONAGRI,CITRANGE C35,40173,IMG-00010-39.jpg,53,57,49,8,4,0.8596491228070176,0.9245283018867924
2022,ONAGRI,CITRANGE C35,40175,IMG-00005-39.jpg,95,82,80,2,15,0.975609756097561,0.8421052631578947
2022,ONAGRI,CITRANGE C35,40175,IMG-00006-39.jpg,64,65,58,7,6,0.8923076923076924,0.90625
2022,ONAGRI,CITRANGE C35,40176,IMG-00004-39.jpg,79,78,71,7,8,0.9102564102564102,0.8987341772151899
2022,ONAGRI,CITRANGE C35,40176,IMG-00012-39.jpg,105,106,100,6,5,0.9433962264150944,0.9523809523809524
2022,ONAGRI,CITRANGE C35,40176,IMG-00014-39.jpg,91,95,86,9,5,0.9052631578947368,0.945054945054945
2022,ONAGRI,CITRUMELO SACCATON,40177,IMG-00012-39.jpg,89,92,84,8,5,0.9130434782608696,0.9438202247191012
2022,ONAGRI,CITRUMELO SACCATON,40177,IMG-00015-39.jpg,213,220,206,14,7,0.9363636363636364,0.9671361502347418
2022,ONAGRI,CITRUMELO SACCATON,40177,IMG-00037-39.jpg,95,94,88,6,7,0.9361702127659576,0.9263157894736842
2022,ONAGRI,CITRANGE C35,40178,IMG-00013-39.jpg,76,76,75,1,1,0.986842105263158,0.986842105263158
2022,ONAGRI,CITRANGE C35,40178,IMG-00027-39.jpg,56,58,55,3,1,0.9482758620689656,0.9821428571428572
2022,ONAGRI,CITRANGE C35,40178,IMG-00031-39.jpg,30,33,30,3,0,0.9090909090909092,1.0
2022,ONAGRI,CITRANGE C35,40178,IMG-00032-39.jpg,27,30,27,3,0,0.9,1.0
2022,ONAGRI,CITRANGE C35,40178,IMG-00033-39.jpg,34,35,33,2,1,0.9428571428571428,0.9705882352941176
2022,ONAGRI,CITRANGE C35,40179,IMG-00001.jpg,83,85,78,7,5,0.9176470588235294,0.9397590361445785
2022,ONAGRI,CITRANGE C35,40179,IMG-00010-39.jpg,161,158,151,7,10,0.9556962025316456,0.937888198757764
2022,ONAGRI,CITRANGE C35,40179,IMG-00011-39.jpg,102,97,95,2,7,0.979381443298969,0.931372549019608
2022,ONAGRI,CITRANGE C35,40179,IMG-00018-39.jpg,9,10,8,2,1,0.8,0.8888888888888888
2022,ONAGRI,CITRUMELO SACCATON,40182,IMG-00004-39.jpg,35,36,35,1,0,0.9722222222222222,1.0
2022,ONAGRI,CITRUMELO SACCATON,40182,IMG-00010-39.jpg,52,52,49,3,3,0.9423076923076924,0.9423076923076924
2022,ONAGRI,CITRUMELO SACCATON,40182,IMG-00015-39.jpg,85,82,78,4,7,0.951219512195122,0.9176470588235294
2022,ONAGRI,CITRUMELO SACCATON,40183,IMG-00005-39.jpg,68,65,64,1,4,0.9846153846153848,0.9411764705882352
2022,ONAGRI,CITRUMELO SACCATON,40183,IMG-00009-39.jpg,57,57,54,3,3,0.9473684210526316,0.9473684210526316
2022,ONAGRI,CITRUMELO SACCATON,40183,IMG-00010-39.jpg,48,44,43,1,5,0.9772727272727272,0.8958333333333334
2024,KHOUALKA,CITRUS VOLKAMERIANA,50152,IMG-17274.jpg,170,152,148,4,22,0.9736842105263158,0.8705882352941177
2024,KHOUALKA,CITRUS VOLKAMERIANA,50152,IMG-17306.jpg,105,100,98,2,7,0.98,0.9333333333333332
2024,KHOUALKA,CITRUS VOLKAMERIANA,50152,IMG-17330.jpg,41,37,36,1,5,0.972972972972973,0.8780487804878049
2024,KHOUALKA,CITRUS VOLKAMERIANA,50152,IMG-17335.jpg,44,40,39,1,5,0.975,0.8863636363636364
2024,KHOUALKA,CITRUS VOLKAMERIANA,50152,IMG-17340.jpg,108,92,88,4,20,0.9565217391304348,0.8148148148148148
2024,KHOUALKA,CITRUS VOLKAMERIANA,50152,IMG-17356.jpg,60,56,52,4,8,0.9285714285714286,0.8666666666666667
2024,KHOUALKA,CITRUS VOLKAMERIANA,50152,IMG-17384.jpg,53,44,41,3,12,0.9318181818181818,0.7735849056603774
2024,KHOUALKA,CITRUS VOLKAMERIANA,50154,IMG-17440.jpg,76,71,70,1,6,0.9859154929577464,0.9210526315789472
2024,KHOUALKA,CITRUS VOLKAMERIANA,50154,IMG-17490.jpg,107,95,93,2,14,0.9789473684210528,0.8691588785046729
2024,KHOUALKA,CITRUS VOLKAMERIANA,50154,IMG-17543.jpg,100,87,83,4,17,0.9540229885057472,0.83
2024,KHOUALKA,CITRUS VOLKAMERIANA,50154,IMG-17545.jpg,94,81,80,1,14,0.9876543209876544,0.851063829787234
2024,KHOUALKA,CITRUS VOLKAMERIANA,50154,IMG-17562.jpg,129,123,118,5,11,0.959349593495935,0.9147286821705426
2024,KHOUALKA,CITRUS VOLKAMERIANA,50154,IMG-17576.jpg,121,113,109,4,12,0.9646017699115044,0.9008264462809916
2024,KHOUALKA,CITRUS VOLKAMERIANA,50154,IMG-17585.jpg,171,153,151,2,20,0.9869281045751634,0.8830409356725146
2024,KHOUALKA,CITRUS VOLKAMERIANA,50168,IMG-13980.jpg,174,148,147,1,27,0.9932432432432432,0.8448275862068966
2024,KHOUALKA,CITRUS VOLKAMERIANA,50168,IMG-15749.jpg,147,139,136,3,11,0.9784172661870504,0.9251700680272108
2024,KHOUALKA,CITRUS VOLKAMERIANA,50168,IMG-15758.jpg,163,155,150,5,13,0.967741935483871,0.9202453987730062
2024,KHOUALKA,CITRUS VOLKAMERIANA,50168,IMG-15981.jpg,210,195,190,5,20,0.9743589743589745,0.9047619047619048
2024,KHOUALKA,CITRUS VOLKAMERIANA,50168,IMG-15983.jpg,120,109,105,4,15,0.963302752293578,0.875
2024,KHOUALKA,CITRUS VOLKAMERIANA,50176,IMG-16025.jpg,81,73,70,3,11,0.958904109589041,0.8641975308641975
2024,KHOUALKA,CITRUS VOLKAMERIANA,50176,IMG-16051.jpg,85,76,76,0,9,1.0,0.8941176470588236
2024,KHOUALKA,CITRUS VOLKAMERIANA,50176,IMG-16079.jpg,161,141,137,4,24,0.9716312056737588,0.8509316770186336
2024,KHOUALKA,CITRUS VOLKAMERIANA,50176,IMG-16095.jpg,101,94,90,4,11,0.9574468085106383,0.8910891089108911
2024,KHOUALKA,CITRUS VOLKAMERIANA,50176,IMG-16105.jpg,43,37,36,1,7,0.972972972972973,0.8372093023255814
2022,ONAGRI,CITRUMELO SACCATON,50193,IMG-00007-39.jpg,218,215,210,5,8,0.9767441860465116,0.963302752293578
2022,ONAGRI,CITRUMELO SACCATON,50193,IMG-00016-39.jpg,64,61,57,4,7,0.9344262295081968,0.890625
2022,ONAGRI,CITRUMELO SACCATON,50193,IMG-00018-39.jpg,115,116,111,5,4,0.956896551724138,0.9652173913043478
2022,ONAGRI,CITRUMELO SACCATON,50193,IMG-00021-39.jpg,62,61,58,3,4,0.9508196721311476,0.935483870967742
2022,ONAGRI,CITRUMELO SACCATON,50193,IMG-00023-39.jpg,113,120,109,11,4,0.9083333333333332,0.9646017699115044
2022,ONAGRI,CITRUMELO SACCATON,50194,IMG-00032-39.jpg,162,168,151,17,11,0.8988095238095238,0.9320987654320988
2022,ONAGRI,CITRUMELO SACCATON,50194,IMG-00034-39.jpg,105,110,104,6,1,0.9454545454545454,0.9904761904761904
2022,ONAGRI,CITRUMELO SACCATON,50194,IMG-00036-39.jpg,161,169,152,17,9,0.8994082840236687,0.9440993788819876
2022,ONAGRI,CITRUMELO SACCATON,50194,IMG-00038-39.jpg,100,107,97,10,3,0.9065420560747663,0.97
2022,ONAGRI,CITRUMELO SACCATON,50194,IMG-00039-39.jpg,65,64,63,1,2,0.984375,0.9692307692307692
2022,ONAGRI,CITRUMELO SACCATON,50194,IMG-00041-39.jpg,153,155,147,8,6,0.9483870967741936,0.9607843137254902
2022,ONAGRI,CITRUMELO SACCATON,50194,IMG-00051-39.jpg,137,137,133,4,4,0.9708029197080292,0.9708029197080292
2022,ONAGRI,CITRUMELO SACCATON,50194,IMG-00054-39.jpg,111,109,106,3,5,0.9724770642201837,0.954954954954955
2022,ONAGRI,CITRUMELO SACCATON,51091,IMG-00015-39.jpg,85,89,82,7,3,0.9213483146067416,0.9647058823529412
2022,ONAGRI,CITRUMELO SACCATON,51091,IMG-00016-39.jpg,170,170,163,7,7,0.9588235294117649,0.9588235294117649
2022,ONAGRI,CITRUMELO SACCATON,51091,IMG-00018-39.jpg,185,196,179,17,6,0.9132653061224488,0.9675675675675676
2022,ONAGRI,CITRUMELO SACCATON,51091,IMG-00022-39.jpg,135,145,131,14,4,0.903448275862069,0.9703703703703704
2022,ONAGRI,CITRUMELO SACCATON,51091,IMG-00023-39.jpg,140,133,129,4,11,0.9699248120300752,0.9214285714285714
2022,ONAGRI,CITRUMELO SACCATON,51091,IMG-00026-39.jpg,149,143,141,2,8,0.986013986013986,0.9463087248322148
2022,ONAGRI,CITRUMELO SACCATON,51091,IMG-00044-39.jpg,168,172,162,10,6,0.9418604651162792,0.9642857142857144
2022,ONAGRI,CITRUMELO SACCATON,51095,IMG-00004-39.jpg,201,203,187,16,14,0.9211822660098522,0.9303482587064676
2022,ONAGRI,CITRUMELO SACCATON,51095,IMG-00013-39.jpg,154,153,145,8,9,0.9477124183006536,0.9415584415584416
2022,ONAGRI,CITRUMELO SACCATON,51095,IMG-00014-39.jpg,140,145,135,10,5,0.9310344827586208,0.9642857142857144
2022,ONAGRI,CITRUMELO SACCATON,51095,IMG-00015-39.jpg,196,195,190,5,6,0.9743589743589745,0.9693877551020408
2022,ONAGRI,CITRUMELO SACCATON,51095,IMG-00024-39.jpg,234,227,218,9,16,0.960352422907489,0.9316239316239316
2022,ONAGRI,CITRUMELO SACCATON,51095,IMG-00025-39.jpg,198,202,191,11,7,0.9455445544554456,0.9646464646464646
2022,ONAGRI,CITRUMELO SACCATON,51096,IMG-00009-39.jpg,219,218,208,10,11,0.9541284403669724,0.9497716894977168
2022,ONAGRI,CITRUMELO SACCATON,51096,IMG-00011-39.jpg,145,154,141,13,4,0.9155844155844156,0.9724137931034482
2022,ONAGRI,CITRUMELO SACCATON,51096,IMG-00012-39.jpg,114,107,105,2,9,0.9813084112149532,0.9210526315789472
2022,ONAGRI,CITRUMELO SACCATON,51096,IMG-00055-39.jpg,217,204,197,7,20,0.965686274509804,0.9078341013824884
2022,ONAGRI,MC PONSIRUCE TRIFOLIATA,51097,IMG-00025-39.jpg,121,122,112,10,9,0.918032786885246,0.9256198347107438
2022,ONAGRI,MC PONSIRUCE TRIFOLIATA,51097,IMG-00029-39.jpg,106,112,103,9,3,0.9196428571428572,0.9716981132075472
2022,ONAGRI,MC PONSIRUCE TRIFOLIATA,51097,IMG-00044-39.jpg,182,186,172,14,10,0.9247311827956988,0.945054945054945
2022,ONAGRI,MC PONSIRUCE TRIFOLIATA,51098,IMG-00003-39.jpg,65,70,62,8,3,0.8857142857142857,0.953846153846154
2022,ONAGRI,MC PONSIRUCE TRIFOLIATA,51098,IMG-00010-39.jpg,184,183,174,9,10,0.9508196721311476,0.9456521739130436
2022,ONAGRI,MC PONSIRUCE TRIFOLIATA,51098,IMG-00015-39.jpg,162,170,156,14,6,0.9176470588235294,0.9629629629629628
2022,ONAGRI,MC PONSIRUCE TRIFOLIATA,51099,IMG-00012-39.jpg,133,136,124,12,9,0.9117647058823528,0.9323308270676692
2024,ONAGRI,MC PONSIRUCE TRIFOLIATA,51101,IMG-12118.jpg,177,169,167,2,10,0.9881656804733728,0.943502824858757
2024,ONAGRI,MC PONSIRUCE TRIFOLIATA,51101,IMG-14223.jpg,153,139,134,5,19,0.9640287769784172,0.8758169934640523
2024,ONAGRI,MC PONSIRUCE TRIFOLIATA,51101,IMG-14226.jpg,151,140,136,4,15,0.9714285714285714,0.9006622516556292
2024,ONAGRI,MC PONSIRUCE TRIFOLIATA,51101,IMG-14255.jpg,189,178,173,5,16,0.9719101123595506,0.9153439153439152
2024,ONAGRI,MC PONSIRUCE TRIFOLIATA,51101,IMG-14281.jpg,150,144,140,4,10,0.9722222222222222,0.9333333333333332
2022,ONAGRI,CITRUS VOLKAMERIANA,101020,IMG-00001.jpg,6,7,6,1,0,0.8571428571428571,1.0
2022,ONAGRI,CITRUS VOLKAMERIANA,101020,IMG-00004-44.jpg,53,49,46,3,7,0.9387755102040816,0.8679245283018868
2022,ONAGRI,CITRUS VOLKAMERIANA,101030,IMG-00003-44.jpg,29,31,28,3,1,0.9032258064516128,0.9655172413793104
2022,ONAGRI,CITRUS VOLKAMERIANA,101030,IMG-00004-44.jpg,110,102,98,4,12,0.9607843137254902,0.8909090909090909
2022,ONAGRI,CITRUS VOLKAMERIANA,101030,IMG-00005-44.jpg,134,126,119,7,15,0.9444444444444444,0.8880597014925373
2022,ONAGRI,CITRUS VOLKAMERIANA,101030,IMG-00017-44.jpg,79,67,65,2,14,0.9701492537313432,0.8227848101265823
2022,ONAGRI,CITRUS VOLKAMERIANA,101040,IMG-00005-44.jpg,172,152,147,5,25,0.9671052631578948,0.8546511627906976
2022,ONAGRI,CITRUS VOLKAMERIANA,101040,IMG-00009-44.jpg,131,138,126,12,5,0.9130434782608696,0.9618320610687024
2022,ONAGRI,CITRUS VOLKAMERIANA,101040,IMG-00011-44.jpg,64,66,60,6,4,0.9090909090909092,0.9375
2022,ONAGRI,CITRUS VOLKAMERIANA,101040,IMG-00012-44.jpg,139,127,116,11,23,0.9133858267716536,0.8345323741007195
2022,ONAGRI,CITRUS VOLKAMERIANA,101050,IMG-00002-44.jpg,95,90,85,5,10,0.9444444444444444,0.8947368421052632
2022,ONAGRI,CITRUS VOLKAMERIANA,101050,IMG-00005-44.jpg,59,55,54,1,5,0.9818181818181818,0.9152542372881356
2022,ONAGRI,CITRUS VOLKAMERIANA,101050,IMG-00011-44.jpg,46,38,37,1,9,0.9736842105263158,0.8043478260869565
2022,ONAGRI,CITRUS VOLKAMERIANA,101050,IMG-00024-44.jpg,40,40,37,3,3,0.925,0.925
2022,ONAGRI,CITRUS VOLKAMERIANA,101080,IMG-00005-44.jpg,42,35,32,3,10,0.9142857142857144,0.7619047619047619
2022,ONAGRI,CITRUS VOLKAMERIANA,101080,IMG-00006-44.jpg,79,66,64,2,15,0.9696969696969696,0.810126582278481
2022,ONAGRI,CITRUS VOLKAMERIANA,101080,IMG-00023-44.jpg,7,8,7,1,0,0.875,1.0
2022,ONAGRI,CITRUS VOLKAMERIANA,101080,IMG-00024-44.jpg,27,23,22,1,5,0.9565217391304348,0.8148148148148148
2022,ONAGRI,CITRUS VOLKAMERIANA,101090,IMG-00003-44.jpg,66,63,61,2,5,0.9682539682539684,0.9242424242424242
2022,ONAGRI,CITRUS VOLKAMERIANA,101090,IMG-00006-44.jpg,41,34,31,3,10,0.9117647058823528,0.7560975609756098
2022,ONAGRI,CITRUS VOLKAMERIANA,101090,IMG-00019-44.jpg,35,34,32,2,3,0.9411764705882352,0.9142857142857144
2022,ONAGRI,CITRUS VOLKAMERIANA,101090,IMG-00020-44.jpg,42,43,39,4,3,0.9069767441860463,0.9285714285714286
2022,KHOUALKA,CITRANGE CARRIZO,102130,IMG-00001.jpg,5,6,5,1,0,0.8333333333333334,1.0
2022,KHOUALKA,CITRANGE CARRIZO,102130,IMG-00004-43.jpg,24,17,17,0,7,1.0,0.7083333333333334
2022,KHOUALKA,CITRANGE CARRIZO,102130,IMG-00019-43.jpg,33,38,32,6,1,0.8421052631578947,0.9696969696969696
2022,KHOUALKA,CITRANGE CARRIZO,102130,IMG-00020-43.jpg,18,24,17,7,1,0.7083333333333334,0.9444444444444444
2022,KHOUALKA,MACROPHYLLA,201180,IMG-00007-43.jpg,38,50,37,13,1,0.74,0.9736842105263158
2022,KHOUALKA,MACROPHYLLA,201180,IMG-00011-43.jpg,64,64,58,6,6,0.90625,0.90625
2022,KHOUALKA,MACROPHYLLA,201180,IMG-00019-43.jpg,64,63,59,4,5,0.9365079365079364,0.921875
2022,KHOUALKA,MACROPHYLLA,201180,IMG-00020-43.jpg,43,46,39,7,4,0.8478260869565217,0.9069767441860463
2022,KHOUALKA,MACROPHYLLA,201190,IMG-00004-43.jpg,101,82,80,2,21,0.975609756097561,0.7920792079207921
2022,KHOUALKA,MACROPHYLLA,201190,IMG-00010-43.jpg,90,80,77,3,13,0.9625,0.8555555555555555
2022,KHOUALKA,MACROPHYLLA,201190,IMG-00011-43.jpg,134,117,111,6,23,0.9487179487179488,0.8283582089552238
2022,KHOUALKA,MACROPHYLLA,201190,IMG-00020-43.jpg,95,78,74,4,21,0.9487179487179488,0.7789473684210526
2022,KHOUALKA,CITRUS VOLKAMERIANA,201210,IMG-00011-43.jpg,103,94,94,0,9,1.0,0.912621359223301
2022,KHOUALKA,CITRUS VOLKAMERIANA,201210,IMG-00012-43.jpg,42,39,38,1,4,0.9743589743589745,0.9047619047619048
2022,KHOUALKA,CITRUS VOLKAMERIANA,201210,IMG-00015-43.jpg,77,69,68,1,9,0.9855072463768116,0.8831168831168831
2022,KHOUALKA,CITRUS VOLKAMERIANA,201210,IMG-00019-43.jpg,31,30,30,0,1,1.0,0.967741935483871
2022,KHOUALKA,BIGARADIER,201320,IMG-00006-43.jpg,87,69,68,1,19,0.9855072463768116,0.7816091954022989
2022,KHOUALKA,BIGARADIER,201320,IMG-00016-43.jpg,97,91,87,4,10,0.956043956043956,0.8969072164948454
2022,KHOUALKA,BIGARADIER,201320,IMG-00017-43.jpg,49,49,44,5,5,0.8979591836734694,0.8979591836734694
2022,KHOUALKA,BIGARADIER,201320,IMG-00020-43.jpg,88,89,86,3,2,0.9662921348314608,0.9772727272727272
2022,ONAGRI,BIGARADIER,201390,IMG-00008-44.jpg,62,62,57,5,5,0.9193548387096774,0.9193548387096774
2022,ONAGRI,BIGARADIER,201390,IMG-00011-44.jpg,90,82,82,0,8,1.0,0.9111111111111112
2022,ONAGRI,BIGARADIER,201390,IMG-00013-44.jpg,77,63,59,4,18,0.9365079365079364,0.7662337662337663
2022,ONAGRI,BIGARADIER,201390,IMG-00016-44.jpg,69,59,57,2,12,0.9661016949152542,0.8260869565217391
2022,KHOUALKA,CITRUS VOLKAMERIANA,202050,IMG-00006-43.jpg,89,84,83,1,6,0.988095238095238,0.9325842696629212
2022,KHOUALKA,CITRUS VOLKAMERIANA,202050,IMG-00010-43.jpg,94,91,89,2,5,0.978021978021978,0.946808510638298
2022,KHOUALKA,CITRUS VOLKAMERIANA,202050,IMG-00011-43.jpg,151,143,139,4,12,0.972027972027972,0.9205298013245032
2022,KHOUALKA,CITRUS VOLKAMERIANA,202050,IMG-00020-43.jpg,129,122,119,3,10,0.9754098360655736,0.9224806201550388
2022,KHOUALKA,CITRUS VOLKAMERIANA,202070,IMG-00006-43.jpg,68,65,64,1,4,0.9846153846153848,0.9411764705882352
2022,KHOUALKA,CITRUS VOLKAMERIANA,202070,IMG-00009-43.jpg,120,121,114,7,6,0.9421487603305784,0.95
2022,KHOUALKA,CITRUS VOLKAMERIANA,202070,IMG-00013-43.jpg,95,84,80,4,15,0.9523809523809524,0.8421052631578947
2022,KHOUALKA,CITRUS VOLKAMERIANA,202070,IMG-00019-43.jpg,57,54,52,2,5,0.9629629629629628,0.912280701754386
2022,KHOUALKA,CITRUS VOLKAMERIANA,202080,IMG-00005-43.jpg,65,61,60,1,5,0.9836065573770492,0.9230769230769232
2022,KHOUALKA,CITRUS VOLKAMERIANA,202080,IMG-00008-43.jpg,31,31,29,2,2,0.935483870967742,0.935483870967742
2022,KHOUALKA,CITRUS VOLKAMERIANA,202080,IMG-00015-43.jpg,220,218,208,10,12,0.9541284403669724,0.9454545454545454
2022,KHOUALKA,CITRUS VOLKAMERIANA,202080,IMG-00016-43.jpg,131,129,125,4,6,0.9689922480620154,0.9541984732824428
2022,KHOUALKA,CITRANGE CARRIZO,301380,IMG-00007-43.jpg,30,31,26,5,4,0.8387096774193549,0.8666666666666667
2022,KHOUALKA,CITRANGE CARRIZO,301380,IMG-00011-43.jpg,53,58,52,6,1,0.896551724137931,0.981132075471698
2022,KHOUALKA,CITRANGE CARRIZO,301380,IMG-00014-43.jpg,7,7,5,2,2,0.7142857142857143,0.7142857142857143
2022,KHOUALKA,CITRANGE CARRIZO,301380,IMG-00020-43.jpg,91,98,87,11,4,0.8877551020408163,0.956043956043956
2022,ONAGRI,CITRUS VOLKAMERIANA,301470,IMG-00003-44.jpg,148,147,141,6,7,0.9591836734693876,0.9527027027027029
2022,ONAGRI,CITRUS VOLKAMERIANA,301470,IMG-00004-44.jpg,163,165,149,16,14,0.9030303030303032,0.9141104294478528
2022,ONAGRI,CITRUS VOLKAMERIANA,301470,IMG-00005-44.jpg,160,152,144,8,16,0.9473684210526316,0.9
2022,ONAGRI,CITRUS VOLKAMERIANA,301480,IMG-00001.jpg,92,74,73,1,19,0.9864864864864864,0.7934782608695652
2022,ONAGRI,CITRUS VOLKAMERIANA,301480,IMG-00003-43.jpg,26,19,19,0,7,1.0,0.7307692307692307
2022,ONAGRI,CITRUS VOLKAMERIANA,301480,IMG-00012-43.jpg,50,44,42,2,8,0.9545454545454546,0.84
2022,ONAGRI,CITRUS VOLKAMERIANA,301480,IMG-00014-43.jpg,77,68,68,0,9,1.0,0.8831168831168831
2022,ONAGRI,CITRUS VOLKAMERIANA,301490,IMG-00005-44.jpg,108,89,84,5,24,0.9438202247191012,0.7777777777777778
2022,ONAGRI,CITRUS VOLKAMERIANA,301490,IMG-00009-44.jpg,185,171,159,12,26,0.9298245614035088,0.8594594594594595
2022,ONAGRI,CITRUS VOLKAMERIANA,301490,IMG-00012-44.jpg,162,156,148,8,14,0.9487179487179488,0.9135802469135802
2022,ONAGRI,CITRUS VOLKAMERIANA,301490,IMG-00015-44.jpg,109,105,98,7,11,0.9333333333333332,0.8990825688073395
2022,ONAGRI,CITRUS VOLKAMERIANA,301510,IMG-00001.jpg,252,225,219,6,33,0.9733333333333334,0.8690476190476191
2022,ONAGRI,CITRUS VOLKAMERIANA,301510,IMG-00006-44.jpg,137,130,123,7,14,0.946153846153846,0.8978102189781022
2022,ONAGRI,CITRUS VOLKAMERIANA,301510,IMG-00007-44.jpg,115,113,101,12,14,0.8938053097345132,0.8782608695652174
2022,ONAGRI,CITRUS VOLKAMERIANA,301510,IMG-00008-44.jpg,150,133,126,7,24,0.9473684210526316,0.84
2022,ONAGRI,BIGARADIER,301550,IMG-00008-44.jpg,144,137,131,6,13,0.9562043795620438,0.9097222222222222
2022,ONAGRI,BIGARADIER,301550,IMG-00011-44.jpg,40,38,37,1,3,0.9736842105263158,0.925
2022,ONAGRI,BIGARADIER,301550,IMG-00013-44.jpg,76,67,62,5,14,0.9253731343283582,0.8157894736842105
2022,ONAGRI,BIGARADIER,301550,IMG-00014-44.jpg,80,87,77,10,3,0.8850574712643678,0.9625
2022,ONAGRI,CITRUS VOLKAMERIANA,301570,IMG-00004-44.jpg,158,146,144,2,14,0.9863013698630136,0.9113924050632912
2022,ONAGRI,CITRUS VOLKAMERIANA,301570,IMG-00007-44.jpg,152,139,137,2,15,0.9856115107913668,0.9013157894736842
2022,ONAGRI,CITRUS VOLKAMERIANA,301570,IMG-00008-44.jpg,103,91,82,9,21,0.9010989010989012,0.7961165048543689
2022,ONAGRI,CITRUS VOLKAMERIANA,301570,IMG-00017-44.jpg,218,208,201,7,17,0.966346153846154,0.9220183486238532
2022,KHOUALKA,CITRUS VOLKAMERIANA,302340,IMG-00004-43.jpg,106,84,83,1,23,0.988095238095238,0.7830188679245284
2022,KHOUALKA,CITRUS VOLKAMERIANA,302340,IMG-00005-43.jpg,105,84,83,1,22,0.988095238095238,0.7904761904761904
2022,KHOUALKA,CITRUS VOLKAMERIANA,302340,IMG-00011-43.jpg,75,64,63,1,12,0.984375,0.84
2022,KHOUALKA,CITRUS VOLKAMERIANA,302340,IMG-00015-43.jpg,92,80,77,3,15,0.9625,0.8369565217391305
2022,KHOUALKA,CITRUS VOLKAMERIANA,302350,IMG-00008-43.jpg,33,32,30,2,3,0.9375,0.9090909090909092
2022,KHOUALKA,CITRUS VOLKAMERIANA,302350,IMG-00013-43.jpg,80,81,70,11,10,0.8641975308641975,0.875
2022,KHOUALKA,CITRUS VOLKAMERIANA,302350,IMG-00014-43.jpg,76,70,65,5,11,0.9285714285714286,0.8552631578947368
2022,KHOUALKA,CITRUS VOLKAMERIANA,302350,IMG-00018-43.jpg,44,44,40,4,4,0.9090909090909092,0.9090909090909092
2022,KHOUALKA,CITRUS VOLKAMERIANA,302360,IMG-00005-43.jpg,97,92,89,3,8,0.967391304347826,0.9175257731958762
2022,KHOUALKA,CITRUS VOLKAMERIANA,302360,IMG-00006-43.jpg,118,106,104,2,14,0.981132075471698,0.8813559322033898
2022,KHOUALKA,CITRUS VOLKAMERIANA,302360,IMG-00016-43.jpg,67,61,61,0,6,1.0,0.9104477611940298
2022,KHOUALKA,CITRUS VOLKAMERIANA,302360,IMG-00021-43.jpg,65,70,60,10,5,0.8571428571428571,0.9230769230769232
2022,KHOUALKA,CITRUS VOLKAMERIANA,302510,IMG-00001.jpg,73,61,60,1,13,0.9836065573770492,0.821917808219178
2022,KHOUALKA,CITRUS VOLKAMERIANA,302510,IMG-00002-43.jpg,44,40,37,3,7,0.925,0.8409090909090909
2022,KHOUALKA,CITRUS VOLKAMERIANA,302510,IMG-00003-43.jpg,78,78,75,3,3,0.9615384615384616,0.9615384615384616
2022,KHOUALKA,CITRUS VOLKAMERIANA,302510,IMG-00015-43.jpg,49,36,36,0,13,1.0,0.7346938775510204
2022,KHOUALKA,BIGARADIER,401410,IMG-00093-43.jpg,35,23,23,0,12,1.0,0.6571428571428571
2022,KHOUALKA,BIGARADIER,401410,IMG-00099-43.jpg,6,4,4,0,2,1.0,0.6666666666666666
2022,KHOUALKA,BIGARADIER,401410,IMG-00102-43.jpg,78,64,62,2,16,0.96875,0.7948717948717948
2022,KHOUALKA,BIGARADIER,401410,IMG-00104-43.jpg,81,67,63,4,18,0.9402985074626866,0.7777777777777778
2022,ONAGRI,CITRANGE C35,401660,IMG-00001.jpg,56,58,53,5,3,0.913793103448276,0.9464285714285714
2022,ONAGRI,CITRANGE C35,401660,IMG-00008-44.jpg,42,41,39,2,3,0.951219512195122,0.9285714285714286
2022,ONAGRI,CITRANGE C35,401660,IMG-00010-44.jpg,29,28,26,2,3,0.9285714285714286,0.896551724137931
2022,ONAGRI,CITRANGE C35,401660,IMG-00016-44.jpg,64,61,58,3,6,0.9508196721311476,0.90625
2022,ONAGRI,CITRANGE C35,401710,IMG-00003-44.jpg,51,37,37,0,14,1.0,0.7254901960784313
2022,ONAGRI,CITRANGE C35,401710,IMG-00012-44.jpg,19,17,17,0,2,1.0,0.8947368421052632
2022,ONAGRI,CITRANGE C35,401710,IMG-00013-44.jpg,33,27,26,1,7,0.9629629629629628,0.7878787878787878
2022,ONAGRI,CITRANGE C35,401710,IMG-00019-44.jpg,76,70,69,1,7,0.9857142857142858,0.9078947368421052
2022,ONAGRI,CITRANGE C35,401720,IMG-00007-44.jpg,93,94,89,5,4,0.946808510638298,0.956989247311828
2022,ONAGRI,CITRANGE C35,401720,IMG-00008-44.jpg,38,33,32,1,6,0.9696969696969696,0.8421052631578947
2022,ONAGRI,CITRANGE C35,401720,IMG-00010-44.jpg,50,40,38,2,12,0.95,0.76
2022,ONAGRI,CITRANGE C35,401720,IMG-00017-44.jpg,68,60,56,4,12,0.9333333333333332,0.8235294117647058
2022,ONAGRI,CITRANGE C35,401730,IMG-00001.jpg,19,20,19,1,0,0.95,1.0
2022,ONAGRI,CITRANGE C35,401730,IMG-00010-44.jpg,50,48,48,0,2,1.0,0.96
2022,ONAGRI,CITRANGE C35,401730,IMG-00013-44.jpg,75,73,70,3,5,0.958904109589041,0.9333333333333332
2022,ONAGRI,CITRANGE C35,401730,IMG-00016-44.jpg,36,34,34,0,2,1.0,0.9444444444444444
2022,ONAGRI,CITRANGE C35,401750,IMG-00005-44.jpg,88,66,62,4,26,0.9393939393939394,0.7045454545454546
2022,ONAGRI,CITRANGE C35,401750,IMG-00009-44.jpg,127,110,107,3,20,0.9727272727272728,0.84251968503937
2022,ONAGRI,CITRANGE C35,401750,IMG-00016-44.jpg,107,96,94,2,13,0.9791666666666666,0.8785046728971962
2022,ONAGRI,CITRANGE C35,401750,IMG-00024-44.jpg,50,45,39,6,11,0.8666666666666667,0.78
2022,ONAGRI,CITRUMELO SACCATON,401770,IMG-00003-44.jpg,24,25,21,4,3,0.84,0.875
2022,ONAGRI,CITRUMELO SACCATON,401770,IMG-00008-44.jpg,72,75,70,5,2,0.9333333333333332,0.9722222222222222
2022,ONAGRI,CITRUMELO SACCATON,401770,IMG-00009-44.jpg,14,12,11,1,3,0.9166666666666666,0.7857142857142857
2022,ONAGRI,CITRUMELO SACCATON,401770,IMG-00017-44.jpg,20,16,15,1,5,0.9375,0.75
2022,KHOUALKA,BIGARADIER,402440,IMG-00005-43.jpg,17,11,10,1,7,0.9090909090909092,0.5882352941176471
2022,KHOUALKA,BIGARADIER,402440,IMG-00012-43.jpg,46,38,36,2,10,0.9473684210526316,0.782608695652174
2022,KHOUALKA,BIGARADIER,402440,IMG-00014-43.jpg,11,7,7,0,4,1.0,0.6363636363636364
2022,KHOUALKA,BIGARADIER,402440,IMG-00015-43.jpg,22,12,12,0,10,1.0,0.5454545454545454
2022,KHOUALKA,BIGARADIER,402590,IMG-00007-43.jpg,104,83,81,2,23,0.9759036144578314,0.7788461538461539
2022,KHOUALKA,BIGARADIER,402590,IMG-00012-43.jpg,45,44,43,1,2,0.9772727272727272,0.9555555555555556
2022,KHOUALKA,BIGARADIER,402590,IMG-00015-43.jpg,58,53,49,4,9,0.9245283018867924,0.8448275862068966
2022,KHOUALKA,BIGARADIER,402590,IMG-00019-43.jpg,64,61,61,0,3,1.0,0.953125
2022,KHOUALKA,CITRUS VOLKAMERIANA,501520,IMG-00004-43.jpg,39,32,32,0,7,1.0,0.8205128205128205
2022,KHOUALKA,CITRUS VOLKAMERIANA,501520,IMG-00007-43.jpg,43,38,37,1,6,0.9736842105263158,0.8604651162790697
2022,KHOUALKA,CITRUS VOLKAMERIANA,501520,IMG-00015-43.jpg,18,12,11,1,7,0.9166666666666666,0.6111111111111112
2022,KHOUALKA,CITRUS VOLKAMERIANA,501520,IMG-00020-43.jpg,48,43,41,2,7,0.9534883720930232,0.8541666666666666
2022,KHOUALKA,CITRUS VOLKAMERIANA,501540,IMG-00006-43.jpg,38,37,36,1,2,0.972972972972973,0.9473684210526316
2022,KHOUALKA,CITRUS VOLKAMERIANA,501540,IMG-00012-43.jpg,102,98,94,4,8,0.9591836734693876,0.9215686274509804
2022,KHOUALKA,CITRUS VOLKAMERIANA,501540,IMG-00017-43.jpg,138,126,122,4,16,0.9682539682539684,0.8840579710144928
2022,KHOUALKA,CITRUS VOLKAMERIANA,501540,IMG-00018-43.jpg,51,45,43,2,8,0.9555555555555556,0.8431372549019608
2022,KHOUALKA,CITRUS VOLKAMERIANA,501660,IMG-00006-43.jpg,60,57,55,2,5,0.9649122807017544,0.9166666666666666
2022,KHOUALKA,CITRUS VOLKAMERIANA,501660,IMG-00016-43.jpg,63,60,56,4,7,0.9333333333333332,0.8888888888888888
2022,KHOUALKA,CITRUS VOLKAMERIANA,501660,IMG-00018-43.jpg,112,102,94,8,18,0.9215686274509804,0.8392857142857143
2022,KHOUALKA,CITRUS VOLKAMERIANA,501660,IMG-00021-43.jpg,90,101,89,12,1,0.8811881188118812,0.9888888888888888
2022,KHOUALKA,CITRUS VOLKAMERIANA,501680,IMG-00005-43.jpg,179,157,156,1,23,0.9936305732484076,0.8715083798882681
2022,KHOUALKA,CITRUS VOLKAMERIANA,501680,IMG-00011-43.jpg,101,77,77,0,24,1.0,0.7623762376237624
2022,KHOUALKA,CITRUS VOLKAMERIANA,501680,IMG-00012-43.jpg,76,62,58,4,18,0.935483870967742,0.7631578947368421
2022,KHOUALKA,CITRUS VOLKAMERIANA,501680,IMG-00016-43.jpg,113,99,96,3,17,0.9696969696969696,0.8495575221238938
2022,KHOUALKA,CITRUS VOLKAMERIANA,501690,IMG-00032-43.jpg,34,28,27,1,7,0.9642857142857144,0.7941176470588235
2022,KHOUALKA,CITRUS VOLKAMERIANA,501690,IMG-00039-43.jpg,186,163,161,2,25,0.9877300613496932,0.8655913978494624
2022,KHOUALKA,CITRUS VOLKAMERIANA,501690,IMG-00047-43.jpg,103,75,75,0,28,1.0,0.7281553398058253
2022,KHOUALKA,CITRUS VOLKAMERIANA,501690,IMG-00049-43.jpg,166,147,143,4,23,0.9727891156462584,0.8614457831325302
2022,KHOUALKA,CITRUS VOLKAMERIANA,501760,IMG-00001.jpg,94,59,58,1,36,0.9830508474576272,0.6170212765957447
2022,KHOUALKA,CITRUS VOLKAMERIANA,501760,IMG-00034-43.jpg,45,30,30,0,15,1.0,0.6666666666666666
2022,KHOUALKA,CITRUS VOLKAMERIANA,501760,IMG-00036-43.jpg,40,30,30,0,10,1.0,0.75
2022,KHOUALKA,CITRUS VOLKAMERIANA,501760,IMG-00051-43.jpg,92,73,71,2,21,0.9726027397260274,0.7717391304347826
2022,ONAGRI,CITRUMELO SACCATON,510910,IMG-00004-44.jpg,73,74,69,5,4,0.9324324324324323,0.9452054794520548
2022,ONAGRI,CITRUMELO SACCATON,510910,IMG-00008-44.jpg,152,124,123,1,29,0.9919354838709676,0.8092105263157895
2022,ONAGRI,CITRUMELO SACCATON,510910,IMG-00010-44.jpg,107,101,98,3,9,0.9702970297029704,0.9158878504672896
2022,ONAGRI,CITRUMELO SACCATON,510910,IMG-00011-44.jpg,92,90,84,6,8,0.9333333333333332,0.9130434782608696
2022,ONAGRI,CITRUMELO SACCATON,510950,IMG-00006-44.jpg,70,61,61,0,9,1.0,0.8714285714285714
2022,ONAGRI,CITRUMELO SACCATON,510950,IMG-00008-44.jpg,75,70,66,4,9,0.9428571428571428,0.88
2022,ONAGRI,CITRUMELO SACCATON,510950,IMG-00009-44.jpg,85,69,68,1,17,0.9855072463768116,0.8
2022,ONAGRI,CITRUMELO SACCATON,510950,IMG-00011-44.jpg,135,115,113,2,22,0.982608695652174,0.837037037037037
2022,ONAGRI,MC PONSIRUCE TRIFOLIATA,510980,IMG-00014-44.jpg,67,63,60,3,7,0.9523809523809524,0.8955223880597015
2022,ONAGRI,MC PONSIRUCE TRIFOLIATA,510980,IMG-00015-44.jpg,51,51,48,3,3,0.9411764705882352,0.9411764705882352
2022,ONAGRI,MC PONSIRUCE TRIFOLIATA,510980,IMG-00016-44.jpg,99,92,89,3,10,0.967391304347826,0.898989898989899
2022,ONAGRI,MC PONSIRUCE TRIFOLIATA,510980,IMG-00019-44.jpg,102,89,86,3,16,0.9662921348314608,0.8431372549019608
2022,ONAGRI,MC PONSIRUCE TRIFOLIATA,510990,IMG-00006-44.jpg,135,129,124,5,11,0.9612403100775194,0.9185185185185184
2022,ONAGRI,MC PONSIRUCE TRIFOLIATA,510990,IMG-00008-44.jpg,110,106,103,3,7,0.9716981132075472,0.9363636363636364
2022,ONAGRI,MC PONSIRUCE TRIFOLIATA,510990,IMG-00009-44.jpg,85,76,75,1,10,0.986842105263158,0.8823529411764706
2022,ONAGRI,MC PONSIRUCE TRIFOLIATA,510990,IMG-00024-44.jpg,65,61,61,0,4,1.0,0.9384615384615383
2022,ONAGRI,MC PONSIRUCE TRIFOLIATA,511030,IMG-00007-44.jpg,100,94,90,4,10,0.9574468085106383,0.9
2022,ONAGRI,MC PONSIRUCE TRIFOLIATA,511030,IMG-00016-44.jpg,63,61,59,2,4,0.9672131147540984,0.9365079365079364
2022,ONAGRI,MC PONSIRUCE TRIFOLIATA,511030,IMG-00022-44.jpg,98,93,86,7,12,0.9247311827956988,0.8775510204081632
2022,ONAGRI,MC PONSIRUCE TRIFOLIATA,511030,IMG-00027-44.jpg,82,77,76,1,6,0.987012987012987,0.926829268292683
2022,ONAGRI,MS PONSIRUCE TRIFOLIATA,511040,IMG-00004-44.jpg,77,69,69,0,8,1.0,0.8961038961038961
2022,ONAGRI,MS PONSIRUCE TRIFOLIATA,511040,IMG-00014-44.jpg,48,42,40,2,8,0.9523809523809524,0.8333333333333334
2022,ONAGRI,MS PONSIRUCE TRIFOLIATA,511040,IMG-00016-44.jpg,71,70,68,2,3,0.9714285714285714,0.9577464788732394
2022,ONAGRI,MS PONSIRUCE TRIFOLIATA,511040,IMG-00025-44.jpg,56,51,46,5,10,0.9019607843137256,0.8214285714285714
2022,ONAGRI,FUZHU,511050,IMG-00004-44.jpg,109,98,94,4,15,0.9591836734693876,0.8623853211009175
2022,ONAGRI,FUZHU,511050,IMG-00006-44.jpg,142,127,123,4,19,0.968503937007874,0.8661971830985915
2022,ONAGRI,FUZHU,511050,IMG-00011-44.jpg,172,161,153,8,19,0.9503105590062112,0.8895348837209303
2022,ONAGRI,FUZHU,511050,IMG-00022-44.jpg,194,180,177,3,17,0.9833333333333332,0.9123711340206184
2022,ONAGRI,MS PONSIRUCE TRIFOLIATA,511060,IMG-00007-44.jpg,115,110,105,5,10,0.9545454545454546,0.9130434782608696
2022,ONAGRI,MS PONSIRUCE TRIFOLIATA,511060,IMG-00016-44.jpg,102,88,81,7,21,0.9204545454545454,0.7941176470588235
2022,ONAGRI,MS PONSIRUCE TRIFOLIATA,511060,IMG-00017-44.jpg,59,51,51,0,8,1.0,0.864406779661017
2022,ONAGRI,MS PONSIRUCE TRIFOLIATA,511060,IMG-00019-44.jpg,108,99,91,8,17,0.9191919191919192,0.8425925925925926
2022,ONAGRI,FUZHU,511070,IMG-00006-44.jpg,82,79,73,6,9,0.9240506329113924,0.8902439024390244
2022,ONAGRI,FUZHU,511070,IMG-00016-44.jpg,96,88,83,5,13,0.9431818181818182,0.8645833333333334
2022,ONAGRI,FUZHU,511070,IMG-00018-44.jpg,93,83,82,1,11,0.9879518072289156,0.8817204301075269
2022,ONAGRI,FUZHU,511070,IMG-00019-44.jpg,142,131,128,3,14,0.9770992366412212,0.9014084507042254
