compagnie,Domaine,Porte-greffe,parcelle,Filename,True_count,detect_count,TP,FP,FN,Precision,Recall
2022,SAOUDA,BIGARADIER,10010,IMG-00011-45.jpg,28,28,27,1,1,0.9642857142857144,0.9642857142857144
2022,SAOUDA,BIGARADIER,10010,IMG-00012-45.jpg,27,27,26,1,1,0.9629629629629628,0.9629629629629628
2022,SAOUDA,BIGARADIER,10010,IMG-00014-45.jpg,50,53,48,5,2,0.9056603773584906,0.96
2022,SAOUDA,BIGARADIER,10010,IMG-00018-45.jpg,30,30,28,2,2,0.9333333333333332,0.9333333333333332
2022,SAOUDA,BIGARADIER,10010,IMG-00020-45.jpg,31,31,28,3,3,0.9032258064516128,0.9032258064516128
2024,SAOUDA,BIGARADIER,10010,IMG-23410.jpg,85,72,72,0,13,1.0,0.8470588235294118
2024,SAOUDA,BIGARADIER,10010,IMG-23417.jpg,86,67,65,2,21,0.9701492537313432,0.7558139534883721
2024,SAOUDA,BIGARADIER,10010,IMG-23430.jpg,74,61,61,0,13,1.0,0.8243243243243243
2024,SAOUDA,BIGARADIER,10010,IMG-23647.jpg,95,85,82,3,13,0.9647058823529412,0.8631578947368421
2024,SAOUDA,BIGARADIER,10010,IMG-23672.jpg,47,36,36,0,11,1.0,0.7659574468085106
2024,SAOUDA,BIGARADIER,10010,IMG-23707.jpg,30,26,26,0,4,1.0,0.8666666666666667
2024,SAOUDA,BIGARADIER,10010,IMG-23709.jpg,31,25,24,1,7,0.96,0.7741935483870968
2024,SAOUDA,BIGARADIER,10010,IMG-23711.jpg,79,72,65,7,14,0.9027777777777778,0.8227848101265823
2022,SAOUDA,MACROPHYLLA,10030,IMG-00158-45.jpg,101,96,93,3,8,0.96875,0.9207920792079208
2022,SAOUDA,MACROPHYLLA,10030,IMG-00159-45.jpg,155,148,137,11,18,0.9256756756756755,0.8838709677419355
2022,SAOUDA,MACROPHYLLA,10030,IMG-00162-45.jpg,119,117,110,7,9,0.9401709401709402,0.9243697478991596
2022,SAOUDA,MACROPHYLLA,10030,IMG-00169-45.jpg,72,71,67,4,5,0.943661971830986,0.9305555555555556
2022,SAOUDA,MACROPHYLLA,10031,IMG-00002-45.jpg,46,45,40,5,6,0.8888888888888888,0.8695652173913043
2022,SAOUDA,MACROPHYLLA,10031,IMG-00084-45.jpg,41,37,34,3,7,0.918918918918919,0.8292682926829268
2022,SAOUDA,MACROPHYLLA,10031,IMG-00450-45.jpg,27,31,25,6,2,0.8064516129032258,0.925925925925926
2022,SAOUDA,MACROPHYLLA,10031,IMG-00451-45.jpg,34,33,28,5,6,0.8484848484848485,0.8235294117647058
2022,SAOUDA,MACROPHYLLA,10031,IMG-00464-45.jpg,33,33,31,2,2,0.9393939393939394,0.9393939393939394
2022,ONAGRI,CITRUS VOLKAMERIANA,10101,IMG-00003-39.jpg,120,115,111,4,9,0.9652173913043478,0.925
2022,ONAGRI,CITRUS VOLKAMERIANA,10101,IMG-00010-39.jpg,85,72,68,4,17,0.9444444444444444,0.8
2024,ONAGRI,CITRUS VOLKAMERIANA,10101,IMG-10523.jpg,288,265,260,5,28,0.981132075471698,0.9027777777777778
2024,ONAGRI,CITRUS VOLKAMERIANA,10101,IMG-10545.jpg,98,96,91,5,7,0.9479166666666666,0.9285714285714286
2024,ONAGRI,CITRUS VOLKAMERIANA,10101,IMG-10558.jpg,143,137,129,8,14,0.9416058394160584,0.902097902097902
2022,ONAGRI,CITRUS VOLKAMERIANA,10102,IMG-00003-39.jpg,48,40,39,1,9,0.975,0.8125
2024,ONAGRI,CITRUS VOLKAMERIANA,10102,IMG-10637.jpg,140,140,130,10,10,0.9285714285714286,0.9285714285714286
2024,ONAGRI,CITRUS VOLKAMERIANA,10102,IMG-10658.jpg,163,153,144,9,19,0.9411764705882352,0.8834355828220859
2022,ONAGRI,CITRUS VOLKAMERIANA,10103,IMG-00003-39.jpg,215,184,178,6,37,0.967391304347826,0.827906976744186
2022,ONAGRI,CITRUS VOLKAMERIANA,10103,IMG-00008-39.jpg,195,182,172,10,23,0.945054945054945,0.882051282051282
2024,ONAGRI,CITRUS VOLKAMERIANA,10103,IMG-10614.jpg,134,135,127,8,7,0.9407407407407408,0.9477611940298508
2024,ONAGRI,CITRUS VOLKAMERIANA,10103,IMG-10630.jpg,213,202,193,9,20,0.9554455445544554,0.9061032863849764
2024,ONAGRI,CITRUS VOLKAMERIANA,10103,IMG-10631.jpg,134,127,120,7,14,0.9448818897637796,0.8955223880597015
2022,ONAGRI,CITRUS VOLKAMERIANA,10104,IMG-00004-39.jpg,65,63,56,7,9,0.8888888888888888,0.8615384615384616
2022,ONAGRI,CITRUS VOLKAMERIANA,10104,IMG-00008-39.jpg,69,62,56,6,13,0.9032258064516128,0.8115942028985508
2024,ONAGRI,CITRUS VOLKAMERIANA,10104,IMG-11267.jpg,22,17,16,1,6,0.9411764705882352,0.7272727272727273
2024,ONAGRI,CITRUS VOLKAMERIANA,10104,IMG-11327.jpg,128,117,113,4,15,0.9658119658119658,0.8828125
2024,ONAGRI,CITRUS VOLKAMERIANA,10104,IMG-11347.jpg,118,115,110,5,8,0.9565217391304348,0.9322033898305084
2024,ONAGRI,CITRUS VOLKAMERIANA,10104,IMG-11366.jpg,351,300,293,7,58,0.9766666666666668,0.8347578347578347
2024,ONAGRI,CITRUS VOLKAMERIANA,10104,IMG-11386.jpg,99,86,84,2,15,0.9767441860465116,0.8484848484848485
2022,ONAGRI,CITRUS VOLKAMERIANA,10105,IMG-00004-39.jpg,17,18,13,5,4,0.7222222222222222,0.7647058823529411
2022,ONAGRI,CITRUS VOLKAMERIANA,10105,IMG-00005-39.jpg,68,68,60,8,8,0.8823529411764706,0.8823529411764706
2022,ONAGRI,CITRUS VOLKAMERIANA,10108,IMG-00003-39.jpg,61,56,53,3,8,0.9464285714285714,0.8688524590163934
2022,ONAGRI,CITRUS VOLKAMERIANA,10108,IMG-00007-39.jpg,69,57,56,1,13,0.9824561403508772,0.8115942028985508
2022,ONAGRI,CITRUS VOLKAMERIANA,10109,IMG-00003-39.jpg,4,4,4,0,0,1.0,1.0
2022,ONAGRI,CITRUS VOLKAMERIANA,10109,IMG-00008-39.jpg,105,102,94,8,11,0.9215686274509804,0.8952380952380953
2022,KHOUALKA,CITRANGE CARRIZO,10213,IMG-00001.jpg,77,78,72,6,5,0.9230769230769232,0.935064935064935
2022,KHOUALKA,CITRANGE CARRIZO,10213,IMG-00005-40.jpg,73,73,71,2,2,0.9726027397260274,0.9726027397260274
2022,KHOUALKA,CITRANGE CARRIZO,10213,IMG-00009-40.jpg,14,18,14,4,0,0.7777777777777778,1.0
2022,KHOUALKA,CITRANGE CARRIZO,10213,IMG-00014-40.jpg,21,19,17,2,4,0.8947368421052632,0.8095238095238095
2022,KHOUALKA,CITRANGE CARRIZO,10213,IMG-00028-40.jpg,47,47,45,2,2,0.9574468085106383,0.9574468085106383
2022,KHOUALKA,CITRANGE CARRIZO,10213,IMG-00034-40.jpg,48,49,48,1,0,0.979591836734694,1.0
2022,KHOUALKA,CITRANGE CARRIZO,10213,IMG-00035-40.jpg,37,38,35,3,2,0.9210526315789472,0.945945945945946
2022,KHOUALKA,CITRANGE CARRIZO,10213,IMG-00036-40.jpg,47,51,46,5,1,0.9019607843137256,0.9787234042553192
2022,KHOUALKA,CITRANGE CARRIZO,10213,IMG-00042-40.jpg,22,24,22,2,0,0.9166666666666666,1.0
2022,KHOUALKA,CITRANGE CARRIZO,10213,IMG-00047-40.jpg,70,70,68,2,2,0.9714285714285714,0.9714285714285714
2022,KHOUALKA,CITRANGE CARRIZO,10213,IMG-00054-40.jpg,33,37,33,4,0,0.8918918918918919,1.0
2022,KHOUALKA,CITRANGE CARRIZO,10213,IMG-00055-40.jpg,93,92,88,4,5,0.9565217391304348,0.946236559139785
2022,KHOUALKA,CITRANGE CARRIZO,10213,IMG-00061-40.jpg,113,114,109,5,4,0.956140350877193,0.9646017699115044
2022,KHOUALKA,CITRANGE CARRIZO,10213,IMG-00066-40.jpg,48,49,43,6,5,0.8775510204081632,0.8958333333333334
2022,OUARGHA,MACROPHYLLA,11010,IMG-00001.jpg,40,37,37,0,3,1.0,0.925
2022,OUARGHA,MACROPHYLLA,11010,IMG-00015-41.jpg,24,23,20,3,4,0.8695652173913043,0.8333333333333334
2022,OUARGHA,MACROPHYLLA,11010,IMG-00019-41.jpg,20,23,19,4,1,0.8260869565217391,0.95
2022,OUARGHA,MACROPHYLLA,11010,IMG-00024-41.jpg,21,21,20,1,1,0.9523809523809524,0.9523809523809524
2022,OUARGHA,MACROPHYLLA,11020,IMG-00017-41.jpg,51,55,51,4,0,0.9272727272727272,1.0
2022,OUARGHA,MACROPHYLLA,11020,IMG-00018-41.jpg,13,13,13,0,0,1.0,1.0
2022,OUARGHA,CITRANGE CARRIZO,13010,IMG-00067-41.jpg,55,53,50,3,5,0.9433962264150944,0.9090909090909092
2022,OUARGHA,CITRANGE CARRIZO,13010,IMG-00086-41.jpg,49,52,47,5,2,0.903846153846154,0.9591836734693876
2022,OUARGHA,CITRANGE CARRIZO,13010,IMG-00194-41.jpg,33,34,33,1,0,0.9705882352941176,1.0
2022,OUARGHA,CITRANGE CARRIZO,13020,IMG-00023-41.jpg,31,28,28,0,3,1.0,0.9032258064516128
2022,OUARGHA,CITRANGE CARRIZO,13020,IMG-00024-41.jpg,18,18,18,0,0,1.0,1.0
2022,OUARGHA,CITRANGE CARRIZO,13020,IMG-00039-41.jpg,4,4,3,1,1,0.75,0.75
2022,OUARGHA,CITRANGE CARRIZO,13020,IMG-00040-41.jpg,6,7,5,2,1,0.7142857142857143,0.8333333333333334
2022,OUARGHA,CITRUS VOLKAMERIANA,13030,IMG-00009-41.jpg,18,17,16,1,2,0.9411764705882352,0.8888888888888888
2022,OUARGHA,CITRUS VOLKAMERIANA,13030,IMG-00013-41.jpg,46,44,42,2,4,0.9545454545454546,0.9130434782608696
2022,OUARGHA,CITRUS VOLKAMERIANA,13030,IMG-00027-41.jpg,12,10,10,0,2,1.0,0.8333333333333334
2022,OUARGHA,CITRUS VOLKAMERIANA,13030,IMG-00029-41.jpg,18,19,17,2,1,0.8947368421052632,0.9444444444444444
2022,OUARGHA,CITRUS VOLKAMERIANA,13030,IMG-00036-41.jpg,16,20,15,5,1,0.75,0.9375
2022,OUARGHA,CITRUS VOLKAMERIANA,14010,IMG-00008-41.jpg,40,40,37,3,3,0.925,0.925
2022,OUARGHA,CITRUS VOLKAMERIANA,14010,IMG-00010-41.jpg,49,45,44,1,5,0.9777777777777776,0.8979591836734694
2022,OUARGHA,CITRUS VOLKAMERIANA,14010,IMG-00011-41.jpg,47,48,46,2,1,0.9583333333333334,0.9787234042553192
2022,OUARGHA,CITRUS VOLKAMERIANA,14010,IMG-00018-41.jpg,44,45,41,4,3,0.9111111111111112,0.9318181818181818
2022,KHOUALKA,MACROPHYLLA,20118,IMG-00007-40.jpg,44,45,41,4,3,0.9111111111111112,0.9318181818181818
2022,KHOUALKA,MACROPHYLLA,20118,IMG-00008-40.jpg,115,117,111,6,4,0.9487179487179488,0.9652173913043478
2022,KHOUALKA,MACROPHYLLA,20118,IMG-00022-40.jpg,113,108,106,2,7,0.9814814814814816,0.9380530973451328
2022,KHOUALKA,MACROPHYLLA,20118,IMG-00033-40.jpg,58,60,56,4,2,0.9333333333333332,0.9655172413793104
2022,KHOUALKA,MACROPHYLLA,20118,IMG-00037-40.jpg,29,30,28,2,1,0.9333333333333332,0.9655172413793104
2022,KHOUALKA,MACROPHYLLA,20118,IMG-00042-40.jpg,137,141,133,8,4,0.9432624113475178,0.9708029197080292
2022,KHOUALKA,MACROPHYLLA,20118,IMG-00046-40.jpg,45,50,44,6,1,0.88,0.9777777777777776
2022,KHOUALKA,MACROPHYLLA,20118,IMG-00050-40.jpg,48,45,45,0,3,1.0,0.9375
2022,KHOUALKA,MACROPHYLLA,20118,IMG-00055-40.jpg,52,51,48,3,4,0.9411764705882352,0.9230769230769232
2022,KHOUALKA,MACROPHYLLA,20118,IMG-00061-40.jpg,120,125,114,11,6,0.912,0.95
2022,KHOUALKA,MACROPHYLLA,20118,IMG-00062-40.jpg,63,66,60,6,3,0.9090909090909092,0.9523809523809524
2022,KHOUALKA,MACROPHYLLA,20118,IMG-00063-40.jpg,47,50,44,6,3,0.88,0.9361702127659576
2022,KHOUALKA,MACROPHYLLA,20118,IMG-00066-40.jpg,84,88,80,8,4,0.9090909090909092,0.9523809523809524
2024,KHOUALKA,MACROPHYLLA,20118,IMG-12691.jpg,22,14,14,0,8,1.0,0.6363636363636364
2024,KHOUALKA,MACROPHYLLA,20118,IMG-12729.jpg,56,46,46,0,10,1.0,0.8214285714285714
2024,KHOUALKA,MACROPHYLLA,20118,IMG-12735.jpg,88,76,74,2,14,0.9736842105263158,0.8409090909090909
2024,KHOUALKA,MACROPHYLLA,20118,IMG-12748.jpg,107,99,97,2,10,0.9797979797979798,0.9065420560747663
2024,KHOUALKA,MACROPHYLLA,20118,IMG-12764.jpg,111,103,100,3,11,0.970873786407767,0.9009009009009008
2024,KHOUALKA,MACROPHYLLA,20118,IMG-12808.jpg,113,98,95,3,18,0.9693877551020408,0.8407079646017699
2024,KHOUALKA,MACROPHYLLA,20118,IMG-12851.jpg,24,17,16,1,8,0.9411764705882352,0.6666666666666666
2022,KHOUALKA,MACROPHYLLA,20119,IMG-00005-40.jpg,106,107,95,12,11,0.8878504672897196,0.8962264150943396
2022,KHOUALKA,MACROPHYLLA,20119,IMG-00008-40.jpg,142,141,130,11,12,0.9219858156028368,0.9154929577464788
2022,KHOUALKA,MACROPHYLLA,20119,IMG-00014-40.jpg,132,127,122,5,10,0.9606299212598424,0.9242424242424242
2022,KHOUALKA,BIGARADIER,20132,IMG-00004-40.jpg,181,173,170,3,11,0.9826589595375722,0.9392265193370166
2022,KHOUALKA,BIGARADIER,20132,IMG-00025-40.jpg,91,93,82,11,9,0.8817204301075269,0.9010989010989012
2022,KHOUALKA,BIGARADIER,20132,IMG-00028-40.jpg,49,48,45,3,4,0.9375,0.9183673469387756
2022,KHOUALKA,BIGARADIER,20132,IMG-00035-40.jpg,103,113,103,10,0,0.911504424778761,1.0
2022,KHOUALKA,BIGARADIER,20132,IMG-00039-40.jpg,119,122,114,8,5,0.9344262295081968,0.957983193277311
2022,KHOUALKA,BIGARADIER,20132,IMG-00046-40.jpg,156,155,150,5,6,0.967741935483871,0.9615384615384616
2022,KHOUALKA,BIGARADIER,20132,IMG-00051-40.jpg,108,106,101,5,7,0.9528301886792452,0.9351851851851852
2022,KHOUALKA,BIGARADIER,20132,IMG-00055-40.jpg,67,62,60,2,7,0.967741935483871,0.8955223880597015
2022,KHOUALKA,BIGARADIER,20132,IMG-00058-40.jpg,89,86,85,1,4,0.9883720930232558,0.9550561797752808
2022,KHOUALKA,BIGARADIER,20132,IMG-00059-40.jpg,139,139,131,8,8,0.9424460431654677,0.9424460431654677
2022,KHOUALKA,BIGARADIER,20132,IMG-00060-40.jpg,57,53,51,2,6,0.9622641509433962,0.8947368421052632
2022,KHOUALKA,BIGARADIER,20132,IMG-00064-40.jpg,117,118,110,8,7,0.9322033898305084,0.9401709401709402
2022,KHOUALKA,BIGARADIER,20132,IMG-00075-40.jpg,69,73,69,4,0,0.9452054794520548,1.0
2022,ONAGRI,BIGARADIER,20139,IMG-00021-39.jpg,93,89,84,5,9,0.9438202247191012,0.9032258064516128
2024,KHOUALKA,CITRUS VOLKAMERIANA,20205,IMG-12040.jpg,123,106,103,3,20,0.9716981132075472,0.8373983739837398
2024,KHOUALKA,CITRUS VOLKAMERIANA,20205,IMG-12058.jpg,116,106,106,0,10,1.0,0.913793103448276
2022,SAOUDA,CITRUS VOLKAMERIANA,21020,IMG-00033-45.jpg,67,68,62,6,5,0.9117647058823528,0.9253731343283582
2022,SAOUDA,CITRUS VOLKAMERIANA,21020,IMG-00087-45.jpg,21,17,16,1,5,0.9411764705882352,0.7619047619047619
2022,SAOUDA,CITRUS VOLKAMERIANA,21020,IMG-00138-45.jpg,40,40,38,2,2,0.95,0.95
2022,SAOUDA,CITRUS VOLKAMERIANA,21020,IMG-00145-45.jpg,37,37,34,3,3,0.918918918918919,0.918918918918919
2022,SAOUDA,CITRUS VOLKAMERIANA,21020,IMG-00155-45.jpg,38,40,35,5,3,0.875,0.9210526315789472
2022,SAOUDA,CITRUS VOLKAMERIANA,21030,IMG-00521-45.jpg,31,36,31,5,0,0.8611111111111112,1.0
2022,SAOUDA,CITRUS VOLKAMERIANA,21030,IMG-00524-45.jpg,71,75,70,5,1,0.9333333333333332,0.9859154929577464
2022,SAOUDA,CITRUS VOLKAMERIANA,21030,IMG-00536-45.jpg,41,45,38,7,3,0.8444444444444444,0.926829268292683
2022,SAOUDA,CITRUS VOLKAMERIANA,21030,IMG-00537-45.jpg,52,47,42,5,10,0.8936170212765957,0.8076923076923077
2022,SAOUDA,CITRUS VOLKAMERIANA,22020,IMG-00053-45.jpg,39,41,35,6,4,0.8536585365853658,0.8974358974358975
2022,SAOUDA,CITRUS VOLKAMERIANA,22020,IMG-00059-45.jpg,46,48,43,5,3,0.8958333333333334,0.9347826086956522
2022,SAOUDA,CITRUS VOLKAMERIANA,22020,IMG-00060-45.jpg,48,51,46,5,2,0.9019607843137256,0.9583333333333334
2022,SAOUDA,CITRUS VOLKAMERIANA,22020,IMG-00062-45.jpg,50,53,49,4,1,0.9245283018867924,0.98
2022,SAOUDA,CITRUS VOLKAMERIANA,22030,IMG-00062-45.jpg,62,64,59,5,3,0.921875,0.9516129032258064
2022,SAOUDA,CITRUS VOLKAMERIANA,22030,IMG-00063-45.jpg,83,79,75,4,8,0.9493670886075948,0.9036144578313252
2022,SAOUDA,CITRUS VOLKAMERIANA,22030,IMG-00065-45.jpg,58,58,54,4,4,0.9310344827586208,0.9310344827586208
2022,SAOUDA,CITRUS VOLKAMERIANA,22030,IMG-00068-45.jpg,66,66,62,4,4,0.9393939393939394,0.9393939393939394
2022,SAOUDA,CITRUS VOLKAMERIANA,23020,IMG-00024-45.jpg,47,48,43,5,4,0.8958333333333334,0.9148936170212766
2022,SAOUDA,CITRUS VOLKAMERIANA,23020,IMG-00032-45.jpg,33,34,33,1,0,0.9705882352941176,1.0
2022,SAOUDA,CITRUS VOLKAMERIANA,23020,IMG-00074-45.jpg,28,29,24,5,4,0.8275862068965517,0.8571428571428571
2022,SAOUDA,CITRUS VOLKAMERIANA,23020,IMG-00079-45.jpg,28,33,27,6,1,0.8181818181818182,0.9642857142857144
2022,SAOUDA,CITRUS VOLKAMERIANA,23030,IMG-00014-45.jpg,25,25,22,3,3,0.88,0.88
2022,SAOUDA,CITRUS VOLKAMERIANA,23030,IMG-00034-45.jpg,43,46,39,7,4,0.8478260869565217,0.9069767441860463
2022,SAOUDA,CITRUS VOLKAMERIANA,23030,IMG-00069-45.jpg,28,33,25,8,3,0.7575757575757576,0.8928571428571429
2022,SAOUDA,CITRUS VOLKAMERIANA,23030,IMG-00079-45.jpg,50,56,48,8,2,0.8571428571428571,0.96
2022,SAOUDA,CITRANGE CARRIZO,24010,IMG-00097-45.jpg,59,62,56,6,3,0.9032258064516128,0.9491525423728814
2022,SAOUDA,CITRANGE CARRIZO,24010,IMG-00101-45.jpg,27,30,25,5,2,0.8333333333333334,0.925925925925926
2022,SAOUDA,CITRANGE CARRIZO,24010,IMG-00111-45.jpg,54,55,52,3,2,0.9454545454545454,0.9629629629629628
2022,SAOUDA,CITRANGE CARRIZO,24010,IMG-00112-45.jpg,40,43,39,4,1,0.9069767441860463,0.975
2022,SAOUDA,CITRANGE CARRIZO,25010,IMG-00006-45.jpg,55,52,49,3,6,0.9423076923076924,0.8909090909090909
2022,SAOUDA,CITRANGE CARRIZO,25010,IMG-00007-45.jpg,77,80,75,5,2,0.9375,0.974025974025974
2022,SAOUDA,CITRANGE CARRIZO,25010,IMG-00010-45.jpg,53,53,50,3,3,0.9433962264150944,0.9433962264150944
2022,SAOUDA,CITRANGE CARRIZO,25010,IMG-00011-45.jpg,26,28,26,2,0,0.9285714285714286,1.0
2022,SAOUDA,CITRANGE CARRIZO,26010,IMG-00008-45.jpg,39,37,37,0,2,1.0,0.9487179487179488
2022,SAOUDA,CITRANGE CARRIZO,26010,IMG-00013-45.jpg,36,38,36,2,0,0.9473684210526316,1.0
2022,SAOUDA,CITRANGE CARRIZO,26010,IMG-00018-45.jpg,43,45,42,3,1,0.9333333333333332,0.9767441860465116
2022,SAOUDA,CITRANGE CARRIZO,26010,IMG-00020-45.jpg,44,44,42,2,2,0.9545454545454546,0.9545454545454546
2022,KHOUALKA,CITRANGE CARRIZO,30138,IMG-00002-40.jpg,39,40,36,4,3,0.9,0.9230769230769232
2022,KHOUALKA,CITRANGE CARRIZO,30138,IMG-00003-40.jpg,59,60,56,4,3,0.9333333333333332,0.9491525423728814
2022,KHOUALKA,CITRANGE CARRIZO,30138,IMG-00005-40.jpg,58,61,54,7,4,0.8852459016393442,0.9310344827586208
2022,KHOUALKA,CITRANGE CARRIZO,30138,IMG-00008-40.jpg,32,31,29,2,3,0.935483870967742,0.90625
2022,KHOUALKA,CITRANGE CARRIZO,30138,IMG-00011-40.jpg,26,26,26,0,0,1.0,1.0
2022,KHOUALKA,CITRANGE CARRIZO,30138,IMG-00019-40.jpg,2,2,2,0,0,1.0,1.0
2022,KHOUALKA,CITRANGE CARRIZO,30138,IMG-00037-40.jpg,30,34,30,4,0,0.8823529411764706,1.0
2022,KHOUALKA,CITRANGE CARRIZO,30138,IMG-00040-40.jpg,41,41,40,1,1,0.975609756097561,0.975609756097561
2022,KHOUALKA,CITRANGE CARRIZO,30138,IMG-00043-40.jpg,28,33,27,6,1,0.8181818181818182,0.9642857142857144
2022,KHOUALKA,CITRANGE CARRIZO,30138,IMG-00044-40.jpg,99,99,96,3,3,0.9696969696969696,0.9696969696969696
2022,KHOUALKA,CITRANGE CARRIZO,30138,IMG-00048-40.jpg,37,41,34,7,3,0.8292682926829268,0.918918918918919
2022,KHOUALKA,CITRANGE CARRIZO,30138,IMG-00057-40.jpg,73,77,69,8,4,0.8961038961038961,0.9452054794520548
2022,KHOUALKA,CITRANGE CARRIZO,30138,IMG-00063-40.jpg,89,84,81,3,8,0.9642857142857144,0.9101123595505618
2022,ONAGRI,CITRUS VOLKAMERIANA,30145,IMG-00018-39.jpg,219,198,188,10,31,0.9494949494949496,0.8584474885844748
2022,ONAGRI,CITRUS VOLKAMERIANA,30145,IMG-00043-39.jpg,64,66,60,6,4,0.9090909090909092,0.9375
2022,ONAGRI,CITRUS VOLKAMERIANA,30146,IMG-00008-39.jpg,262,249,234,15,28,0.9397590361445785,0.8931297709923665
2022,ONAGRI,CITRUS VOLKAMERIANA,30146,IMG-00045-39.jpg,190,198,178,20,12,0.898989898989899,0.936842105263158
2022,ONAGRI,CITRUS VOLKAMERIANA,30147,IMG-00002-39.jpg,269,260,248,12,21,0.953846153846154,0.9219330855018588
2022,ONAGRI,CITRUS VOLKAMERIANA,30147,IMG-00008-39.jpg,172,168,159,9,13,0.9464285714285714,0.9244186046511628
2022,ONAGRI,CITRUS VOLKAMERIANA,30148,IMG-00016-40.jpg,88,83,80,3,8,0.963855421686747,0.9090909090909092
2022,ONAGRI,CITRUS VOLKAMERIANA,30148,IMG-00047-40.jpg,34,24,24,0,10,1.0,0.7058823529411765
2022,ONAGRI,CITRUS VOLKAMERIANA,30149,IMG-00018-39.jpg,151,134,132,2,19,0.9850746268656716,0.8741721854304636
2022,ONAGRI,CITRUS VOLKAMERIANA,30149,IMG-00027-39.jpg,226,186,185,1,41,0.9946236559139784,0.8185840707964602
2022,ONAGRI,CITRUS VOLKAMERIANA,30151,IMG-00012-39.jpg,185,158,150,8,35,0.9493670886075948,0.8108108108108109
2022,ONAGRI,CITRUS VOLKAMERIANA,30151,IMG-00033-39.jpg,214,206,192,14,22,0.9320388349514565,0.897196261682243
2024,ONAGRI,CITRUS VOLKAMERIANA,30151,IMG-21881.jpg,73,58,57,1,16,0.9827586206896552,0.7808219178082192
2024,ONAGRI,CITRUS VOLKAMERIANA,30151,IMG-21935.jpg,179,161,158,3,21,0.9813664596273292,0.88268156424581
2024,ONAGRI,CITRUS VOLKAMERIANA,30151,IMG-21936.jpg,93,84,83,1,10,0.988095238095238,0.8924731182795699
2022,ONAGRI,CITRUS VOLKAMERIANA,30152,IMG-00016-39.jpg,39,39,34,5,5,0.8717948717948718,0.8717948717948718
2022,ONAGRI,CITRUS VOLKAMERIANA,30152,IMG-00019-39.jpg,139,124,115,9,24,0.9274193548387096,0.8273381294964028
2022,ONAGRI,CITRUS VOLKAMERIANA,30153,IMG-00001.jpg,157,134,127,7,30,0.9477611940298508,0.8089171974522293
2022,ONAGRI,CITRUS VOLKAMERIANA,30153,IMG-00007-39.jpg,127,117,109,8,18,0.9316239316239316,0.8582677165354331
2022,ONAGRI,CITRUS VOLKAMERIANA,30153,IMG-00013-39.jpg,159,145,139,6,20,0.9586206896551724,0.8742138364779874
2022,ONAGRI,CITRUS VOLKAMERIANA,30153,IMG-00040-39.jpg,153,142,134,8,19,0.943661971830986,0.8758169934640523
2022,ONAGRI,CITRUS VOLKAMERIANA,30154,IMG-00017-39.jpg,160,162,151,11,9,0.9320987654320988,0.94375
2022,ONAGRI,CITRUS VOLKAMERIANA,30154,IMG-00027-39.jpg,220,206,201,5,19,0.9757281553398058,0.9136363636363636
2022,ONAGRI,CITRUS VOLKAMERIANA,30154,IMG-00033-39.jpg,51,53,49,4,2,0.9245283018867924,0.9607843137254902
2022,ONAGRI,CITRUS VOLKAMERIANA,30154,IMG-00036-39.jpg,137,144,131,13,6,0.9097222222222222,0.9562043795620438
2022,ONAGRI,CITRUS VOLKAMERIANA,30154,IMG-00038-39.jpg,242,247,229,18,13,0.9271255060728744,0.9462809917355371
2022,ONAGRI,CITRUS VOLKAMERIANA,30154,IMG-00041-39.jpg,272,254,238,16,34,0.937007874015748,0.875
2022,ONAGRI,CITRUS VOLKAMERIANA,30154,IMG-00044-39.jpg,141,144,129,15,12,0.8958333333333334,0.9148936170212766
2022,ONAGRI,BIGARADIER,30155,IMG-00002-39.jpg,139,135,129,6,10,0.9555555555555556,0.9280575539568344
2022,ONAGRI,BIGARADIER,30155,IMG-00003-39.jpg,115,113,108,5,7,0.9557522123893806,0.9391304347826088
2022,ONAGRI,BIGARADIER,30155,IMG-00006-39.jpg,44,43,37,6,7,0.8604651162790697,0.8409090909090909
2022,ONAGRI,BIGARADIER,30155,IMG-00011-39.jpg,100,90,87,3,13,0.9666666666666668,0.87
2022,ONAGRI,BIGARADIER,30155,IMG-00019-39.jpg,142,133,126,7,16,0.9473684210526316,0.8873239436619719
2022,ONAGRI,BIGARADIER,30155,IMG-00026-39.jpg,124,117,110,7,14,0.9401709401709402,0.8870967741935484
2022,ONAGRI,BIGARADIER,30155,IMG-00032-39.jpg,81,75,70,5,11,0.9333333333333332,0.8641975308641975
2022,ONAGRI,BIGARADIER,30155,IMG-00039-39.jpg,19,17,15,2,4,0.8823529411764706,0.7894736842105263
2022,ONAGRI,BIGARADIER,30155,IMG-00043-39.jpg,130,128,119,9,11,0.9296875,0.9153846153846154
2022,ONAGRI,CITRUS VOLKAMERIANA,30157,IMG-00003-39.jpg,227,218,209,9,18,0.9587155963302753,0.920704845814978
2022,ONAGRI,CITRUS VOLKAMERIANA,30157,IMG-00012-39.jpg,283,278,259,19,24,0.9316546762589928,0.9151943462897526
2022,ONAGRI,CITRUS VOLKAMERIANA,30157,IMG-00032-39.jpg,64,65,57,8,7,0.8769230769230769,0.890625
2022,ONAGRI,CITRUS VOLKAMERIANA,30157,IMG-00035-39.jpg,159,146,139,7,20,0.952054794520548,0.8742138364779874
2022,KHOUALKA,CITRUS VOLKAMERIANA,30235,IMG-00001.jpg,93,93,90,3,3,0.967741935483871,0.967741935483871
2022,KHOUALKA,CITRUS VOLKAMERIANA,30235,IMG-00003-40.jpg,37,37,36,1,1,0.972972972972973,0.972972972972973
2022,KHOUALKA,CITRUS VOLKAMERIANA,30235,IMG-00009-40.jpg,103,106,99,7,4,0.9339622641509434,0.9611650485436892
2022,KHOUALKA,CITRUS VOLKAMERIANA,30235,IMG-00013-40.jpg,90,91,87,4,3,0.956043956043956,0.9666666666666668
2022,KHOUALKA,CITRUS VOLKAMERIANA,30235,IMG-00026-40.jpg,122,128,118,10,4,0.921875,0.9672131147540984
2022,KHOUALKA,CITRUS VOLKAMERIANA,30235,IMG-00047-40.jpg,47,54,45,9,2,0.8333333333333334,0.9574468085106383
2022,KHOUALKA,CITRUS VOLKAMERIANA,30235,IMG-00048-40.jpg,90,92,85,7,5,0.9239130434782608,0.9444444444444444
2022,KHOUALKA,CITRUS VOLKAMERIANA,30235,IMG-00049-40.jpg,44,43,41,2,3,0.9534883720930232,0.9318181818181818
2022,KHOUALKA,CITRUS VOLKAMERIANA,30235,IMG-00050-40.jpg,84,78,75,3,9,0.9615384615384616,0.8928571428571429
2022,KHOUALKA,CITRUS VOLKAMERIANA,30235,IMG-00052-40.jpg,98,102,95,7,3,0.931372549019608,0.9693877551020408
2022,KHOUALKA,CITRUS VOLKAMERIANA,30235,IMG-00057-40.jpg,80,75,71,4,9,0.9466666666666668,0.8875
2022,KHOUALKA,CITRUS VOLKAMERIANA,30235,IMG-00064-40.jpg,38,33,32,1,6,0.9696969696969696,0.8421052631578947
2022,KHOUALKA,CITRUS VOLKAMERIANA,30235,IMG-00067-40.jpg,107,98,96,2,11,0.979591836734694,0.897196261682243
2022,KHOUALKA,CITRUS VOLKAMERIANA,30235,IMG-00069-40.jpg,34,37,33,4,1,0.8918918918918919,0.9705882352941176
2022,KHOUALKA,CITRUS VOLKAMERIANA,30235,IMG-00075-40.jpg,95,96,90,6,5,0.9375,0.9473684210526316
2022,KHOUALKA,BIGARADIER,40141,IMG-00006-40.jpg,7,7,6,1,1,0.8571428571428571,0.8571428571428571
2022,KHOUALKA,BIGARADIER,40141,IMG-00007-40.jpg,20,9,9,0,11,1.0,0.45
2022,KHOUALKA,BIGARADIER,40141,IMG-00008-40.jpg,15,12,11,1,4,0.9166666666666666,0.7333333333333333
2022,ONAGRI,CITRANGE C35,40166,IMG-00009-39.jpg,38,34,33,1,5,0.9705882352941176,0.868421052631579
2022,ONAGRI,CITRANGE C35,40166,IMG-00011-39.jpg,173,172,161,11,12,0.936046511627907,0.930635838150289
2022,ONAGRI,CITRANGE C35,40166,IMG-00014-39.jpg,179,177,171,6,8,0.9661016949152542,0.9553072625698324
2022,ONAGRI,CITRANGE C35,40166,IMG-00015-39.jpg,122,121,114,7,8,0.9421487603305784,0.9344262295081968
2022,ONAGRI,CITRANGE C35,40166,IMG-00041-39.jpg,102,97,95,2,7,0.979381443298969,0.931372549019608
2022,ONAGRI,CITRANGE C35,40167,IMG-00019-39.jpg,197,192,187,5,10,0.9739583333333334,0.949238578680203
2022,ONAGRI,CITRANGE C35,40167,IMG-00030-39.jpg,126,117,115,2,11,0.9829059829059827,0.9126984126984128
2022,ONAGRI,CITRANGE C35,40167,IMG-00039-39.jpg,217,200,188,12,29,0.94,0.8663594470046083
2022,ONAGRI,CITRANGE C35,40171,IMG-00008-39.jpg,109,98,96,2,13,0.979591836734694,0.8807339449541285
2022,ONAGRI,CITRANGE C35,40171,IMG-00037-39.jpg,94,87,84,3,10,0.9655172413793104,0.8936170212765957
2022,ONAGRI,CITRANGE C35,40171,IMG-00040-39.jpg,149,140,133,7,16,0.95,0.8926174496644296
2022,ONAGRI,CITRANGE C35,40172,IMG-00012-39.jpg,89,80,79,1,10,0.9875,0.8876404494382022
2022,ONAGRI,CITRANGE C35,40172,IMG-00025-39.jpg,109,99,96,3,13,0.9696969696969696,0.8807339449541285
2022,ONAGRI,CITRANGE C35,40172,IMG-00027-39.jpg,103,94,88,6,15,0.9361702127659576,0.8543689320388349
2022,ONAGRI,CITRANGE C35,40173,IMG-00004-39.jpg,133,120,118,2,15,0.9833333333333332,0.8872180451127819
2022,ONAGRI,CITRANGE C35,40173,IMG-00008-39.jpg,57,44,44,0,13,1.0,0.7719298245614035
2022,ONAGRI,CITRANGE C35,40173,IMG-00010-39.jpg,53,55,49,6,4,0.8909090909090909,0.9245283018867924
2022,ONAGRI,CITRANGE C35,40175,IMG-00005-39.jpg,95,81,79,2,16,0.9753086419753086,0.8315789473684211
2022,ONAGRI,CITRANGE C35,40175,IMG-00006-39.jpg,64,60,58,2,6,0.9666666666666668,0.90625
2022,ONAGRI,CITRANGE C35,40176,IMG-00004-39.jpg,79,77,70,7,9,0.9090909090909092,0.8860759493670886
2022,ONAGRI,CITRANGE C35,40176,IMG-00012-39.jpg,105,109,102,7,3,0.9357798165137616,0.9714285714285714
2022,ONAGRI,CITRANGE C35,40176,IMG-00014-39.jpg,91,92,85,7,6,0.9239130434782608,0.934065934065934
2022,ONAGRI,CITRUMELO SACCATON,40177,IMG-00012-39.jpg,89,91,84,7,5,0.9230769230769232,0.9438202247191012
2022,ONAGRI,CITRUMELO SACCATON,40177,IMG-00015-39.jpg,213,222,207,15,6,0.9324324324324323,0.971830985915493
2022,ONAGRI,CITRUMELO SACCATON,40177,IMG-00037-39.jpg,95,95,88,7,7,0.9263157894736842,0.9263157894736842
2022,ONAGRI,CITRANGE C35,40178,IMG-00013-39.jpg,76,77,74,3,2,0.961038961038961,0.9736842105263158
2022,ONAGRI,CITRANGE C35,40178,IMG-00027-39.jpg,56,57,55,2,1,0.9649122807017544,0.9821428571428572
2022,ONAGRI,CITRANGE C35,40178,IMG-00031-39.jpg,30,31,29,2,1,0.935483870967742,0.9666666666666668
2022,ONAGRI,CITRANGE C35,40178,IMG-00032-39.jpg,27,28,26,2,1,0.9285714285714286,0.9629629629629628
2022,ONAGRI,CITRANGE C35,40178,IMG-00033-39.jpg,34,34,33,1,1,0.9705882352941176,0.9705882352941176
2022,ONAGRI,CITRANGE C35,40179,IMG-00001.jpg,83,87,79,8,4,0.9080459770114944,0.9518072289156626
2022,ONAGRI,CITRANGE C35,40179,IMG-00010-39.jpg,161,157,151,6,10,0.961783439490446,0.937888198757764
2022,ONAGRI,CITRANGE C35,40179,IMG-00011-39.jpg,102,95,94,1,8,0.9894736842105264,0.9215686274509804
2022,ONAGRI,CITRANGE C35,40179,IMG-00018-39.jpg,9,10,8,2,1,0.8,0.8888888888888888
2022,ONAGRI,CITRUMELO SACCATON,40182,IMG-00004-39.jpg,35,36,34,2,1,0.9444444444444444,0.9714285714285714
2022,ONAGRI,CITRUMELO SACCATON,40182,IMG-00010-39.jpg,52,51,48,3,4,0.9411764705882352,0.9230769230769232
2022,ONAGRI,CITRUMELO SACCATON,40182,IMG-00015-39.jpg,85,82,78,4,7,0.951219512195122,0.9176470588235294
2022,ONAGRI,CITRUMELO SACCATON,40183,IMG-00005-39.jpg,68,64,64,0,4,1.0,0.9411764705882352
2022,ONAGRI,CITRUMELO SACCATON,40183,IMG-00009-39.jpg,57,56,54,2,3,0.9642857142857144,0.9473684210526316
2022,ONAGRI,CITRUMELO SACCATON,40183,IMG-00010-39.jpg,48,48,45,3,3,0.9375,0.9375
2024,KHOUALKA,CITRUS VOLKAMERIANA,50152,IMG-17274.jpg,170,151,146,5,24,0.9668874172185432,0.8588235294117647
2024,KHOUALKA,CITRUS VOLKAMERIANA,50152,IMG-17306.jpg,105,99,98,1,7,0.98989898989899,0.9333333333333332
2024,KHOUALKA,CITRUS VOLKAMERIANA,50152,IMG-17330.jpg,41,36,36,0,5,1.0,0.8780487804878049
2024,KHOUALKA,CITRUS VOLKAMERIANA,50152,IMG-17335.jpg,44,40,40,0,4,1.0,0.9090909090909092
2024,KHOUALKA,CITRUS VOLKAMERIANA,50152,IMG-17340.jpg,108,91,87,4,21,0.956043956043956,0.8055555555555556
2024,KHOUALKA,CITRUS VOLKAMERIANA,50152,IMG-17356.jpg,60,57,51,6,9,0.8947368421052632,0.85
2024,KHOUALKA,CITRUS VOLKAMERIANA,50152,IMG-17384.jpg,53,45,43,2,10,0.9555555555555556,0.8113207547169812
2024,KHOUALKA,CITRUS VOLKAMERIANA,50154,IMG-17440.jpg,76,71,69,2,7,0.971830985915493,0.9078947368421052
2024,KHOUALKA,CITRUS VOLKAMERIANA,50154,IMG-17490.jpg,107,97,96,1,11,0.9896907216494846,0.897196261682243
2024,KHOUALKA,CITRUS VOLKAMERIANA,50154,IMG-17543.jpg,100,82,80,2,20,0.975609756097561,0.8
2024,KHOUALKA,CITRUS VOLKAMERIANA,50154,IMG-17545.jpg,94,86,83,3,11,0.9651162790697676,0.8829787234042553
2024,KHOUALKA,CITRUS VOLKAMERIANA,50154,IMG-17562.jpg,129,125,119,6,10,0.952,0.9224806201550388
2024,KHOUALKA,CITRUS VOLKAMERIANA,50154,IMG-17576.jpg,121,112,109,3,12,0.9732142857142856,0.9008264462809916
2024,KHOUALKA,CITRUS VOLKAMERIANA,50154,IMG-17585.jpg,171,157,153,4,18,0.9745222929936306,0.8947368421052632
2024,KHOUALKA,CITRUS VOLKAMERIANA,50168,IMG-13980.jpg,174,152,151,1,23,0.993421052631579,0.867816091954023
2024,KHOUALKA,CITRUS VOLKAMERIANA,50168,IMG-15749.jpg,147,137,133,4,14,0.9708029197080292,0.9047619047619048
2024,KHOUALKA,CITRUS VOLKAMERIANA,50168,IMG-15758.jpg,163,153,148,5,15,0.9673202614379084,0.9079754601226994
2024,KHOUALKA,CITRUS VOLKAMERIANA,50168,IMG-15981.jpg,210,190,185,5,25,0.9736842105263158,0.8809523809523809
2024,KHOUALKA,CITRUS VOLKAMERIANA,50168,IMG-15983.jpg,120,103,101,2,19,0.9805825242718448,0.8416666666666667
2024,KHOUALKA,CITRUS VOLKAMERIANA,50176,IMG-16025.jpg,81,76,72,4,9,0.9473684210526316,0.8888888888888888
2024,KHOUALKA,CITRUS VOLKAMERIANA,50176,IMG-16051.jpg,85,77,76,1,9,0.987012987012987,0.8941176470588236
2024,KHOUALKA,CITRUS VOLKAMERIANA,50176,IMG-16079.jpg,161,142,137,5,24,0.9647887323943662,0.8509316770186336
2024,KHOUALKA,CITRUS VOLKAMERIANA,50176,IMG-16095.jpg,101,93,89,4,12,0.956989247311828,0.8811881188118812
2024,KHOUALKA,CITRUS VOLKAMERIANA,50176,IMG-16105.jpg,43,37,36,1,7,0.972972972972973,0.8372093023255814
2022,ONAGRI,CITRUMELO SACCATON,50193,IMG-00007-39.jpg,218,210,209,1,9,0.9952380952380953,0.9587155963302753
2022,ONAGRI,CITRUMELO SACCATON,50193,IMG-00016-39.jpg,64,63,58,5,6,0.9206349206349206,0.90625
2022,ONAGRI,CITRUMELO SACCATON,50193,IMG-00018-39.jpg,115,119,112,7,3,0.9411764705882352,0.9739130434782608
2022,ONAGRI,CITRUMELO SACCATON,50193,IMG-00021-39.jpg,62,60,57,3,5,0.95,0.9193548387096774
2022,ONAGRI,CITRUMELO SACCATON,50193,IMG-00023-39.jpg,113,117,108,9,5,0.9230769230769232,0.9557522123893806
2022,ONAGRI,CITRUMELO SACCATON,50194,IMG-00032-39.jpg,162,166,152,14,10,0.9156626506024096,0.9382716049382716
2022,ONAGRI,CITRUMELO SACCATON,50194,IMG-00034-39.jpg,105,112,104,8,1,0.9285714285714286,0.9904761904761904
2022,ONAGRI,CITRUMELO SACCATON,50194,IMG-00036-39.jpg,161,171,153,18,8,0.8947368421052632,0.9503105590062112
2022,ONAGRI,CITRUMELO SACCATON,50194,IMG-00038-39.jpg,100,106,96,10,4,0.9056603773584906,0.96
2022,ONAGRI,CITRUMELO SACCATON,50194,IMG-00039-39.jpg,65,64,63,1,2,0.984375,0.9692307692307692
2022,ONAGRI,CITRUMELO SACCATON,50194,IMG-00041-39.jpg,153,151,145,6,8,0.9602649006622516,0.9477124183006536
2022,ONAGRI,CITRUMELO SACCATON,50194,IMG-00051-39.jpg,137,138,132,6,5,0.9565217391304348,0.9635036496350364
2022,ONAGRI,CITRUMELO SACCATON,50194,IMG-00054-39.jpg,111,111,105,6,6,0.945945945945946,0.945945945945946
2022,ONAGRI,CITRUMELO SACCATON,51091,IMG-00015-39.jpg,85,89,82,7,3,0.9213483146067416,0.9647058823529412
2022,ONAGRI,CITRUMELO SACCATON,51091,IMG-00016-39.jpg,170,168,163,5,7,0.9702380952380952,0.9588235294117649
2022,ONAGRI,CITRUMELO SACCATON,51091,IMG-00018-39.jpg,185,194,180,14,5,0.9278350515463918,0.972972972972973
2022,ONAGRI,CITRUMELO SACCATON,51091,IMG-00022-39.jpg,135,144,132,12,3,0.9166666666666666,0.9777777777777776
2022,ONAGRI,CITRUMELO SACCATON,51091,IMG-00023-39.jpg,140,135,131,4,9,0.9703703703703704,0.9357142857142856
2022,ONAGRI,CITRUMELO SACCATON,51091,IMG-00026-39.jpg,149,144,140,4,9,0.9722222222222222,0.9395973154362416
2022,ONAGRI,CITRUMELO SACCATON,51091,IMG-00044-39.jpg,168,175,164,11,4,0.9371428571428572,0.9761904761904762
2022,ONAGRI,CITRUMELO SACCATON,51095,IMG-00004-39.jpg,201,197,185,12,16,0.9390862944162436,0.9203980099502488
2022,ONAGRI,CITRUMELO SACCATON,51095,IMG-00013-39.jpg,154,153,145,8,9,0.9477124183006536,0.9415584415584416
2022,ONAGRI,CITRUMELO SACCATON,51095,IMG-00014-39.jpg,140,137,130,7,10,0.948905109489051,0.9285714285714286
2022,ONAGRI,CITRUMELO SACCATON,51095,IMG-00015-39.jpg,196,196,190,6,6,0.9693877551020408,0.9693877551020408
2022,ONAGRI,CITRUMELO SACCATON,51095,IMG-00024-39.jpg,234,229,222,7,12,0.9694323144104804,0.9487179487179488
2022,ONAGRI,CITRUMELO SACCATON,51095,IMG-00025-39.jpg,198,198,189,9,9,0.9545454545454546,0.9545454545454546
2022,ONAGRI,CITRUMELO SACCATON,51096,IMG-00009-39.jpg,219,216,211,5,8,0.976851851851852,0.9634703196347032
2022,ONAGRI,CITRUMELO SACCATON,51096,IMG-00011-39.jpg,145,153,140,13,5,0.915032679738562,0.9655172413793104
2022,ONAGRI,CITRUMELO SACCATON,51096,IMG-00012-39.jpg,114,109,107,2,7,0.981651376146789,0.9385964912280702
2022,ONAGRI,CITRUMELO SACCATON,51096,IMG-00055-39.jpg,217,206,199,7,18,0.9660194174757282,0.9170506912442395
2022,ONAGRI,MC PONSIRUCE TRIFOLIATA,51097,IMG-00025-39.jpg,121,120,111,9,10,0.925,0.9173553719008264
2022,ONAGRI,MC PONSIRUCE TRIFOLIATA,51097,IMG-00029-39.jpg,106,110,102,8,4,0.9272727272727272,0.9622641509433962
2022,ONAGRI,MC PONSIRUCE TRIFOLIATA,51097,IMG-00044-39.jpg,182,186,173,13,9,0.9301075268817204,0.9505494505494504
2022,ONAGRI,MC PONSIRUCE TRIFOLIATA,51098,IMG-00003-39.jpg,65,69,60,9,5,0.8695652173913043,0.9230769230769232
2022,ONAGRI,MC PONSIRUCE TRIFOLIATA,51098,IMG-00010-39.jpg,184,181,173,8,11,0.9558011049723756,0.9402173913043478
2022,ONAGRI,MC PONSIRUCE TRIFOLIATA,51098,IMG-00015-39.jpg,162,166,154,12,8,0.927710843373494,0.9506172839506172
2022,ONAGRI,MC PONSIRUCE TRIFOLIATA,51099,IMG-00012-39.jpg,133,136,127,9,6,0.9338235294117648,0.9548872180451128
2024,ONAGRI,MC PONSIRUCE TRIFOLIATA,51101,IMG-12118.jpg,177,167,166,1,11,0.994011976047904,0.9378531073446328
2024,ONAGRI,MC PONSIRUCE TRIFOLIATA,51101,IMG-14223.jpg,153,135,132,3,21,0.9777777777777776,0.8627450980392157
2024,ONAGRI,MC PONSIRUCE TRIFOLIATA,51101,IMG-14226.jpg,151,139,137,2,14,0.9856115107913668,0.9072847682119204
2024,ONAGRI,MC PONSIRUCE TRIFOLIATA,51101,IMG-14255.jpg,189,175,172,3,17,0.9828571428571428,0.91005291005291
2024,ONAGRI,MC PONSIRUCE TRIFOLIATA,51101,IMG-14281.jpg,150,137,135,2,15,0.9854014598540146,0.9
2022,ONAGRI,CITRUS VOLKAMERIANA,101020,IMG-00001.jpg,6,6,6,0,0,1.0,1.0
2022,ONAGRI,CITRUS VOLKAMERIANA,101020,IMG-00004-44.jpg,53,48,46,2,7,0.9583333333333334,0.8679245283018868
2022,ONAGRI,CITRUS VOLKAMERIANA,101030,IMG-00003-44.jpg,29,29,25,4,4,0.8620689655172413,0.8620689655172413
2022,ONAGRI,CITRUS VOLKAMERIANA,101030,IMG-00004-44.jpg,110,97,94,3,16,0.9690721649484536,0.8545454545454545
2022,ONAGRI,CITRUS VOLKAMERIANA,101030,IMG-00005-44.jpg,134,125,117,8,17,0.936,0.8731343283582089
2022,ONAGRI,CITRUS VOLKAMERIANA,101030,IMG-00017-44.jpg,79,64,63,1,16,0.984375,0.7974683544303798
2022,ONAGRI,CITRUS VOLKAMERIANA,101040,IMG-00005-44.jpg,172,158,150,8,22,0.9493670886075948,0.872093023255814
2022,ONAGRI,CITRUS VOLKAMERIANA,101040,IMG-00009-44.jpg,131,140,126,14,5,0.9,0.9618320610687024
2022,ONAGRI,CITRUS VOLKAMERIANA,101040,IMG-00011-44.jpg,64,63,59,4,5,0.9365079365079364,0.921875
2022,ONAGRI,CITRUS VOLKAMERIANA,101040,IMG-00012-44.jpg,139,127,117,10,22,0.9212598425196852,0.841726618705036
2022,ONAGRI,CITRUS VOLKAMERIANA,101050,IMG-00002-44.jpg,95,90,84,6,11,0.9333333333333332,0.8842105263157894
2022,ONAGRI,CITRUS VOLKAMERIANA,101050,IMG-00005-44.jpg,59,56,54,2,5,0.9642857142857144,0.9152542372881356
2022,ONAGRI,CITRUS VOLKAMERIANA,101050,IMG-00011-44.jpg,46,39,37,2,9,0.9487179487179488,0.8043478260869565
2022,ONAGRI,CITRUS VOLKAMERIANA,101050,IMG-00024-44.jpg,40,41,38,3,2,0.926829268292683,0.95
2022,ONAGRI,CITRUS VOLKAMERIANA,101080,IMG-00005-44.jpg,42,36,32,4,10,0.8888888888888888,0.7619047619047619
2022,ONAGRI,CITRUS VOLKAMERIANA,101080,IMG-00006-44.jpg,79,65,63,2,16,0.9692307692307692,0.7974683544303798
2022,ONAGRI,CITRUS VOLKAMERIANA,101080,IMG-00023-44.jpg,7,8,7,1,0,0.875,1.0
2022,ONAGRI,CITRUS VOLKAMERIANA,101080,IMG-00024-44.jpg,27,23,22,1,5,0.9565217391304348,0.8148148148148148
2022,ONAGRI,CITRUS VOLKAMERIANA,101090,IMG-00003-44.jpg,66,60,56,4,10,0.9333333333333332,0.8484848484848485
2022,ONAGRI,CITRUS VOLKAMERIANA,101090,IMG-00006-44.jpg,41,34,31,3,10,0.9117647058823528,0.7560975609756098
2022,ONAGRI,CITRUS VOLKAMERIANA,101090,IMG-00019-44.jpg,35,35,31,4,4,0.8857142857142857,0.8857142857142857
2022,ONAGRI,CITRUS VOLKAMERIANA,101090,IMG-00020-44.jpg,42,40,38,2,4,0.95,0.9047619047619048
2022,KHOUALKA,CITRANGE CARRIZO,102130,IMG-00001.jpg,5,4,4,0,1,1.0,0.8
2022,KHOUALKA,CITRANGE CARRIZO,102130,IMG-00004-43.jpg,24,17,17,0,7,1.0,0.7083333333333334
2022,KHOUALKA,CITRANGE CARRIZO,102130,IMG-00019-43.jpg,33,37,32,5,1,0.8648648648648649,0.9696969696969696
2022,KHOUALKA,CITRANGE CARRIZO,102130,IMG-00020-43.jpg,18,21,14,7,4,0.6666666666666666,0.7777777777777778
2022,KHOUALKA,MACROPHYLLA,201180,IMG-00007-43.jpg,38,47,38,9,0,0.8085106382978723,1.0
2022,KHOUALKA,MACROPHYLLA,201180,IMG-00011-43.jpg,64,66,58,8,6,0.8787878787878788,0.90625
2022,KHOUALKA,MACROPHYLLA,201180,IMG-00019-43.jpg,64,62,59,3,5,0.9516129032258064,0.921875
2022,KHOUALKA,MACROPHYLLA,201180,IMG-00020-43.jpg,43,45,40,5,3,0.8888888888888888,0.9302325581395348
2022,KHOUALKA,MACROPHYLLA,201190,IMG-00004-43.jpg,101,89,86,3,15,0.9662921348314608,0.8514851485148515
2022,KHOUALKA,MACROPHYLLA,201190,IMG-00010-43.jpg,90,84,79,5,11,0.9404761904761904,0.8777777777777778
2022,KHOUALKA,MACROPHYLLA,201190,IMG-00011-43.jpg,134,119,112,7,22,0.9411764705882352,0.835820895522388
2022,KHOUALKA,MACROPHYLLA,201190,IMG-00020-43.jpg,95,74,72,2,23,0.972972972972973,0.7578947368421053
2022,KHOUALKA,CITRUS VOLKAMERIANA,201210,IMG-00011-43.jpg,103,95,94,1,9,0.9894736842105264,0.912621359223301
2022,KHOUALKA,CITRUS VOLKAMERIANA,201210,IMG-00012-43.jpg,42,40,38,2,4,0.95,0.9047619047619048
2022,KHOUALKA,CITRUS VOLKAMERIANA,201210,IMG-00015-43.jpg,77,68,67,1,10,0.9852941176470588,0.8701298701298701
2022,KHOUALKA,CITRUS VOLKAMERIANA,201210,IMG-00019-43.jpg,31,30,30,0,1,1.0,0.967741935483871
2022,KHOUALKA,BIGARADIER,201320,IMG-00006-43.jpg,87,68,66,2,21,0.9705882352941176,0.7586206896551724
2022,KHOUALKA,BIGARADIER,201320,IMG-00016-43.jpg,97,91,88,3,9,0.967032967032967,0.9072164948453608
2022,KHOUALKA,BIGARADIER,201320,IMG-00017-43.jpg,49,47,44,3,5,0.9361702127659576,0.8979591836734694
2022,KHOUALKA,BIGARADIER,201320,IMG-00020-43.jpg,88,88,86,2,2,0.9772727272727272,0.9772727272727272
2022,ONAGRI,BIGARADIER,201390,IMG-00008-44.jpg,62,63,58,5,4,0.9206349206349206,0.935483870967742
2022,ONAGRI,BIGARADIER,201390,IMG-00011-44.jpg,90,80,79,1,11,0.9875,0.8777777777777778
2022,ONAGRI,BIGARADIER,201390,IMG-00013-44.jpg,77,63,61,2,16,0.9682539682539684,0.7922077922077922
2022,ONAGRI,BIGARADIER,201390,IMG-00016-44.jpg,69,57,55,2,14,0.9649122807017544,0.7971014492753623
2022,KHOUALKA,CITRUS VOLKAMERIANA,202050,IMG-00006-43.jpg,89,86,84,2,5,0.9767441860465116,0.9438202247191012
2022,KHOUALKA,CITRUS VOLKAMERIANA,202050,IMG-00010-43.jpg,94,89,88,1,6,0.9887640449438202,0.9361702127659576
2022,KHOUALKA,CITRUS VOLKAMERIANA,202050,IMG-00011-43.jpg,151,143,139,4,12,0.972027972027972,0.9205298013245032
2022,KHOUALKA,CITRUS VOLKAMERIANA,202050,IMG-00020-43.jpg,129,118,116,2,13,0.9830508474576272,0.8992248062015504
2022,KHOUALKA,CITRUS VOLKAMERIANA,202070,IMG-00006-43.jpg,68,66,64,2,4,0.9696969696969696,0.9411764705882352
2022,KHOUALKA,CITRUS VOLKAMERIANA,202070,IMG-00009-43.jpg,120,122,116,6,4,0.9508196721311476,0.9666666666666668
2022,KHOUALKA,CITRUS VOLKAMERIANA,202070,IMG-00013-43.jpg,95,83,80,3,15,0.963855421686747,0.8421052631578947
2022,KHOUALKA,CITRUS VOLKAMERIANA,202070,IMG-00019-43.jpg,57,55,53,2,4,0.9636363636363636,0.9298245614035088
2022,KHOUALKA,CITRUS VOLKAMERIANA,202080,IMG-00005-43.jpg,65,62,60,2,5,0.967741935483871,0.9230769230769232
2022,KHOUALKA,CITRUS VOLKAMERIANA,202080,IMG-00008-43.jpg,31,31,29,2,2,0.935483870967742,0.935483870967742
2022,KHOUALKA,CITRUS VOLKAMERIANA,202080,IMG-00015-43.jpg,220,214,206,8,14,0.9626168224299064,0.9363636363636364
2022,KHOUALKA,CITRUS VOLKAMERIANA,202080,IMG-00016-43.jpg,131,128,124,4,7,0.96875,0.9465648854961832
2022,KHOUALKA,CITRANGE CARRIZO,301380,IMG-00007-43.jpg,30,31,26,5,4,0.8387096774193549,0.8666666666666667
2022,KHOUALKA,CITRANGE CARRIZO,301380,IMG-00011-43.jpg,53,57,52,5,1,0.912280701754386,0.981132075471698
2022,KHOUALKA,CITRANGE CARRIZO,301380,IMG-00014-43.jpg,7,7,5,2,2,0.7142857142857143,0.7142857142857143
2022,KHOUALKA,CITRANGE CARRIZO,301380,IMG-00020-43.jpg,91,99,87,12,4,0.8787878787878788,0.956043956043956
2022,ONAGRI,CITRUS VOLKAMERIANA,301470,IMG-00003-44.jpg,148,144,141,3,7,0.9791666666666666,0.9527027027027029
2022,ONAGRI,CITRUS VOLKAMERIANA,301470,IMG-00004-44.jpg,163,158,146,12,17,0.9240506329113924,0.8957055214723927
2022,ONAGRI,CITRUS VOLKAMERIANA,301470,IMG-00005-44.jpg,160,150,144,6,16,0.96,0.9
2022,ONAGRI,CITRUS VOLKAMERIANA,301480,IMG-00001.jpg,92,72,72,0,20,1.0,0.782608695652174
2022,ONAGRI,CITRUS VOLKAMERIANA,301480,IMG-00003-43.jpg,26,20,20,0,6,1.0,0.7692307692307693
2022,ONAGRI,CITRUS VOLKAMERIANA,301480,IMG-00012-43.jpg,50,42,40,2,10,0.9523809523809524,0.8
2022,ONAGRI,CITRUS VOLKAMERIANA,301480,IMG-00014-43.jpg,77,68,68,0,9,1.0,0.8831168831168831
2022,ONAGRI,CITRUS VOLKAMERIANA,301490,IMG-00005-44.jpg,108,88,83,5,25,0.9431818181818182,0.7685185185185185
2022,ONAGRI,CITRUS VOLKAMERIANA,301490,IMG-00009-44.jpg,185,178,165,13,20,0.9269662921348316,0.8918918918918919
2022,ONAGRI,CITRUS VOLKAMERIANA,301490,IMG-00012-44.jpg,162,157,149,8,13,0.9490445859872612,0.9197530864197532
2022,ONAGRI,CITRUS VOLKAMERIANA,301490,IMG-00015-44.jpg,109,100,98,2,11,0.98,0.8990825688073395
2022,ONAGRI,CITRUS VOLKAMERIANA,301510,IMG-00001.jpg,252,224,217,7,35,0.96875,0.8611111111111112
2022,ONAGRI,CITRUS VOLKAMERIANA,301510,IMG-00006-44.jpg,137,130,125,5,12,0.9615384615384616,0.9124087591240876
2022,ONAGRI,CITRUS VOLKAMERIANA,301510,IMG-00007-44.jpg,115,115,101,14,14,0.8782608695652174,0.8782608695652174
2022,ONAGRI,CITRUS VOLKAMERIANA,301510,IMG-00008-44.jpg,150,137,127,10,23,0.927007299270073,0.8466666666666667
2022,ONAGRI,BIGARADIER,301550,IMG-00008-44.jpg,144,136,131,5,13,0.9632352941176472,0.9097222222222222
2022,ONAGRI,BIGARADIER,301550,IMG-00011-44.jpg,40,37,36,1,4,0.972972972972973,0.9
2022,ONAGRI,BIGARADIER,301550,IMG-00013-44.jpg,76,67,63,4,13,0.9402985074626866,0.8289473684210527
2022,ONAGRI,BIGARADIER,301550,IMG-00014-44.jpg,80,81,74,7,6,0.9135802469135802,0.925
2022,ONAGRI,CITRUS VOLKAMERIANA,301570,IMG-00004-44.jpg,158,147,143,4,15,0.9727891156462584,0.9050632911392406
2022,ONAGRI,CITRUS VOLKAMERIANA,301570,IMG-00007-44.jpg,152,141,137,4,15,0.9716312056737588,0.9013157894736842
2022,ONAGRI,CITRUS VOLKAMERIANA,301570,IMG-00008-44.jpg,103,94,85,9,18,0.9042553191489362,0.8252427184466019
2022,ONAGRI,CITRUS VOLKAMERIANA,301570,IMG-00017-44.jpg,218,206,199,7,19,0.9660194174757282,0.9128440366972476
2022,KHOUALKA,CITRUS VOLKAMERIANA,302340,IMG-00004-43.jpg,106,89,87,2,19,0.9775280898876404,0.8207547169811321
2022,KHOUALKA,CITRUS VOLKAMERIANA,302340,IMG-00005-43.jpg,105,79,79,0,26,1.0,0.7523809523809524
2022,KHOUALKA,CITRUS VOLKAMERIANA,302340,IMG-00011-43.jpg,75,64,64,0,11,1.0,0.8533333333333334
2022,KHOUALKA,CITRUS VOLKAMERIANA,302340,IMG-00015-43.jpg,92,76,75,1,17,0.986842105263158,0.8152173913043478
2022,KHOUALKA,CITRUS VOLKAMERIANA,302350,IMG-00008-43.jpg,33,32,29,3,4,0.90625,0.8787878787878788
2022,KHOUALKA,CITRUS VOLKAMERIANA,302350,IMG-00013-43.jpg,80,74,65,9,15,0.8783783783783784,0.8125
2022,KHOUALKA,CITRUS VOLKAMERIANA,302350,IMG-00014-43.jpg,76,73,66,7,10,0.9041095890410958,0.868421052631579
2022,KHOUALKA,CITRUS VOLKAMERIANA,302350,IMG-00018-43.jpg,44,46,40,6,4,0.8695652173913043,0.9090909090909092
2022,KHOUALKA,CITRUS VOLKAMERIANA,302360,IMG-00005-43.jpg,97,90,89,1,8,0.9888888888888888,0.9175257731958762
2022,KHOUALKA,CITRUS VOLKAMERIANA,302360,IMG-00006-43.jpg,118,106,104,2,14,0.981132075471698,0.8813559322033898
2022,KHOUALKA,CITRUS VOLKAMERIANA,302360,IMG-00016-43.jpg,67,58,58,0,9,1.0,0.8656716417910447
2022,KHOUALKA,CITRUS VOLKAMERIANA,302360,IMG-00021-43.jpg,65,72,63,9,2,0.875,0.9692307692307692
2022,KHOUALKA,CITRUS VOLKAMERIANA,302510,IMG-00001.jpg,73,61,61,0,12,1.0,0.8356164383561644
2022,KHOUALKA,CITRUS VOLKAMERIANA,302510,IMG-00002-43.jpg,44,38,35,3,9,0.9210526315789472,0.7954545454545454
2022,KHOUALKA,CITRUS VOLKAMERIANA,302510,IMG-00003-43.jpg,78,75,73,2,5,0.9733333333333334,0.935897435897436
2022,KHOUALKA,CITRUS VOLKAMERIANA,302510,IMG-00015-43.jpg,49,34,34,0,15,1.0,0.6938775510204082
2022,KHOUALKA,BIGARADIER,401410,IMG-00093-43.jpg,35,23,23,0,12,1.0,0.6571428571428571
2022,KHOUALKA,BIGARADIER,401410,IMG-00099-43.jpg,6,3,3,0,3,1.0,0.5
2022,KHOUALKA,BIGARADIER,401410,IMG-00102-43.jpg,78,63,63,0,15,1.0,0.8076923076923077
2022,KHOUALKA,BIGARADIER,401410,IMG-00104-43.jpg,81,64,63,1,18,0.984375,0.7777777777777778
2022,ONAGRI,CITRANGE C35,401660,IMG-00001.jpg,56,57,53,4,3,0.9298245614035088,0.9464285714285714
2022,ONAGRI,CITRANGE C35,401660,IMG-00008-44.jpg,42,37,36,1,6,0.972972972972973,0.8571428571428571
2022,ONAGRI,CITRANGE C35,401660,IMG-00010-44.jpg,29,25,24,1,5,0.96,0.8275862068965517
2022,ONAGRI,CITRANGE C35,401660,IMG-00016-44.jpg,64,61,57,4,7,0.9344262295081968,0.890625
2022,ONAGRI,CITRANGE C35,401710,IMG-00003-44.jpg,51,38,38,0,13,1.0,0.7450980392156863
2022,ONAGRI,CITRANGE C35,401710,IMG-00012-44.jpg,19,17,17,0,2,1.0,0.8947368421052632
2022,ONAGRI,CITRANGE C35,401710,IMG-00013-44.jpg,33,29,28,1,5,0.9655172413793104,0.8484848484848485
2022,ONAGRI,CITRANGE C35,401710,IMG-00019-44.jpg,76,72,70,2,6,0.9722222222222222,0.9210526315789472
2022,ONAGRI,CITRANGE C35,401720,IMG-00007-44.jpg,93,97,91,6,2,0.9381443298969072,0.978494623655914
2022,ONAGRI,CITRANGE C35,401720,IMG-00008-44.jpg,38,34,33,1,5,0.9705882352941176,0.868421052631579
2022,ONAGRI,CITRANGE C35,401720,IMG-00010-44.jpg,50,38,36,2,14,0.9473684210526316,0.72
2022,ONAGRI,CITRANGE C35,401720,IMG-00017-44.jpg,68,61,57,4,11,0.9344262295081968,0.8382352941176471
2022,ONAGRI,CITRANGE C35,401730,IMG-00001.jpg,19,19,18,1,1,0.9473684210526316,0.9473684210526316
2022,ONAGRI,CITRANGE C35,401730,IMG-00010-44.jpg,50,47,46,1,4,0.9787234042553192,0.92
2022,ONAGRI,CITRANGE C35,401730,IMG-00013-44.jpg,75,70,68,2,7,0.9714285714285714,0.9066666666666666
2022,ONAGRI,CITRANGE C35,401730,IMG-00016-44.jpg,36,34,34,0,2,1.0,0.9444444444444444
2022,ONAGRI,CITRANGE C35,401750,IMG-00005-44.jpg,88,72,67,5,21,0.9305555555555556,0.7613636363636364
2022,ONAGRI,CITRANGE C35,401750,IMG-00009-44.jpg,127,108,106,2,21,0.9814814814814816,0.8346456692913385
2022,ONAGRI,CITRANGE C35,401750,IMG-00016-44.jpg,107,90,88,2,19,0.9777777777777776,0.822429906542056
2022,ONAGRI,CITRANGE C35,401750,IMG-00024-44.jpg,50,44,39,5,11,0.8863636363636364,0.78
2022,ONAGRI,CITRUMELO SACCATON,401770,IMG-00003-44.jpg,24,22,20,2,4,0.9090909090909092,0.8333333333333334
2022,ONAGRI,CITRUMELO SACCATON,401770,IMG-00008-44.jpg,72,72,68,4,4,0.9444444444444444,0.9444444444444444
2022,ONAGRI,CITRUMELO SACCATON,401770,IMG-00009-44.jpg,14,15,12,3,2,0.8,0.8571428571428571
2022,ONAGRI,CITRUMELO SACCATON,401770,IMG-00017-44.jpg,20,16,15,1,5,0.9375,0.75
2022,KHOUALKA,BIGARADIER,402440,IMG-00005-43.jpg,17,11,10,1,7,0.9090909090909092,0.5882352941176471
2022,KHOUALKA,BIGARADIER,402440,IMG-00012-43.jpg,46,38,37,1,9,0.9736842105263158,0.8043478260869565
2022,KHOUALKA,BIGARADIER,402440,IMG-00014-43.jpg,11,7,7,0,4,1.0,0.6363636363636364
2022,KHOUALKA,BIGARADIER,402440,IMG-00015-43.jpg,22,11,11,0,11,1.0,0.5
2022,KHOUALKA,BIGARADIER,402590,IMG-00007-43.jpg,104,81,79,2,25,0.9753086419753086,0.7596153846153846
2022,KHOUALKA,BIGARADIER,402590,IMG-00012-43.jpg,45,46,43,3,2,0.9347826086956522,0.9555555555555556
2022,KHOUALKA,BIGARADIER,402590,IMG-00015-43.jpg,58,55,50,5,8,0.9090909090909092,0.8620689655172413
2022,KHOUALKA,BIGARADIER,402590,IMG-00019-43.jpg,64,61,60,1,4,0.9836065573770492,0.9375
2022,KHOUALKA,CITRUS VOLKAMERIANA,501520,IMG-00004-43.jpg,39,32,32,0,7,1.0,0.8205128205128205
2022,KHOUALKA,CITRUS VOLKAMERIANA,501520,IMG-00007-43.jpg,43,40,38,2,5,0.95,0.8837209302325582
2022,KHOUALKA,CITRUS VOLKAMERIANA,501520,IMG-00015-43.jpg,18,11,9,2,9,0.8181818181818182,0.5
2022,KHOUALKA,CITRUS VOLKAMERIANA,501520,IMG-00020-43.jpg,48,41,41,0,7,1.0,0.8541666666666666
2022,KHOUALKA,CITRUS VOLKAMERIANA,501540,IMG-00006-43.jpg,38,37,35,2,3,0.945945945945946,0.9210526315789472
2022,KHOUALKA,CITRUS VOLKAMERIANA,501540,IMG-00012-43.jpg,102,99,94,5,8,0.9494949494949496,0.9215686274509804
2022,KHOUALKA,CITRUS VOLKAMERIANA,501540,IMG-00017-43.jpg,138,125,124,1,14,0.992,0.8985507246376812
2022,KHOUALKA,CITRUS VOLKAMERIANA,501540,IMG-00018-43.jpg,51,49,45,4,6,0.9183673469387756,0.8823529411764706
2022,KHOUALKA,CITRUS VOLKAMERIANA,501660,IMG-00006-43.jpg,60,59,56,3,4,0.9491525423728814,0.9333333333333332
2022,KHOUALKA,CITRUS VOLKAMERIANA,501660,IMG-00016-43.jpg,63,56,54,2,9,0.9642857142857144,0.8571428571428571
2022,KHOUALKA,CITRUS VOLKAMERIANA,501660,IMG-00018-43.jpg,112,101,93,8,19,0.9207920792079208,0.8303571428571429
2022,KHOUALKA,CITRUS VOLKAMERIANA,501660,IMG-00021-43.jpg,90,98,88,10,2,0.8979591836734694,0.9777777777777776
2022,KHOUALKA,CITRUS VOLKAMERIANA,501680,IMG-00005-43.jpg,179,159,159,0,20,1.0,0.888268156424581
2022,KHOUALKA,CITRUS VOLKAMERIANA,501680,IMG-00011-43.jpg,101,77,77,0,24,1.0,0.7623762376237624
2022,KHOUALKA,CITRUS VOLKAMERIANA,501680,IMG-00012-43.jpg,76,62,58,4,18,0.935483870967742,0.7631578947368421
2022,KHOUALKA,CITRUS VOLKAMERIANA,501680,IMG-00016-43.jpg,113,101,98,3,15,0.9702970297029704,0.8672566371681416
2022,KHOUALKA,CITRUS VOLKAMERIANA,501690,IMG-00032-43.jpg,34,27,25,2,9,0.925925925925926,0.7352941176470589
2022,KHOUALKA,CITRUS VOLKAMERIANA,501690,IMG-00039-43.jpg,186,160,157,3,29,0.98125,0.8440860215053764
2022,KHOUALKA,CITRUS VOLKAMERIANA,501690,IMG-00047-43.jpg,103,74,73,1,30,0.9864864864864864,0.7087378640776699
2022,KHOUALKA,CITRUS VOLKAMERIANA,501690,IMG-00049-43.jpg,166,144,142,2,24,0.9861111111111112,0.8554216867469879
2022,KHOUALKA,CITRUS VOLKAMERIANA,501760,IMG-00001.jpg,94,61,60,1,34,0.9836065573770492,0.6382978723404256
2022,KHOUALKA,CITRUS VOLKAMERIANA,501760,IMG-00034-43.jpg,45,29,29,0,16,1.0,0.6444444444444445
2022,KHOUALKA,CITRUS VOLKAMERIANA,501760,IMG-00036-43.jpg,40,31,31,0,9,1.0,0.775
2022,KHOUALKA,CITRUS VOLKAMERIANA,501760,IMG-00051-43.jpg,92,72,70,2,22,0.9722222222222222,0.7608695652173914
2022,ONAGRI,CITRUMELO SACCATON,510910,IMG-00004-44.jpg,73,72,69,3,4,0.9583333333333334,0.9452054794520548
2022,ONAGRI,CITRUMELO SACCATON,510910,IMG-00008-44.jpg,152,126,123,3,29,0.9761904761904762,0.8092105263157895
2022,ONAGRI,CITRUMELO SACCATON,510910,IMG-00010-44.jpg,107,99,96,3,11,0.9696969696969696,0.897196261682243
2022,ONAGRI,CITRUMELO SACCATON,510910,IMG-00011-44.jpg,92,84,83,1,9,0.988095238095238,0.9021739130434784
2022,ONAGRI,CITRUMELO SACCATON,510950,IMG-00006-44.jpg,70,62,62,0,8,1.0,0.8857142857142857
2022,ONAGRI,CITRUMELO SACCATON,510950,IMG-00008-44.jpg,75,73,68,5,7,0.9315068493150684,0.9066666666666666
2022,ONAGRI,CITRUMELO SACCATON,510950,IMG-00009-44.jpg,85,71,70,1,15,0.9859154929577464,0.8235294117647058
2022,ONAGRI,CITRUMELO SACCATON,510950,IMG-00011-44.jpg,135,114,112,2,23,0.9824561403508772,0.8296296296296296
2022,ONAGRI,MC PONSIRUCE TRIFOLIATA,510980,IMG-00014-44.jpg,67,63,61,2,6,0.9682539682539684,0.9104477611940298
2022,ONAGRI,MC PONSIRUCE TRIFOLIATA,510980,IMG-00015-44.jpg,51,52,49,3,2,0.9423076923076924,0.9607843137254902
2022,ONAGRI,MC PONSIRUCE TRIFOLIATA,510980,IMG-00016-44.jpg,99,92,87,5,12,0.9456521739130436,0.8787878787878788
2022,ONAGRI,MC PONSIRUCE TRIFOLIATA,510980,IMG-00019-44.jpg,102,90,88,2,14,0.9777777777777776,0.8627450980392157
2022,ONAGRI,MC PONSIRUCE TRIFOLIATA,510990,IMG-00006-44.jpg,135,128,123,5,12,0.9609375,0.9111111111111112
2022,ONAGRI,MC PONSIRUCE TRIFOLIATA,510990,IMG-00008-44.jpg,110,108,103,5,7,0.9537037037037036,0.9363636363636364
2022,ONAGRI,MC PONSIRUCE TRIFOLIATA,510990,IMG-00009-44.jpg,85,76,75,1,10,0.986842105263158,0.8823529411764706
2022,ONAGRI,MC PONSIRUCE TRIFOLIATA,510990,IMG-00024-44.jpg,65,61,61,0,4,1.0,0.9384615384615383
2022,ONAGRI,MC PONSIRUCE TRIFOLIATA,511030,IMG-00007-44.jpg,100,88,85,3,15,0.9659090909090908,0.85
2022,ONAGRI,MC PONSIRUCE TRIFOLIATA,511030,IMG-00016-44.jpg,63,58,56,2,7,0.9655172413793104,0.8888888888888888
2022,ONAGRI,MC PONSIRUCE TRIFOLIATA,511030,IMG-00022-44.jpg,98,94,88,6,10,0.9361702127659576,0.8979591836734694
2022,ONAGRI,MC PONSIRUCE TRIFOLIATA,511030,IMG-00027-44.jpg,82,78,78,0,4,1.0,0.951219512195122
2022,ONAGRI,MS PONSIRUCE TRIFOLIATA,511040,IMG-00004-44.jpg,77,67,67,0,10,1.0,0.8701298701298701
2022,ONAGRI,MS PONSIRUCE TRIFOLIATA,511040,IMG-00014-44.jpg,48,43,40,3,8,0.9302325581395348,0.8333333333333334
2022,ONAGRI,MS PONSIRUCE TRIFOLIATA,511040,IMG-00016-44.jpg,71,70,68,2,3,0.9714285714285714,0.9577464788732394
2022,ONAGRI,MS PONSIRUCE TRIFOLIATA,511040,IMG-00025-44.jpg,56,48,43,5,13,0.8958333333333334,0.7678571428571429
2022,ONAGRI,FUZHU,511050,IMG-00004-44.jpg,109,99,94,5,15,0.9494949494949496,0.8623853211009175
2022,ONAGRI,FUZHU,511050,IMG-00006-44.jpg,142,130,126,4,16,0.9692307692307692,0.8873239436619719
2022,ONAGRI,FUZHU,511050,IMG-00011-44.jpg,172,159,152,7,20,0.9559748427672956,0.8837209302325582
2022,ONAGRI,FUZHU,511050,IMG-00022-44.jpg,194,176,173,3,21,0.9829545454545454,0.8917525773195877
2022,ONAGRI,MS PONSIRUCE TRIFOLIATA,511060,IMG-00007-44.jpg,115,111,106,5,9,0.954954954954955,0.9217391304347826
2022,ONAGRI,MS PONSIRUCE TRIFOLIATA,511060,IMG-00016-44.jpg,102,86,81,5,21,0.9418604651162792,0.7941176470588235
2022,ONAGRI,MS PONSIRUCE TRIFOLIATA,511060,IMG-00017-44.jpg,59,50,50,0,9,1.0,0.847457627118644
2022,ONAGRI,MS PONSIRUCE TRIFOLIATA,511060,IMG-00019-44.jpg,108,98,94,4,14,0.9591836734693876,0.8703703703703703
2022,ONAGRI,FUZHU,511070,IMG-00006-44.jpg,82,83,76,7,6,0.9156626506024096,0.926829268292683
2022,ONAGRI,FUZHU,511070,IMG-00016-44.jpg,96,94,86,8,10,0.9148936170212766,0.8958333333333334
2022,ONAGRI,FUZHU,511070,IMG-00018-44.jpg,93,84,83,1,10,0.988095238095238,0.8924731182795699
2022,ONAGRI,FUZHU,511070,IMG-00019-44.jpg,142,134,130,4,12,0.9701492537313432,0.9154929577464788
