compagnie,Domaine,Porte-greffe,parcelle,Filename,True_count,detect_count,TP,FP,FN,Precision,Recall
2022,SAOUDA,BIGARADIER,10010,IMG-00011-45.jpg,28,37,28,9,0,0.7567567567567568,1.0
2022,SAOUDA,BIGARADIER,10010,IMG-00012-45.jpg,27,34,27,7,0,0.7941176470588235,1.0
2022,SAOUDA,BIGARADIER,10010,IMG-00014-45.jpg,50,60,49,11,1,0.8166666666666667,0.98
2022,SAOUDA,BIGARADIER,10010,IMG-00018-45.jpg,30,33,29,4,1,0.8787878787878788,0.9666666666666668
2022,SAOUDA,BIGARADIER,10010,IMG-00020-45.jpg,31,43,31,12,0,0.7209302325581395,1.0
2024,SAOUDA,BIGARADIER,10010,IMG-23410.jpg,85,73,69,4,16,0.9452054794520548,0.8117647058823529
2024,SAOUDA,BIGARADIER,10010,IMG-23417.jpg,86,62,62,0,24,1.0,0.7209302325581395
2024,SAOUDA,BIGARADIER,10010,IMG-23430.jpg,74,61,60,1,14,0.9836065573770492,0.8108108108108109
2024,SAOUDA,BIGARADIER,10010,IMG-23647.jpg,95,82,79,3,16,0.9634146341463414,0.8315789473684211
2024,SAOUDA,BIGARADIER,10010,IMG-23672.jpg,47,30,28,2,19,0.9333333333333332,0.5957446808510638
2024,SAOUDA,BIGARADIER,10010,IMG-23707.jpg,30,25,25,0,5,1.0,0.8333333333333334
2024,SAOUDA,BIGARADIER,10010,IMG-23709.jpg,31,21,21,0,10,1.0,0.6774193548387096
2024,SAOUDA,BIGARADIER,10010,IMG-23711.jpg,79,59,57,2,22,0.9661016949152542,0.7215189873417721
2022,SAOUDA,MACROPHYLLA,10030,IMG-00158-45.jpg,101,136,101,35,0,0.7426470588235294,1.0
2022,SAOUDA,MACROPHYLLA,10030,IMG-00159-45.jpg,155,197,154,43,1,0.7817258883248731,0.9935483870967742
2022,SAOUDA,MACROPHYLLA,10030,IMG-00162-45.jpg,119,145,116,29,3,0.8,0.9747899159663864
2022,SAOUDA,MACROPHYLLA,10030,IMG-00169-45.jpg,72,96,71,25,1,0.7395833333333334,0.9861111111111112
2022,SAOUDA,MACROPHYLLA,10031,IMG-00002-45.jpg,46,57,45,12,1,0.7894736842105263,0.9782608695652174
2022,SAOUDA,MACROPHYLLA,10031,IMG-00084-45.jpg,41,56,41,15,0,0.7321428571428571,1.0
2022,SAOUDA,MACROPHYLLA,10031,IMG-00450-45.jpg,27,38,26,12,1,0.6842105263157895,0.9629629629629628
2022,SAOUDA,MACROPHYLLA,10031,IMG-00451-45.jpg,34,44,32,12,2,0.7272727272727273,0.9411764705882352
2022,SAOUDA,MACROPHYLLA,10031,IMG-00464-45.jpg,33,42,32,10,1,0.7619047619047619,0.9696969696969696
2022,ONAGRI,CITRUS VOLKAMERIANA,10101,IMG-00003-39.jpg,120,120,113,7,7,0.9416666666666668,0.9416666666666668
2022,ONAGRI,CITRUS VOLKAMERIANA,10101,IMG-00010-39.jpg,85,76,73,3,12,0.9605263157894736,0.8588235294117647
2024,ONAGRI,CITRUS VOLKAMERIANA,10101,IMG-10523.jpg,288,233,233,0,55,1.0,0.8090277777777778
2024,ONAGRI,CITRUS VOLKAMERIANA,10101,IMG-10545.jpg,98,74,74,0,24,1.0,0.7551020408163265
2024,ONAGRI,CITRUS VOLKAMERIANA,10101,IMG-10558.jpg,143,101,97,4,46,0.9603960396039604,0.6783216783216783
2022,ONAGRI,CITRUS VOLKAMERIANA,10102,IMG-00003-39.jpg,48,38,38,0,10,1.0,0.7916666666666666
2024,ONAGRI,CITRUS VOLKAMERIANA,10102,IMG-10637.jpg,140,114,113,1,27,0.9912280701754386,0.8071428571428572
2024,ONAGRI,CITRUS VOLKAMERIANA,10102,IMG-10658.jpg,163,127,126,1,37,0.9921259842519684,0.7730061349693251
2022,ONAGRI,CITRUS VOLKAMERIANA,10103,IMG-00003-39.jpg,215,190,183,7,32,0.963157894736842,0.8511627906976744
2022,ONAGRI,CITRUS VOLKAMERIANA,10103,IMG-00008-39.jpg,195,185,173,12,22,0.9351351351351352,0.8871794871794871
2024,ONAGRI,CITRUS VOLKAMERIANA,10103,IMG-10614.jpg,134,110,110,0,24,1.0,0.8208955223880597
2024,ONAGRI,CITRUS VOLKAMERIANA,10103,IMG-10630.jpg,213,172,169,3,44,0.9825581395348836,0.7934272300469484
2024,ONAGRI,CITRUS VOLKAMERIANA,10103,IMG-10631.jpg,134,98,97,1,37,0.9897959183673468,0.7238805970149254
2022,ONAGRI,CITRUS VOLKAMERIANA,10104,IMG-00004-39.jpg,65,61,58,3,7,0.9508196721311476,0.8923076923076924
2022,ONAGRI,CITRUS VOLKAMERIANA,10104,IMG-00008-39.jpg,69,59,54,5,15,0.9152542372881356,0.782608695652174
2024,ONAGRI,CITRUS VOLKAMERIANA,10104,IMG-11267.jpg,22,12,12,0,10,1.0,0.5454545454545454
2024,ONAGRI,CITRUS VOLKAMERIANA,10104,IMG-11327.jpg,128,97,95,2,33,0.979381443298969,0.7421875
2024,ONAGRI,CITRUS VOLKAMERIANA,10104,IMG-11347.jpg,118,91,91,0,27,1.0,0.7711864406779662
2024,ONAGRI,CITRUS VOLKAMERIANA,10104,IMG-11366.jpg,351,255,253,2,98,0.992156862745098,0.7207977207977208
2024,ONAGRI,CITRUS VOLKAMERIANA,10104,IMG-11386.jpg,99,68,67,1,32,0.9852941176470588,0.6767676767676768
2022,ONAGRI,CITRUS VOLKAMERIANA,10105,IMG-00004-39.jpg,17,18,15,3,2,0.8333333333333334,0.8823529411764706
2022,ONAGRI,CITRUS VOLKAMERIANA,10105,IMG-00005-39.jpg,68,69,62,7,6,0.8985507246376812,0.9117647058823528
2022,ONAGRI,CITRUS VOLKAMERIANA,10108,IMG-00003-39.jpg,61,56,55,1,6,0.9821428571428572,0.9016393442622952
2022,ONAGRI,CITRUS VOLKAMERIANA,10108,IMG-00007-39.jpg,69,57,57,0,12,1.0,0.8260869565217391
2022,ONAGRI,CITRUS VOLKAMERIANA,10109,IMG-00003-39.jpg,4,4,4,0,0,1.0,1.0
2022,ONAGRI,CITRUS VOLKAMERIANA,10109,IMG-00008-39.jpg,105,102,97,5,8,0.9509803921568628,0.923809523809524
2022,KHOUALKA,CITRANGE CARRIZO,10213,IMG-00001.jpg,77,90,75,15,2,0.8333333333333334,0.974025974025974
2022,KHOUALKA,CITRANGE CARRIZO,10213,IMG-00005-40.jpg,73,83,70,13,3,0.8433734939759037,0.958904109589041
2022,KHOUALKA,CITRANGE CARRIZO,10213,IMG-00009-40.jpg,14,19,14,5,0,0.7368421052631579,1.0
2022,KHOUALKA,CITRANGE CARRIZO,10213,IMG-00014-40.jpg,21,26,21,5,0,0.8076923076923077,1.0
2022,KHOUALKA,CITRANGE CARRIZO,10213,IMG-00028-40.jpg,47,49,46,3,1,0.9387755102040816,0.9787234042553192
2022,KHOUALKA,CITRANGE CARRIZO,10213,IMG-00034-40.jpg,48,47,47,0,1,1.0,0.9791666666666666
2022,KHOUALKA,CITRANGE CARRIZO,10213,IMG-00035-40.jpg,37,38,35,3,2,0.9210526315789472,0.945945945945946
2022,KHOUALKA,CITRANGE CARRIZO,10213,IMG-00036-40.jpg,47,57,47,10,0,0.8245614035087719,1.0
2022,KHOUALKA,CITRANGE CARRIZO,10213,IMG-00042-40.jpg,22,25,22,3,0,0.88,1.0
2022,KHOUALKA,CITRANGE CARRIZO,10213,IMG-00047-40.jpg,70,73,68,5,2,0.9315068493150684,0.9714285714285714
2022,KHOUALKA,CITRANGE CARRIZO,10213,IMG-00054-40.jpg,33,37,33,4,0,0.8918918918918919,1.0
2022,KHOUALKA,CITRANGE CARRIZO,10213,IMG-00055-40.jpg,93,91,87,4,6,0.956043956043956,0.935483870967742
2022,KHOUALKA,CITRANGE CARRIZO,10213,IMG-00061-40.jpg,113,128,110,18,3,0.859375,0.9734513274336284
2022,KHOUALKA,CITRANGE CARRIZO,10213,IMG-00066-40.jpg,48,49,41,8,7,0.8367346938775511,0.8541666666666666
2024,KHOUALKA,CITRANGE CARRIZO,10213,IMG-12628.jpg,119,106,104,2,15,0.981132075471698,0.8739495798319328
2024,KHOUALKA,CITRANGE CARRIZO,10213,IMG-12774.jpg,118,101,99,2,19,0.9801980198019802,0.8389830508474576
2024,KHOUALKA,CITRANGE CARRIZO,10213,IMG-12780.jpg,44,39,39,0,5,1.0,0.8863636363636364
2024,KHOUALKA,CITRANGE CARRIZO,10213,IMG-12791.jpg,166,121,120,1,46,0.9917355371900828,0.7228915662650602
2024,KHOUALKA,CITRANGE CARRIZO,10213,IMG-12834.jpg,57,46,45,1,12,0.9782608695652174,0.7894736842105263
2024,KHOUALKA,CITRANGE CARRIZO,10213,IMG-12945.jpg,130,107,106,1,24,0.9906542056074766,0.8153846153846154
2022,OUARGHA,MACROPHYLLA,11010,IMG-00001.jpg,40,40,39,1,1,0.975,0.975
2022,OUARGHA,MACROPHYLLA,11010,IMG-00015-41.jpg,24,25,21,4,3,0.84,0.875
2022,OUARGHA,MACROPHYLLA,11010,IMG-00019-41.jpg,20,30,20,10,0,0.6666666666666666,1.0
2022,OUARGHA,MACROPHYLLA,11010,IMG-00024-41.jpg,21,24,21,3,0,0.875,1.0
2022,OUARGHA,MACROPHYLLA,11020,IMG-00017-41.jpg,51,61,51,10,0,0.8360655737704918,1.0
2022,OUARGHA,MACROPHYLLA,11020,IMG-00018-41.jpg,13,13,13,0,0,1.0,1.0
2022,OUARGHA,CITRANGE CARRIZO,13010,IMG-00067-41.jpg,55,77,54,23,1,0.7012987012987013,0.9818181818181818
2022,OUARGHA,CITRANGE CARRIZO,13010,IMG-00086-41.jpg,49,60,49,11,0,0.8166666666666667,1.0
2022,OUARGHA,CITRANGE CARRIZO,13010,IMG-00194-41.jpg,33,38,33,5,0,0.868421052631579,1.0
2022,OUARGHA,CITRANGE CARRIZO,13020,IMG-00023-41.jpg,31,34,30,4,1,0.8823529411764706,0.967741935483871
2022,OUARGHA,CITRANGE CARRIZO,13020,IMG-00024-41.jpg,18,27,18,9,0,0.6666666666666666,1.0
2022,OUARGHA,CITRANGE CARRIZO,13020,IMG-00039-41.jpg,4,11,4,7,0,0.3636363636363636,1.0
2022,OUARGHA,CITRANGE CARRIZO,13020,IMG-00040-41.jpg,6,12,6,6,0,0.5,1.0
2022,OUARGHA,CITRUS VOLKAMERIANA,13030,IMG-00009-41.jpg,18,24,18,6,0,0.75,1.0
2022,OUARGHA,CITRUS VOLKAMERIANA,13030,IMG-00013-41.jpg,46,66,46,20,0,0.696969696969697,1.0
2022,OUARGHA,CITRUS VOLKAMERIANA,13030,IMG-00027-41.jpg,12,25,12,13,0,0.48,1.0
2022,OUARGHA,CITRUS VOLKAMERIANA,13030,IMG-00029-41.jpg,18,30,18,12,0,0.6,1.0
2022,OUARGHA,CITRUS VOLKAMERIANA,13030,IMG-00036-41.jpg,16,34,16,18,0,0.4705882352941176,1.0
2022,OUARGHA,CITRUS VOLKAMERIANA,14010,IMG-00008-41.jpg,40,48,39,9,1,0.8125,0.975
2022,OUARGHA,CITRUS VOLKAMERIANA,14010,IMG-00010-41.jpg,49,56,48,8,1,0.8571428571428571,0.979591836734694
2022,OUARGHA,CITRUS VOLKAMERIANA,14010,IMG-00011-41.jpg,47,60,46,14,1,0.7666666666666667,0.9787234042553192
2022,OUARGHA,CITRUS VOLKAMERIANA,14010,IMG-00018-41.jpg,44,56,41,15,3,0.7321428571428571,0.9318181818181818
2022,KHOUALKA,MACROPHYLLA,20118,IMG-00007-40.jpg,44,45,42,3,2,0.9333333333333332,0.9545454545454546
2022,KHOUALKA,MACROPHYLLA,20118,IMG-00008-40.jpg,115,127,114,13,1,0.8976377952755905,0.991304347826087
2022,KHOUALKA,MACROPHYLLA,20118,IMG-00022-40.jpg,113,111,108,3,5,0.972972972972973,0.9557522123893806
2022,KHOUALKA,MACROPHYLLA,20118,IMG-00033-40.jpg,58,63,57,6,1,0.9047619047619048,0.9827586206896552
2022,KHOUALKA,MACROPHYLLA,20118,IMG-00037-40.jpg,29,30,27,3,2,0.9,0.9310344827586208
2022,KHOUALKA,MACROPHYLLA,20118,IMG-00042-40.jpg,137,145,134,11,3,0.9241379310344828,0.978102189781022
2022,KHOUALKA,MACROPHYLLA,20118,IMG-00046-40.jpg,45,50,44,6,1,0.88,0.9777777777777776
2022,KHOUALKA,MACROPHYLLA,20118,IMG-00050-40.jpg,48,47,46,1,2,0.9787234042553192,0.9583333333333334
2022,KHOUALKA,MACROPHYLLA,20118,IMG-00055-40.jpg,52,53,50,3,2,0.9433962264150944,0.9615384615384616
2022,KHOUALKA,MACROPHYLLA,20118,IMG-00061-40.jpg,120,128,114,14,6,0.890625,0.95
2022,KHOUALKA,MACROPHYLLA,20118,IMG-00062-40.jpg,63,56,53,3,10,0.9464285714285714,0.8412698412698413
2022,KHOUALKA,MACROPHYLLA,20118,IMG-00063-40.jpg,47,49,43,6,4,0.8775510204081632,0.9148936170212766
2022,KHOUALKA,MACROPHYLLA,20118,IMG-00066-40.jpg,84,85,79,6,5,0.9294117647058824,0.9404761904761904
2024,KHOUALKA,MACROPHYLLA,20118,IMG-12691.jpg,22,15,15,0,7,1.0,0.6818181818181818
2024,KHOUALKA,MACROPHYLLA,20118,IMG-12729.jpg,56,44,43,1,13,0.9772727272727272,0.7678571428571429
2024,KHOUALKA,MACROPHYLLA,20118,IMG-12735.jpg,88,65,64,1,24,0.9846153846153848,0.7272727272727273
2024,KHOUALKA,MACROPHYLLA,20118,IMG-12748.jpg,107,75,75,0,32,1.0,0.7009345794392523
2024,KHOUALKA,MACROPHYLLA,20118,IMG-12764.jpg,111,89,88,1,23,0.9887640449438202,0.7927927927927928
2024,KHOUALKA,MACROPHYLLA,20118,IMG-12808.jpg,113,78,78,0,35,1.0,0.6902654867256637
2024,KHOUALKA,MACROPHYLLA,20118,IMG-12851.jpg,24,12,12,0,12,1.0,0.5
2022,KHOUALKA,MACROPHYLLA,20119,IMG-00005-40.jpg,106,112,101,11,5,0.9017857142857144,0.9528301886792452
2022,KHOUALKA,MACROPHYLLA,20119,IMG-00008-40.jpg,142,152,138,14,4,0.9078947368421052,0.971830985915493
2022,KHOUALKA,MACROPHYLLA,20119,IMG-00014-40.jpg,132,137,130,7,2,0.948905109489051,0.9848484848484848
2022,KHOUALKA,BIGARADIER,20132,IMG-00004-40.jpg,181,181,175,6,6,0.9668508287292816,0.9668508287292816
2022,KHOUALKA,BIGARADIER,20132,IMG-00025-40.jpg,91,104,90,14,1,0.8653846153846154,0.989010989010989
2022,KHOUALKA,BIGARADIER,20132,IMG-00028-40.jpg,49,56,49,7,0,0.875,1.0
2022,KHOUALKA,BIGARADIER,20132,IMG-00035-40.jpg,103,115,103,12,0,0.8956521739130435,1.0
2022,KHOUALKA,BIGARADIER,20132,IMG-00039-40.jpg,119,132,117,15,2,0.8863636363636364,0.9831932773109244
2022,KHOUALKA,BIGARADIER,20132,IMG-00046-40.jpg,156,166,154,12,2,0.927710843373494,0.9871794871794872
2022,KHOUALKA,BIGARADIER,20132,IMG-00051-40.jpg,108,109,102,7,6,0.9357798165137616,0.9444444444444444
2022,KHOUALKA,BIGARADIER,20132,IMG-00055-40.jpg,67,64,61,3,6,0.953125,0.9104477611940298
2022,KHOUALKA,BIGARADIER,20132,IMG-00058-40.jpg,89,88,85,3,4,0.9659090909090908,0.9550561797752808
2022,KHOUALKA,BIGARADIER,20132,IMG-00059-40.jpg,139,139,131,8,8,0.9424460431654677,0.9424460431654677
2022,KHOUALKA,BIGARADIER,20132,IMG-00060-40.jpg,57,57,53,4,4,0.9298245614035088,0.9298245614035088
2022,KHOUALKA,BIGARADIER,20132,IMG-00064-40.jpg,117,130,114,16,3,0.8769230769230769,0.9743589743589745
2022,KHOUALKA,BIGARADIER,20132,IMG-00075-40.jpg,69,75,69,6,0,0.92,1.0
2022,ONAGRI,BIGARADIER,20139,IMG-00021-39.jpg,93,90,86,4,7,0.9555555555555556,0.9247311827956988
2024,KHOUALKA,CITRUS VOLKAMERIANA,20205,IMG-12040.jpg,123,92,89,3,34,0.967391304347826,0.7235772357723578
2024,KHOUALKA,CITRUS VOLKAMERIANA,20205,IMG-12058.jpg,116,109,108,1,8,0.9908256880733946,0.9310344827586208
2024,KHOUALKA,CITRUS VOLKAMERIANA,20207,IMG-11892.jpg,94,78,75,3,19,0.9615384615384616,0.7978723404255319
2024,KHOUALKA,CITRUS VOLKAMERIANA,20207,IMG-11921.jpg,264,188,186,2,78,0.9893617021276596,0.7045454545454546
2024,KHOUALKA,CITRUS VOLKAMERIANA,20207,IMG-11927.jpg,195,136,135,1,60,0.9926470588235294,0.6923076923076923
2024,KHOUALKA,CITRUS VOLKAMERIANA,20207,IMG-11961.jpg,113,85,85,0,28,1.0,0.7522123893805309
2024,KHOUALKA,CITRUS VOLKAMERIANA,20207,IMG-11972.jpg,94,68,65,3,29,0.9558823529411764,0.6914893617021277
2024,KHOUALKA,CITRUS VOLKAMERIANA,20207,IMG-11981.jpg,81,58,57,1,24,0.9827586206896552,0.7037037037037037
2022,SAOUDA,CITRUS VOLKAMERIANA,21020,IMG-00033-45.jpg,67,89,67,22,0,0.7528089887640449,1.0
2022,SAOUDA,CITRUS VOLKAMERIANA,21020,IMG-00087-45.jpg,21,25,19,6,2,0.76,0.9047619047619048
2022,SAOUDA,CITRUS VOLKAMERIANA,21020,IMG-00138-45.jpg,40,46,39,7,1,0.8478260869565217,0.975
2022,SAOUDA,CITRUS VOLKAMERIANA,21020,IMG-00145-45.jpg,37,42,37,5,0,0.8809523809523809,1.0
2022,SAOUDA,CITRUS VOLKAMERIANA,21020,IMG-00155-45.jpg,38,57,38,19,0,0.6666666666666666,1.0
2022,SAOUDA,CITRUS VOLKAMERIANA,21030,IMG-00521-45.jpg,31,41,31,10,0,0.7560975609756098,1.0
2022,SAOUDA,CITRUS VOLKAMERIANA,21030,IMG-00524-45.jpg,71,93,71,22,0,0.7634408602150538,1.0
2022,SAOUDA,CITRUS VOLKAMERIANA,21030,IMG-00536-45.jpg,41,62,41,21,0,0.6612903225806451,1.0
2022,SAOUDA,CITRUS VOLKAMERIANA,21030,IMG-00537-45.jpg,52,66,49,17,3,0.7424242424242424,0.9423076923076924
2022,SAOUDA,CITRUS VOLKAMERIANA,22020,IMG-00053-45.jpg,39,55,39,16,0,0.7090909090909091,1.0
2022,SAOUDA,CITRUS VOLKAMERIANA,22020,IMG-00059-45.jpg,46,56,45,11,1,0.8035714285714286,0.9782608695652174
2022,SAOUDA,CITRUS VOLKAMERIANA,22020,IMG-00060-45.jpg,48,55,46,9,2,0.8363636363636363,0.9583333333333334
2022,SAOUDA,CITRUS VOLKAMERIANA,22020,IMG-00062-45.jpg,50,67,50,17,0,0.746268656716418,1.0
2022,SAOUDA,CITRUS VOLKAMERIANA,22030,IMG-00062-45.jpg,62,71,62,9,0,0.8732394366197183,1.0
2022,SAOUDA,CITRUS VOLKAMERIANA,22030,IMG-00063-45.jpg,83,99,80,19,3,0.8080808080808081,0.963855421686747
2022,SAOUDA,CITRUS VOLKAMERIANA,22030,IMG-00065-45.jpg,58,65,57,8,1,0.8769230769230769,0.9827586206896552
2022,SAOUDA,CITRUS VOLKAMERIANA,22030,IMG-00068-45.jpg,66,79,65,14,1,0.8227848101265823,0.9848484848484848
2022,SAOUDA,CITRUS VOLKAMERIANA,23020,IMG-00024-45.jpg,47,61,45,16,2,0.7377049180327869,0.9574468085106383
2022,SAOUDA,CITRUS VOLKAMERIANA,23020,IMG-00032-45.jpg,33,37,33,4,0,0.8918918918918919,1.0
2022,SAOUDA,CITRUS VOLKAMERIANA,23020,IMG-00074-45.jpg,28,33,27,6,1,0.8181818181818182,0.9642857142857144
2022,SAOUDA,CITRUS VOLKAMERIANA,23020,IMG-00079-45.jpg,28,40,28,12,0,0.7,1.0
2022,SAOUDA,CITRUS VOLKAMERIANA,23030,IMG-00014-45.jpg,25,36,24,12,1,0.6666666666666666,0.96
2022,SAOUDA,CITRUS VOLKAMERIANA,23030,IMG-00034-45.jpg,43,60,41,19,2,0.6833333333333333,0.9534883720930232
2022,SAOUDA,CITRUS VOLKAMERIANA,23030,IMG-00069-45.jpg,28,50,27,23,1,0.54,0.9642857142857144
2022,SAOUDA,CITRUS VOLKAMERIANA,23030,IMG-00079-45.jpg,50,74,48,26,2,0.6486486486486487,0.96
2022,SAOUDA,CITRANGE CARRIZO,24010,IMG-00097-45.jpg,59,72,56,16,3,0.7777777777777778,0.9491525423728814
2022,SAOUDA,CITRANGE CARRIZO,24010,IMG-00101-45.jpg,27,34,27,7,0,0.7941176470588235,1.0
2022,SAOUDA,CITRANGE CARRIZO,24010,IMG-00111-45.jpg,54,59,53,6,1,0.8983050847457628,0.9814814814814816
2022,SAOUDA,CITRANGE CARRIZO,24010,IMG-00112-45.jpg,40,53,40,13,0,0.7547169811320755,1.0
2022,SAOUDA,CITRANGE CARRIZO,25010,IMG-00006-45.jpg,55,70,54,16,1,0.7714285714285715,0.9818181818181818
2022,SAOUDA,CITRANGE CARRIZO,25010,IMG-00007-45.jpg,77,96,77,19,0,0.8020833333333334,1.0
2022,SAOUDA,CITRANGE CARRIZO,25010,IMG-00010-45.jpg,53,71,53,18,0,0.7464788732394366,1.0
2022,SAOUDA,CITRANGE CARRIZO,25010,IMG-00011-45.jpg,26,30,26,4,0,0.8666666666666667,1.0
2022,SAOUDA,CITRANGE CARRIZO,26010,IMG-00008-45.jpg,39,44,39,5,0,0.8863636363636364,1.0
2022,SAOUDA,CITRANGE CARRIZO,26010,IMG-00013-45.jpg,36,46,36,10,0,0.782608695652174,1.0
2022,SAOUDA,CITRANGE CARRIZO,26010,IMG-00018-45.jpg,43,52,43,9,0,0.8269230769230769,1.0
2022,SAOUDA,CITRANGE CARRIZO,26010,IMG-00020-45.jpg,44,48,44,4,0,0.9166666666666666,1.0
2022,KHOUALKA,CITRANGE CARRIZO,30138,IMG-00002-40.jpg,39,41,36,5,3,0.8780487804878049,0.9230769230769232
2022,KHOUALKA,CITRANGE CARRIZO,30138,IMG-00003-40.jpg,59,63,56,7,3,0.8888888888888888,0.9491525423728814
2022,KHOUALKA,CITRANGE CARRIZO,30138,IMG-00005-40.jpg,58,62,56,6,2,0.9032258064516128,0.9655172413793104
2022,KHOUALKA,CITRANGE CARRIZO,30138,IMG-00008-40.jpg,32,34,30,4,2,0.8823529411764706,0.9375
2022,KHOUALKA,CITRANGE CARRIZO,30138,IMG-00011-40.jpg,26,26,26,0,0,1.0,1.0
2022,KHOUALKA,CITRANGE CARRIZO,30138,IMG-00019-40.jpg,2,1,1,0,1,1.0,0.5
2022,KHOUALKA,CITRANGE CARRIZO,30138,IMG-00037-40.jpg,30,32,28,4,2,0.875,0.9333333333333332
2022,KHOUALKA,CITRANGE CARRIZO,30138,IMG-00040-40.jpg,41,41,40,1,1,0.975609756097561,0.975609756097561
2022,KHOUALKA,CITRANGE CARRIZO,30138,IMG-00043-40.jpg,28,34,28,6,0,0.8235294117647058,1.0
2022,KHOUALKA,CITRANGE CARRIZO,30138,IMG-00044-40.jpg,99,100,97,3,2,0.97,0.9797979797979798
2022,KHOUALKA,CITRANGE CARRIZO,30138,IMG-00048-40.jpg,37,38,32,6,5,0.8421052631578947,0.8648648648648649
2022,KHOUALKA,CITRANGE CARRIZO,30138,IMG-00057-40.jpg,73,76,68,8,5,0.8947368421052632,0.9315068493150684
2022,KHOUALKA,CITRANGE CARRIZO,30138,IMG-00063-40.jpg,89,81,79,2,10,0.9753086419753086,0.8876404494382022
2022,ONAGRI,CITRUS VOLKAMERIANA,30145,IMG-00018-39.jpg,219,211,201,10,18,0.95260663507109,0.9178082191780822
2022,ONAGRI,CITRUS VOLKAMERIANA,30145,IMG-00043-39.jpg,64,63,59,4,5,0.9365079365079364,0.921875
2022,ONAGRI,CITRUS VOLKAMERIANA,30146,IMG-00008-39.jpg,262,243,233,10,29,0.9588477366255144,0.8893129770992366
2022,ONAGRI,CITRUS VOLKAMERIANA,30146,IMG-00045-39.jpg,190,195,181,14,9,0.9282051282051282,0.9526315789473684
2022,ONAGRI,CITRUS VOLKAMERIANA,30147,IMG-00002-39.jpg,269,256,247,9,22,0.96484375,0.9182156133828996
2022,ONAGRI,CITRUS VOLKAMERIANA,30147,IMG-00008-39.jpg,172,161,154,7,18,0.9565217391304348,0.8953488372093024
2022,ONAGRI,CITRUS VOLKAMERIANA,30148,IMG-00016-40.jpg,88,91,83,8,5,0.912087912087912,0.9431818181818182
2022,ONAGRI,CITRUS VOLKAMERIANA,30148,IMG-00047-40.jpg,34,31,31,0,3,1.0,0.9117647058823528
2022,ONAGRI,CITRUS VOLKAMERIANA,30149,IMG-00018-39.jpg,151,137,136,1,15,0.9927007299270072,0.9006622516556292
2022,ONAGRI,CITRUS VOLKAMERIANA,30149,IMG-00027-39.jpg,226,196,195,1,31,0.9948979591836736,0.8628318584070797
2022,ONAGRI,CITRUS VOLKAMERIANA,30151,IMG-00012-39.jpg,185,156,151,5,34,0.967948717948718,0.8162162162162162
2022,ONAGRI,CITRUS VOLKAMERIANA,30151,IMG-00033-39.jpg,214,209,195,14,19,0.9330143540669856,0.911214953271028
2024,ONAGRI,CITRUS VOLKAMERIANA,30151,IMG-21881.jpg,73,55,54,1,19,0.9818181818181818,0.7397260273972602
2024,ONAGRI,CITRUS VOLKAMERIANA,30151,IMG-21935.jpg,179,143,142,1,37,0.993006993006993,0.7932960893854749
2024,ONAGRI,CITRUS VOLKAMERIANA,30151,IMG-21936.jpg,93,70,70,0,23,1.0,0.7526881720430108
2022,ONAGRI,CITRUS VOLKAMERIANA,30152,IMG-00016-39.jpg,39,34,33,1,6,0.9705882352941176,0.8461538461538461
2022,ONAGRI,CITRUS VOLKAMERIANA,30152,IMG-00019-39.jpg,139,118,114,4,25,0.9661016949152542,0.8201438848920863
2022,ONAGRI,CITRUS VOLKAMERIANA,30153,IMG-00001.jpg,157,142,138,4,19,0.971830985915493,0.8789808917197452
2022,ONAGRI,CITRUS VOLKAMERIANA,30153,IMG-00007-39.jpg,127,111,109,2,18,0.981981981981982,0.8582677165354331
2022,ONAGRI,CITRUS VOLKAMERIANA,30153,IMG-00013-39.jpg,159,145,142,3,17,0.9793103448275862,0.8930817610062893
2022,ONAGRI,CITRUS VOLKAMERIANA,30153,IMG-00040-39.jpg,153,148,144,4,9,0.972972972972973,0.9411764705882352
2022,ONAGRI,CITRUS VOLKAMERIANA,30154,IMG-00017-39.jpg,160,152,148,4,12,0.9736842105263158,0.925
2022,ONAGRI,CITRUS VOLKAMERIANA,30154,IMG-00027-39.jpg,220,218,213,5,7,0.9770642201834864,0.968181818181818
2022,ONAGRI,CITRUS VOLKAMERIANA,30154,IMG-00033-39.jpg,51,49,48,1,3,0.979591836734694,0.9411764705882352
2022,ONAGRI,CITRUS VOLKAMERIANA,30154,IMG-00036-39.jpg,137,134,131,3,6,0.9776119402985076,0.9562043795620438
2022,ONAGRI,CITRUS VOLKAMERIANA,30154,IMG-00038-39.jpg,242,240,229,11,13,0.9541666666666668,0.9462809917355371
2022,ONAGRI,CITRUS VOLKAMERIANA,30154,IMG-00041-39.jpg,272,251,245,6,27,0.9760956175298804,0.9007352941176472
2022,ONAGRI,CITRUS VOLKAMERIANA,30154,IMG-00044-39.jpg,141,143,135,8,6,0.944055944055944,0.9574468085106383
2022,ONAGRI,BIGARADIER,30155,IMG-00002-39.jpg,139,141,134,7,5,0.950354609929078,0.9640287769784172
2022,ONAGRI,BIGARADIER,30155,IMG-00003-39.jpg,115,114,108,6,7,0.9473684210526316,0.9391304347826088
2022,ONAGRI,BIGARADIER,30155,IMG-00006-39.jpg,44,45,40,5,4,0.8888888888888888,0.9090909090909092
2022,ONAGRI,BIGARADIER,30155,IMG-00011-39.jpg,100,95,94,1,6,0.9894736842105264,0.94
2022,ONAGRI,BIGARADIER,30155,IMG-00019-39.jpg,142,136,128,8,14,0.9411764705882352,0.9014084507042254
2022,ONAGRI,BIGARADIER,30155,IMG-00026-39.jpg,124,118,114,4,10,0.9661016949152542,0.9193548387096774
2022,ONAGRI,BIGARADIER,30155,IMG-00032-39.jpg,81,79,76,3,5,0.9620253164556962,0.9382716049382716
2022,ONAGRI,BIGARADIER,30155,IMG-00039-39.jpg,19,17,17,0,2,1.0,0.8947368421052632
2022,ONAGRI,BIGARADIER,30155,IMG-00043-39.jpg,130,136,126,10,4,0.9264705882352942,0.9692307692307692
2022,ONAGRI,CITRUS VOLKAMERIANA,30157,IMG-00003-39.jpg,227,220,216,4,11,0.9818181818181818,0.9515418502202644
2022,ONAGRI,CITRUS VOLKAMERIANA,30157,IMG-00012-39.jpg,283,273,266,7,17,0.9743589743589745,0.939929328621908
2022,ONAGRI,CITRUS VOLKAMERIANA,30157,IMG-00032-39.jpg,64,70,63,7,1,0.9,0.984375
2022,ONAGRI,CITRUS VOLKAMERIANA,30157,IMG-00035-39.jpg,159,147,144,3,15,0.979591836734694,0.9056603773584906
2022,KHOUALKA,CITRUS VOLKAMERIANA,30235,IMG-00001.jpg,93,98,91,7,2,0.9285714285714286,0.978494623655914
2022,KHOUALKA,CITRUS VOLKAMERIANA,30235,IMG-00003-40.jpg,37,41,37,4,0,0.902439024390244,1.0
2022,KHOUALKA,CITRUS VOLKAMERIANA,30235,IMG-00009-40.jpg,103,111,102,9,1,0.918918918918919,0.9902912621359224
2022,KHOUALKA,CITRUS VOLKAMERIANA,30235,IMG-00013-40.jpg,90,99,89,10,1,0.898989898989899,0.9888888888888888
2022,KHOUALKA,CITRUS VOLKAMERIANA,30235,IMG-00026-40.jpg,122,131,120,11,2,0.916030534351145,0.9836065573770492
2022,KHOUALKA,CITRUS VOLKAMERIANA,30235,IMG-00047-40.jpg,47,53,44,9,3,0.8301886792452831,0.9361702127659576
2022,KHOUALKA,CITRUS VOLKAMERIANA,30235,IMG-00048-40.jpg,90,101,88,13,2,0.8712871287128713,0.9777777777777776
2022,KHOUALKA,CITRUS VOLKAMERIANA,30235,IMG-00049-40.jpg,44,51,43,8,1,0.8431372549019608,0.9772727272727272
2022,KHOUALKA,CITRUS VOLKAMERIANA,30235,IMG-00050-40.jpg,84,90,79,11,5,0.8777777777777778,0.9404761904761904
2022,KHOUALKA,CITRUS VOLKAMERIANA,30235,IMG-00052-40.jpg,98,114,98,16,0,0.8596491228070176,1.0
2022,KHOUALKA,CITRUS VOLKAMERIANA,30235,IMG-00057-40.jpg,80,80,76,4,4,0.95,0.95
2022,KHOUALKA,CITRUS VOLKAMERIANA,30235,IMG-00064-40.jpg,38,40,34,6,4,0.85,0.8947368421052632
2022,KHOUALKA,CITRUS VOLKAMERIANA,30235,IMG-00067-40.jpg,107,104,100,4,7,0.9615384615384616,0.9345794392523364
2022,KHOUALKA,CITRUS VOLKAMERIANA,30235,IMG-00069-40.jpg,34,39,31,8,3,0.7948717948717948,0.9117647058823528
2022,KHOUALKA,CITRUS VOLKAMERIANA,30235,IMG-00075-40.jpg,95,99,92,7,3,0.9292929292929292,0.968421052631579
2022,KHOUALKA,BIGARADIER,40141,IMG-00006-40.jpg,7,9,6,3,1,0.6666666666666666,0.8571428571428571
2022,KHOUALKA,BIGARADIER,40141,IMG-00007-40.jpg,20,12,11,1,9,0.9166666666666666,0.55
2022,KHOUALKA,BIGARADIER,40141,IMG-00008-40.jpg,15,14,12,2,3,0.8571428571428571,0.8
2022,ONAGRI,CITRANGE C35,40166,IMG-00009-39.jpg,38,38,37,1,1,0.9736842105263158,0.9736842105263158
2022,ONAGRI,CITRANGE C35,40166,IMG-00011-39.jpg,173,174,168,6,5,0.9655172413793104,0.9710982658959536
2022,ONAGRI,CITRANGE C35,40166,IMG-00014-39.jpg,179,181,177,4,2,0.9779005524861878,0.988826815642458
2022,ONAGRI,CITRANGE C35,40166,IMG-00015-39.jpg,122,123,119,4,3,0.967479674796748,0.9754098360655736
2022,ONAGRI,CITRANGE C35,40166,IMG-00041-39.jpg,102,100,98,2,4,0.98,0.9607843137254902
2022,ONAGRI,CITRANGE C35,40167,IMG-00019-39.jpg,197,200,193,7,4,0.965,0.9796954314720812
2022,ONAGRI,CITRANGE C35,40167,IMG-00030-39.jpg,126,123,120,3,6,0.975609756097561,0.9523809523809524
2022,ONAGRI,CITRANGE C35,40167,IMG-00039-39.jpg,217,208,199,9,18,0.9567307692307692,0.9170506912442395
2022,ONAGRI,CITRANGE C35,40171,IMG-00008-39.jpg,109,104,103,1,6,0.9903846153846154,0.944954128440367
2022,ONAGRI,CITRANGE C35,40171,IMG-00037-39.jpg,94,90,84,6,10,0.9333333333333332,0.8936170212765957
2022,ONAGRI,CITRANGE C35,40171,IMG-00040-39.jpg,149,144,137,7,12,0.9513888888888888,0.9194630872483222
2022,ONAGRI,CITRANGE C35,40172,IMG-00012-39.jpg,89,83,82,1,7,0.9879518072289156,0.9213483146067416
2022,ONAGRI,CITRANGE C35,40172,IMG-00025-39.jpg,109,104,102,2,7,0.9807692307692308,0.9357798165137616
2022,ONAGRI,CITRANGE C35,40172,IMG-00027-39.jpg,103,97,91,6,12,0.9381443298969072,0.883495145631068
2022,ONAGRI,CITRANGE C35,40173,IMG-00004-39.jpg,133,117,115,2,18,0.9829059829059827,0.8646616541353384
2022,ONAGRI,CITRANGE C35,40173,IMG-00008-39.jpg,57,46,45,1,12,0.9782608695652174,0.7894736842105263
2022,ONAGRI,CITRANGE C35,40173,IMG-00010-39.jpg,53,59,51,8,2,0.864406779661017,0.9622641509433962
2022,ONAGRI,CITRANGE C35,40175,IMG-00005-39.jpg,95,86,83,3,12,0.9651162790697676,0.8736842105263158
2022,ONAGRI,CITRANGE C35,40175,IMG-00006-39.jpg,64,67,62,5,2,0.9253731343283582,0.96875
2022,ONAGRI,CITRANGE C35,40176,IMG-00004-39.jpg,79,84,72,12,7,0.8571428571428571,0.9113924050632912
2022,ONAGRI,CITRANGE C35,40176,IMG-00012-39.jpg,105,107,99,8,6,0.9252336448598132,0.9428571428571428
2022,ONAGRI,CITRANGE C35,40176,IMG-00014-39.jpg,91,96,87,9,4,0.90625,0.956043956043956
2022,ONAGRI,CITRUMELO SACCATON,40177,IMG-00012-39.jpg,89,94,85,9,4,0.9042553191489362,0.9550561797752808
2022,ONAGRI,CITRUMELO SACCATON,40177,IMG-00015-39.jpg,213,223,211,12,2,0.9461883408071748,0.9906103286384976
2022,ONAGRI,CITRUMELO SACCATON,40177,IMG-00037-39.jpg,95,98,92,6,3,0.9387755102040816,0.968421052631579
2022,ONAGRI,CITRANGE C35,40178,IMG-00013-39.jpg,76,81,76,5,0,0.9382716049382716,1.0
2022,ONAGRI,CITRANGE C35,40178,IMG-00027-39.jpg,56,56,55,1,1,0.9821428571428572,0.9821428571428572
2022,ONAGRI,CITRANGE C35,40178,IMG-00031-39.jpg,30,33,30,3,0,0.9090909090909092,1.0
2022,ONAGRI,CITRANGE C35,40178,IMG-00032-39.jpg,27,28,26,2,1,0.9285714285714286,0.9629629629629628
2022,ONAGRI,CITRANGE C35,40178,IMG-00033-39.jpg,34,34,33,1,1,0.9705882352941176,0.9705882352941176
2022,ONAGRI,CITRANGE C35,40179,IMG-00001.jpg,83,89,81,8,2,0.9101123595505618,0.9759036144578314
2022,ONAGRI,CITRANGE C35,40179,IMG-00010-39.jpg,161,161,154,7,7,0.9565217391304348,0.9565217391304348
2022,ONAGRI,CITRANGE C35,40179,IMG-00011-39.jpg,102,101,96,5,6,0.9504950495049505,0.9411764705882352
2022,ONAGRI,CITRANGE C35,40179,IMG-00018-39.jpg,9,11,9,2,0,0.8181818181818182,1.0
2022,ONAGRI,CITRUMELO SACCATON,40182,IMG-00004-39.jpg,35,38,35,3,0,0.9210526315789472,1.0
2022,ONAGRI,CITRUMELO SACCATON,40182,IMG-00010-39.jpg,52,52,49,3,3,0.9423076923076924,0.9423076923076924
2022,ONAGRI,CITRUMELO SACCATON,40182,IMG-00015-39.jpg,85,87,80,7,5,0.9195402298850576,0.9411764705882352
2022,ONAGRI,CITRUMELO SACCATON,40183,IMG-00005-39.jpg,68,66,66,0,2,1.0,0.9705882352941176
2022,ONAGRI,CITRUMELO SACCATON,40183,IMG-00009-39.jpg,57,62,56,6,1,0.9032258064516128,0.9824561403508772
2022,ONAGRI,CITRUMELO SACCATON,40183,IMG-00010-39.jpg,48,51,46,5,2,0.9019607843137256,0.9583333333333334
2024,KHOUALKA,CITRUS VOLKAMERIANA,50152,IMG-17274.jpg,170,122,121,1,49,0.9918032786885246,0.711764705882353
2024,KHOUALKA,CITRUS VOLKAMERIANA,50152,IMG-17306.jpg,105,86,86,0,19,1.0,0.819047619047619
2024,KHOUALKA,CITRUS VOLKAMERIANA,50152,IMG-17330.jpg,41,29,29,0,12,1.0,0.7073170731707317
2024,KHOUALKA,CITRUS VOLKAMERIANA,50152,IMG-17335.jpg,44,31,31,0,13,1.0,0.7045454545454546
2024,KHOUALKA,CITRUS VOLKAMERIANA,50152,IMG-17340.jpg,108,71,70,1,38,0.9859154929577464,0.6481481481481481
2024,KHOUALKA,CITRUS VOLKAMERIANA,50152,IMG-17356.jpg,60,45,42,3,18,0.9333333333333332,0.7
2024,KHOUALKA,CITRUS VOLKAMERIANA,50152,IMG-17384.jpg,53,30,29,1,24,0.9666666666666668,0.5471698113207547
2024,KHOUALKA,CITRUS VOLKAMERIANA,50154,IMG-17440.jpg,76,60,60,0,16,1.0,0.7894736842105263
2024,KHOUALKA,CITRUS VOLKAMERIANA,50154,IMG-17490.jpg,107,71,70,1,37,0.9859154929577464,0.6542056074766355
2024,KHOUALKA,CITRUS VOLKAMERIANA,50154,IMG-17543.jpg,100,66,66,0,34,1.0,0.66
2024,KHOUALKA,CITRUS VOLKAMERIANA,50154,IMG-17545.jpg,94,66,66,0,28,1.0,0.7021276595744681
2024,KHOUALKA,CITRUS VOLKAMERIANA,50154,IMG-17562.jpg,129,105,104,1,25,0.9904761904761904,0.8062015503875969
2024,KHOUALKA,CITRUS VOLKAMERIANA,50154,IMG-17576.jpg,121,91,91,0,30,1.0,0.7520661157024794
2024,KHOUALKA,CITRUS VOLKAMERIANA,50154,IMG-17585.jpg,171,122,120,2,51,0.9836065573770492,0.7017543859649122
2024,KHOUALKA,CITRUS VOLKAMERIANA,50168,IMG-13980.jpg,174,122,122,0,52,1.0,0.7011494252873564
2024,KHOUALKA,CITRUS VOLKAMERIANA,50168,IMG-15749.jpg,147,116,116,0,31,1.0,0.7891156462585034
2024,KHOUALKA,CITRUS VOLKAMERIANA,50168,IMG-15758.jpg,163,126,125,1,38,0.992063492063492,0.7668711656441718
2024,KHOUALKA,CITRUS VOLKAMERIANA,50168,IMG-15981.jpg,210,155,154,1,56,0.9935483870967742,0.7333333333333333
2024,KHOUALKA,CITRUS VOLKAMERIANA,50168,IMG-15983.jpg,120,90,89,1,31,0.9888888888888888,0.7416666666666667
2024,KHOUALKA,CITRUS VOLKAMERIANA,50176,IMG-16025.jpg,81,64,64,0,17,1.0,0.7901234567901234
2024,KHOUALKA,CITRUS VOLKAMERIANA,50176,IMG-16051.jpg,85,65,65,0,20,1.0,0.7647058823529411
2024,KHOUALKA,CITRUS VOLKAMERIANA,50176,IMG-16079.jpg,161,121,120,1,41,0.9917355371900828,0.7453416149068323
2024,KHOUALKA,CITRUS VOLKAMERIANA,50176,IMG-16095.jpg,101,65,65,0,36,1.0,0.6435643564356436
2024,KHOUALKA,CITRUS VOLKAMERIANA,50176,IMG-16105.jpg,43,26,26,0,17,1.0,0.6046511627906976
2022,ONAGRI,CITRUMELO SACCATON,50193,IMG-00007-39.jpg,218,233,217,16,1,0.9313304721030042,0.9954128440366972
2022,ONAGRI,CITRUMELO SACCATON,50193,IMG-00016-39.jpg,64,75,63,12,1,0.84,0.984375
2022,ONAGRI,CITRUMELO SACCATON,50193,IMG-00018-39.jpg,115,121,112,9,3,0.9256198347107438,0.9739130434782608
2022,ONAGRI,CITRUMELO SACCATON,50193,IMG-00021-39.jpg,62,61,58,3,4,0.9508196721311476,0.935483870967742
2022,ONAGRI,CITRUMELO SACCATON,50193,IMG-00023-39.jpg,113,125,111,14,2,0.888,0.9823008849557522
2022,ONAGRI,CITRUMELO SACCATON,50194,IMG-00032-39.jpg,162,165,151,14,11,0.9151515151515152,0.9320987654320988
2022,ONAGRI,CITRUMELO SACCATON,50194,IMG-00034-39.jpg,105,111,103,8,2,0.927927927927928,0.9809523809523808
2022,ONAGRI,CITRUMELO SACCATON,50194,IMG-00036-39.jpg,161,181,154,27,7,0.850828729281768,0.9565217391304348
2022,ONAGRI,CITRUMELO SACCATON,50194,IMG-00038-39.jpg,100,113,97,16,3,0.8584070796460177,0.97
2022,ONAGRI,CITRUMELO SACCATON,50194,IMG-00039-39.jpg,65,68,63,5,2,0.9264705882352942,0.9692307692307692
2022,ONAGRI,CITRUMELO SACCATON,50194,IMG-00041-39.jpg,153,159,148,11,5,0.9308176100628932,0.9673202614379084
2022,ONAGRI,CITRUMELO SACCATON,50194,IMG-00051-39.jpg,137,143,134,9,3,0.9370629370629372,0.978102189781022
2022,ONAGRI,CITRUMELO SACCATON,50194,IMG-00054-39.jpg,111,112,104,8,7,0.9285714285714286,0.9369369369369368
2022,ONAGRI,CITRUMELO SACCATON,51091,IMG-00015-39.jpg,85,98,83,15,2,0.8469387755102041,0.976470588235294
2022,ONAGRI,CITRUMELO SACCATON,51091,IMG-00016-39.jpg,170,180,169,11,1,0.9388888888888888,0.9941176470588236
2022,ONAGRI,CITRUMELO SACCATON,51091,IMG-00018-39.jpg,185,209,183,26,2,0.8755980861244019,0.9891891891891892
2022,ONAGRI,CITRUMELO SACCATON,51091,IMG-00022-39.jpg,135,153,132,21,3,0.8627450980392157,0.9777777777777776
2022,ONAGRI,CITRUMELO SACCATON,51091,IMG-00023-39.jpg,140,148,134,14,6,0.9054054054054054,0.9571428571428572
2022,ONAGRI,CITRUMELO SACCATON,51091,IMG-00026-39.jpg,149,151,141,10,8,0.933774834437086,0.9463087248322148
2022,ONAGRI,CITRUMELO SACCATON,51091,IMG-00044-39.jpg,168,184,166,18,2,0.9021739130434784,0.988095238095238
2022,ONAGRI,CITRUMELO SACCATON,51095,IMG-00004-39.jpg,201,217,195,22,6,0.8986175115207373,0.9701492537313432
2022,ONAGRI,CITRUMELO SACCATON,51095,IMG-00013-39.jpg,154,154,145,9,9,0.9415584415584416,0.9415584415584416
2022,ONAGRI,CITRUMELO SACCATON,51095,IMG-00014-39.jpg,140,145,133,12,7,0.9172413793103448,0.95
2022,ONAGRI,CITRUMELO SACCATON,51095,IMG-00015-39.jpg,196,200,193,7,3,0.965,0.9846938775510204
2022,ONAGRI,CITRUMELO SACCATON,51095,IMG-00024-39.jpg,234,239,226,13,8,0.9456066945606696,0.9658119658119658
2022,ONAGRI,CITRUMELO SACCATON,51095,IMG-00025-39.jpg,198,217,196,21,2,0.9032258064516128,0.98989898989899
2022,ONAGRI,CITRUMELO SACCATON,51096,IMG-00009-39.jpg,219,223,211,12,8,0.9461883408071748,0.9634703196347032
2022,ONAGRI,CITRUMELO SACCATON,51096,IMG-00011-39.jpg,145,152,139,13,6,0.9144736842105264,0.9586206896551724
2022,ONAGRI,CITRUMELO SACCATON,51096,IMG-00012-39.jpg,114,111,104,7,10,0.9369369369369368,0.912280701754386
2022,ONAGRI,CITRUMELO SACCATON,51096,IMG-00055-39.jpg,217,216,206,10,11,0.9537037037037036,0.9493087557603688
2022,ONAGRI,MC PONSIRUCE TRIFOLIATA,51097,IMG-00025-39.jpg,121,134,117,17,4,0.8731343283582089,0.9669421487603306
2022,ONAGRI,MC PONSIRUCE TRIFOLIATA,51097,IMG-00029-39.jpg,106,115,103,12,3,0.8956521739130435,0.9716981132075472
2022,ONAGRI,MC PONSIRUCE TRIFOLIATA,51097,IMG-00044-39.jpg,182,189,176,13,6,0.9312169312169312,0.967032967032967
2022,ONAGRI,MC PONSIRUCE TRIFOLIATA,51098,IMG-00003-39.jpg,65,71,63,8,2,0.8873239436619719,0.9692307692307692
2022,ONAGRI,MC PONSIRUCE TRIFOLIATA,51098,IMG-00010-39.jpg,184,191,179,12,5,0.93717277486911,0.9728260869565216
2022,ONAGRI,MC PONSIRUCE TRIFOLIATA,51098,IMG-00015-39.jpg,162,170,159,11,3,0.9352941176470588,0.9814814814814816
2022,ONAGRI,MC PONSIRUCE TRIFOLIATA,51099,IMG-00012-39.jpg,133,144,130,14,3,0.9027777777777778,0.9774436090225564
2024,ONAGRI,MC PONSIRUCE TRIFOLIATA,51101,IMG-12118.jpg,177,132,131,1,46,0.9924242424242424,0.7401129943502824
2024,ONAGRI,MC PONSIRUCE TRIFOLIATA,51101,IMG-14223.jpg,153,124,124,0,29,1.0,0.8104575163398693
2024,ONAGRI,MC PONSIRUCE TRIFOLIATA,51101,IMG-14226.jpg,151,131,131,0,20,1.0,0.8675496688741722
2024,ONAGRI,MC PONSIRUCE TRIFOLIATA,51101,IMG-14255.jpg,189,153,151,2,38,0.9869281045751634,0.798941798941799
2024,ONAGRI,MC PONSIRUCE TRIFOLIATA,51101,IMG-14281.jpg,150,128,127,1,23,0.9921875,0.8466666666666667
2022,ONAGRI,CITRUS VOLKAMERIANA,101020,IMG-00001.jpg,6,6,6,0,0,1.0,1.0
2022,ONAGRI,CITRUS VOLKAMERIANA,101020,IMG-00004-44.jpg,53,52,50,2,3,0.9615384615384616,0.9433962264150944
2022,ONAGRI,CITRUS VOLKAMERIANA,101030,IMG-00003-44.jpg,29,29,29,0,0,1.0,1.0
2022,ONAGRI,CITRUS VOLKAMERIANA,101030,IMG-00004-44.jpg,110,104,102,2,8,0.9807692307692308,0.9272727272727272
2022,ONAGRI,CITRUS VOLKAMERIANA,101030,IMG-00005-44.jpg,134,126,121,5,13,0.9603174603174603,0.9029850746268656
2022,ONAGRI,CITRUS VOLKAMERIANA,101030,IMG-00017-44.jpg,79,70,70,0,9,1.0,0.8860759493670886
2022,ONAGRI,CITRUS VOLKAMERIANA,101040,IMG-00005-44.jpg,172,160,155,5,17,0.96875,0.9011627906976744
2022,ONAGRI,CITRUS VOLKAMERIANA,101040,IMG-00009-44.jpg,131,131,125,6,6,0.9541984732824428,0.9541984732824428
2022,ONAGRI,CITRUS VOLKAMERIANA,101040,IMG-00011-44.jpg,64,65,62,3,2,0.953846153846154,0.96875
2022,ONAGRI,CITRUS VOLKAMERIANA,101040,IMG-00012-44.jpg,139,132,129,3,10,0.9772727272727272,0.9280575539568344
2022,ONAGRI,CITRUS VOLKAMERIANA,101050,IMG-00002-44.jpg,95,92,88,4,7,0.9565217391304348,0.9263157894736842
2022,ONAGRI,CITRUS VOLKAMERIANA,101050,IMG-00005-44.jpg,59,54,54,0,5,1.0,0.9152542372881356
2022,ONAGRI,CITRUS VOLKAMERIANA,101050,IMG-00011-44.jpg,46,40,39,1,7,0.975,0.8478260869565217
2022,ONAGRI,CITRUS VOLKAMERIANA,101050,IMG-00024-44.jpg,40,43,40,3,0,0.9302325581395348,1.0
2022,ONAGRI,CITRUS VOLKAMERIANA,101080,IMG-00005-44.jpg,42,37,35,2,7,0.945945945945946,0.8333333333333334
2022,ONAGRI,CITRUS VOLKAMERIANA,101080,IMG-00006-44.jpg,79,71,70,1,9,0.9859154929577464,0.8860759493670886
2022,ONAGRI,CITRUS VOLKAMERIANA,101080,IMG-00023-44.jpg,7,7,7,0,0,1.0,1.0
2022,ONAGRI,CITRUS VOLKAMERIANA,101080,IMG-00024-44.jpg,27,24,23,1,4,0.9583333333333334,0.8518518518518519
2022,ONAGRI,CITRUS VOLKAMERIANA,101090,IMG-00003-44.jpg,66,65,63,2,3,0.9692307692307692,0.9545454545454546
2022,ONAGRI,CITRUS VOLKAMERIANA,101090,IMG-00006-44.jpg,41,33,33,0,8,1.0,0.8048780487804879
2022,ONAGRI,CITRUS VOLKAMERIANA,101090,IMG-00019-44.jpg,35,36,34,2,1,0.9444444444444444,0.9714285714285714
2022,ONAGRI,CITRUS VOLKAMERIANA,101090,IMG-00020-44.jpg,42,38,37,1,5,0.9736842105263158,0.8809523809523809
2022,KHOUALKA,CITRANGE CARRIZO,102130,IMG-00001.jpg,5,3,3,0,2,1.0,0.6
2022,KHOUALKA,CITRANGE CARRIZO,102130,IMG-00004-43.jpg,24,20,20,0,4,1.0,0.8333333333333334
2022,KHOUALKA,CITRANGE CARRIZO,102130,IMG-00019-43.jpg,33,30,30,0,3,1.0,0.9090909090909092
2022,KHOUALKA,CITRANGE CARRIZO,102130,IMG-00020-43.jpg,18,22,15,7,3,0.6818181818181818,0.8333333333333334
2022,KHOUALKA,MACROPHYLLA,201180,IMG-00007-43.jpg,38,40,38,2,0,0.95,1.0
2022,KHOUALKA,MACROPHYLLA,201180,IMG-00011-43.jpg,64,59,55,4,9,0.9322033898305084,0.859375
2022,KHOUALKA,MACROPHYLLA,201180,IMG-00019-43.jpg,64,56,56,0,8,1.0,0.875
2022,KHOUALKA,MACROPHYLLA,201180,IMG-00020-43.jpg,43,41,38,3,5,0.926829268292683,0.8837209302325582
2022,KHOUALKA,MACROPHYLLA,201190,IMG-00004-43.jpg,101,77,76,1,25,0.987012987012987,0.7524752475247525
2022,KHOUALKA,MACROPHYLLA,201190,IMG-00010-43.jpg,90,70,69,1,21,0.9857142857142858,0.7666666666666667
2022,KHOUALKA,MACROPHYLLA,201190,IMG-00011-43.jpg,134,101,98,3,36,0.9702970297029704,0.7313432835820896
2022,KHOUALKA,MACROPHYLLA,201190,IMG-00020-43.jpg,95,70,68,2,27,0.9714285714285714,0.7157894736842105
2022,KHOUALKA,CITRUS VOLKAMERIANA,201210,IMG-00011-43.jpg,103,91,90,1,13,0.989010989010989,0.8737864077669902
2022,KHOUALKA,CITRUS VOLKAMERIANA,201210,IMG-00012-43.jpg,42,36,34,2,8,0.9444444444444444,0.8095238095238095
2022,KHOUALKA,CITRUS VOLKAMERIANA,201210,IMG-00015-43.jpg,77,63,63,0,14,1.0,0.8181818181818182
2022,KHOUALKA,CITRUS VOLKAMERIANA,201210,IMG-00019-43.jpg,31,29,29,0,2,1.0,0.935483870967742
2022,KHOUALKA,BIGARADIER,201320,IMG-00006-43.jpg,87,79,78,1,9,0.9873417721518988,0.896551724137931
2022,KHOUALKA,BIGARADIER,201320,IMG-00016-43.jpg,97,93,90,3,7,0.967741935483871,0.9278350515463918
2022,KHOUALKA,BIGARADIER,201320,IMG-00017-43.jpg,49,46,45,1,4,0.9782608695652174,0.9183673469387756
2022,KHOUALKA,BIGARADIER,201320,IMG-00020-43.jpg,88,87,87,0,1,1.0,0.9886363636363636
2022,ONAGRI,BIGARADIER,201390,IMG-00008-44.jpg,62,62,57,5,5,0.9193548387096774,0.9193548387096774
2022,ONAGRI,BIGARADIER,201390,IMG-00011-44.jpg,90,76,75,1,15,0.986842105263158,0.8333333333333334
2022,ONAGRI,BIGARADIER,201390,IMG-00013-44.jpg,77,57,54,3,23,0.9473684210526316,0.7012987012987013
2022,ONAGRI,BIGARADIER,201390,IMG-00016-44.jpg,69,60,58,2,11,0.9666666666666668,0.8405797101449275
2022,KHOUALKA,CITRUS VOLKAMERIANA,202050,IMG-00006-43.jpg,89,78,76,2,13,0.9743589743589745,0.8539325842696629
2022,KHOUALKA,CITRUS VOLKAMERIANA,202050,IMG-00010-43.jpg,94,84,84,0,10,1.0,0.8936170212765957
2022,KHOUALKA,CITRUS VOLKAMERIANA,202050,IMG-00011-43.jpg,151,140,135,5,16,0.9642857142857144,0.8940397350993378
2022,KHOUALKA,CITRUS VOLKAMERIANA,202050,IMG-00020-43.jpg,129,115,114,1,15,0.991304347826087,0.8837209302325582
2022,KHOUALKA,CITRUS VOLKAMERIANA,202070,IMG-00006-43.jpg,68,59,58,1,10,0.9830508474576272,0.8529411764705882
2022,KHOUALKA,CITRUS VOLKAMERIANA,202070,IMG-00009-43.jpg,120,105,102,3,18,0.9714285714285714,0.85
2022,KHOUALKA,CITRUS VOLKAMERIANA,202070,IMG-00013-43.jpg,95,76,75,1,20,0.986842105263158,0.7894736842105263
2022,KHOUALKA,CITRUS VOLKAMERIANA,202070,IMG-00019-43.jpg,57,50,49,1,8,0.98,0.8596491228070176
2022,KHOUALKA,CITRUS VOLKAMERIANA,202080,IMG-00005-43.jpg,65,56,56,0,9,1.0,0.8615384615384616
2022,KHOUALKA,CITRUS VOLKAMERIANA,202080,IMG-00008-43.jpg,31,26,26,0,5,1.0,0.8387096774193549
2022,KHOUALKA,CITRUS VOLKAMERIANA,202080,IMG-00015-43.jpg,220,194,192,2,28,0.9896907216494846,0.8727272727272727
2022,KHOUALKA,CITRUS VOLKAMERIANA,202080,IMG-00016-43.jpg,131,122,119,3,12,0.9754098360655736,0.9083969465648856
2022,KHOUALKA,CITRANGE CARRIZO,301380,IMG-00007-43.jpg,30,25,24,1,6,0.96,0.8
2022,KHOUALKA,CITRANGE CARRIZO,301380,IMG-00011-43.jpg,53,49,49,0,4,1.0,0.9245283018867924
2022,KHOUALKA,CITRANGE CARRIZO,301380,IMG-00014-43.jpg,7,7,6,1,1,0.8571428571428571,0.8571428571428571
2022,KHOUALKA,CITRANGE CARRIZO,301380,IMG-00020-43.jpg,91,91,85,6,6,0.934065934065934,0.934065934065934
2022,ONAGRI,CITRUS VOLKAMERIANA,301470,IMG-00003-44.jpg,148,143,143,0,5,1.0,0.9662162162162162
2022,ONAGRI,CITRUS VOLKAMERIANA,301470,IMG-00004-44.jpg,163,158,152,6,11,0.9620253164556962,0.9325153374233128
2022,ONAGRI,CITRUS VOLKAMERIANA,301470,IMG-00005-44.jpg,160,137,135,2,25,0.9854014598540146,0.84375
2022,ONAGRI,CITRUS VOLKAMERIANA,301480,IMG-00001.jpg,92,67,67,0,25,1.0,0.7282608695652174
2022,ONAGRI,CITRUS VOLKAMERIANA,301480,IMG-00003-43.jpg,26,16,15,1,11,0.9375,0.5769230769230769
2022,ONAGRI,CITRUS VOLKAMERIANA,301480,IMG-00012-43.jpg,50,39,38,1,12,0.9743589743589745,0.76
2022,ONAGRI,CITRUS VOLKAMERIANA,301480,IMG-00014-43.jpg,77,62,62,0,15,1.0,0.8051948051948052
2022,ONAGRI,CITRUS VOLKAMERIANA,301490,IMG-00005-44.jpg,108,88,86,2,22,0.9772727272727272,0.7962962962962963
2022,ONAGRI,CITRUS VOLKAMERIANA,301490,IMG-00009-44.jpg,185,177,169,8,16,0.9548022598870056,0.9135135135135136
2022,ONAGRI,CITRUS VOLKAMERIANA,301490,IMG-00012-44.jpg,162,155,152,3,10,0.9806451612903224,0.9382716049382716
2022,ONAGRI,CITRUS VOLKAMERIANA,301490,IMG-00015-44.jpg,109,104,101,3,8,0.971153846153846,0.926605504587156
2022,ONAGRI,CITRUS VOLKAMERIANA,301510,IMG-00001.jpg,252,229,227,2,25,0.9912663755458516,0.9007936507936508
2022,ONAGRI,CITRUS VOLKAMERIANA,301510,IMG-00006-44.jpg,137,131,128,3,9,0.9770992366412212,0.9343065693430656
2022,ONAGRI,CITRUS VOLKAMERIANA,301510,IMG-00007-44.jpg,115,114,107,7,8,0.9385964912280702,0.9304347826086956
2022,ONAGRI,CITRUS VOLKAMERIANA,301510,IMG-00008-44.jpg,150,133,131,2,19,0.9849624060150376,0.8733333333333333
2022,ONAGRI,BIGARADIER,301550,IMG-00008-44.jpg,144,126,124,2,20,0.984126984126984,0.8611111111111112
2022,ONAGRI,BIGARADIER,301550,IMG-00011-44.jpg,40,32,32,0,8,1.0,0.8
2022,ONAGRI,BIGARADIER,301550,IMG-00013-44.jpg,76,61,61,0,15,1.0,0.8026315789473685
2022,ONAGRI,BIGARADIER,301550,IMG-00014-44.jpg,80,81,74,7,6,0.9135802469135802,0.925
2022,ONAGRI,CITRUS VOLKAMERIANA,301570,IMG-00004-44.jpg,158,149,144,5,14,0.9664429530201344,0.9113924050632912
2022,ONAGRI,CITRUS VOLKAMERIANA,301570,IMG-00007-44.jpg,152,141,137,4,15,0.9716312056737588,0.9013157894736842
2022,ONAGRI,CITRUS VOLKAMERIANA,301570,IMG-00008-44.jpg,103,95,88,7,15,0.9263157894736842,0.8543689320388349
2022,ONAGRI,CITRUS VOLKAMERIANA,301570,IMG-00017-44.jpg,218,210,205,5,13,0.9761904761904762,0.9403669724770642
2022,KHOUALKA,CITRUS VOLKAMERIANA,302340,IMG-00004-43.jpg,106,79,79,0,27,1.0,0.7452830188679245
2022,KHOUALKA,CITRUS VOLKAMERIANA,302340,IMG-00005-43.jpg,105,74,74,0,31,1.0,0.7047619047619048
2022,KHOUALKA,CITRUS VOLKAMERIANA,302340,IMG-00011-43.jpg,75,57,56,1,19,0.9824561403508772,0.7466666666666667
2022,KHOUALKA,CITRUS VOLKAMERIANA,302340,IMG-00015-43.jpg,92,60,59,1,33,0.9833333333333332,0.6413043478260869
2022,KHOUALKA,CITRUS VOLKAMERIANA,302350,IMG-00008-43.jpg,33,30,29,1,4,0.9666666666666668,0.8787878787878788
2022,KHOUALKA,CITRUS VOLKAMERIANA,302350,IMG-00013-43.jpg,80,76,71,5,9,0.9342105263157896,0.8875
2022,KHOUALKA,CITRUS VOLKAMERIANA,302350,IMG-00014-43.jpg,76,69,64,5,12,0.927536231884058,0.8421052631578947
2022,KHOUALKA,CITRUS VOLKAMERIANA,302350,IMG-00018-43.jpg,44,40,39,1,5,0.975,0.8863636363636364
2022,KHOUALKA,CITRUS VOLKAMERIANA,302360,IMG-00005-43.jpg,97,79,78,1,19,0.9873417721518988,0.8041237113402062
2022,KHOUALKA,CITRUS VOLKAMERIANA,302360,IMG-00006-43.jpg,118,92,92,0,26,1.0,0.7796610169491526
2022,KHOUALKA,CITRUS VOLKAMERIANA,302360,IMG-00016-43.jpg,67,52,52,0,15,1.0,0.7761194029850746
2022,KHOUALKA,CITRUS VOLKAMERIANA,302360,IMG-00021-43.jpg,65,54,53,1,12,0.9814814814814816,0.8153846153846154
2022,KHOUALKA,CITRUS VOLKAMERIANA,302510,IMG-00001.jpg,73,48,48,0,25,1.0,0.6575342465753424
2022,KHOUALKA,CITRUS VOLKAMERIANA,302510,IMG-00002-43.jpg,44,36,34,2,10,0.9444444444444444,0.7727272727272727
2022,KHOUALKA,CITRUS VOLKAMERIANA,302510,IMG-00003-43.jpg,78,65,62,3,16,0.953846153846154,0.7948717948717948
2022,KHOUALKA,CITRUS VOLKAMERIANA,302510,IMG-00015-43.jpg,49,29,29,0,20,1.0,0.5918367346938775
2022,KHOUALKA,BIGARADIER,401410,IMG-00093-43.jpg,35,20,20,0,15,1.0,0.5714285714285714
2022,KHOUALKA,BIGARADIER,401410,IMG-00099-43.jpg,6,3,3,0,3,1.0,0.5
2022,KHOUALKA,BIGARADIER,401410,IMG-00102-43.jpg,78,56,56,0,22,1.0,0.717948717948718
2022,KHOUALKA,BIGARADIER,401410,IMG-00104-43.jpg,81,62,62,0,19,1.0,0.7654320987654321
2022,ONAGRI,CITRANGE C35,401660,IMG-00001.jpg,56,54,51,3,5,0.9444444444444444,0.9107142857142856
2022,ONAGRI,CITRANGE C35,401660,IMG-00008-44.jpg,42,34,34,0,8,1.0,0.8095238095238095
2022,ONAGRI,CITRANGE C35,401660,IMG-00010-44.jpg,29,23,23,0,6,1.0,0.7931034482758621
2022,ONAGRI,CITRANGE C35,401660,IMG-00016-44.jpg,64,56,54,2,10,0.9642857142857144,0.84375
2022,ONAGRI,CITRANGE C35,401710,IMG-00003-44.jpg,51,39,39,0,12,1.0,0.7647058823529411
2022,ONAGRI,CITRANGE C35,401710,IMG-00012-44.jpg,19,15,15,0,4,1.0,0.7894736842105263
2022,ONAGRI,CITRANGE C35,401710,IMG-00013-44.jpg,33,28,27,1,6,0.9642857142857144,0.8181818181818182
2022,ONAGRI,CITRANGE C35,401710,IMG-00019-44.jpg,76,70,69,1,7,0.9857142857142858,0.9078947368421052
2022,ONAGRI,CITRANGE C35,401720,IMG-00007-44.jpg,93,89,86,3,7,0.9662921348314608,0.9247311827956988
2022,ONAGRI,CITRANGE C35,401720,IMG-00008-44.jpg,38,32,32,0,6,1.0,0.8421052631578947
2022,ONAGRI,CITRANGE C35,401720,IMG-00010-44.jpg,50,34,33,1,17,0.9705882352941176,0.66
2022,ONAGRI,CITRANGE C35,401720,IMG-00017-44.jpg,68,51,51,0,17,1.0,0.75
2022,ONAGRI,CITRANGE C35,401730,IMG-00001.jpg,19,18,18,0,1,1.0,0.9473684210526316
2022,ONAGRI,CITRANGE C35,401730,IMG-00010-44.jpg,50,48,46,2,4,0.9583333333333334,0.92
2022,ONAGRI,CITRANGE C35,401730,IMG-00013-44.jpg,75,66,66,0,9,1.0,0.88
2022,ONAGRI,CITRANGE C35,401730,IMG-00016-44.jpg,36,31,31,0,5,1.0,0.8611111111111112
2022,ONAGRI,CITRANGE C35,401750,IMG-00005-44.jpg,88,65,61,4,27,0.9384615384615383,0.6931818181818182
2022,ONAGRI,CITRANGE C35,401750,IMG-00009-44.jpg,127,103,101,2,26,0.9805825242718448,0.7952755905511811
2022,ONAGRI,CITRANGE C35,401750,IMG-00016-44.jpg,107,86,85,1,22,0.9883720930232558,0.794392523364486
2022,ONAGRI,CITRANGE C35,401750,IMG-00024-44.jpg,50,44,39,5,11,0.8863636363636364,0.78
2022,ONAGRI,CITRUMELO SACCATON,401770,IMG-00003-44.jpg,24,22,21,1,3,0.9545454545454546,0.875
2022,ONAGRI,CITRUMELO SACCATON,401770,IMG-00008-44.jpg,72,64,63,1,9,0.984375,0.875
2022,ONAGRI,CITRUMELO SACCATON,401770,IMG-00009-44.jpg,14,11,11,0,3,1.0,0.7857142857142857
2022,ONAGRI,CITRUMELO SACCATON,401770,IMG-00017-44.jpg,20,14,14,0,6,1.0,0.7
2022,KHOUALKA,BIGARADIER,402440,IMG-00005-43.jpg,17,8,7,1,10,0.875,0.4117647058823529
2022,KHOUALKA,BIGARADIER,402440,IMG-00012-43.jpg,46,33,32,1,14,0.9696969696969696,0.6956521739130435
2022,KHOUALKA,BIGARADIER,402440,IMG-00014-43.jpg,11,5,5,0,6,1.0,0.4545454545454545
2022,KHOUALKA,BIGARADIER,402440,IMG-00015-43.jpg,22,9,9,0,13,1.0,0.4090909090909091
2022,KHOUALKA,BIGARADIER,402590,IMG-00007-43.jpg,104,68,67,1,37,0.9852941176470588,0.6442307692307693
2022,KHOUALKA,BIGARADIER,402590,IMG-00012-43.jpg,45,33,32,1,13,0.9696969696969696,0.7111111111111111
2022,KHOUALKA,BIGARADIER,402590,IMG-00015-43.jpg,58,47,47,0,11,1.0,0.8103448275862069
2022,KHOUALKA,BIGARADIER,402590,IMG-00019-43.jpg,64,54,54,0,10,1.0,0.84375
2022,KHOUALKA,CITRUS VOLKAMERIANA,501520,IMG-00004-43.jpg,39,32,30,2,9,0.9375,0.7692307692307693
2022,KHOUALKA,CITRUS VOLKAMERIANA,501520,IMG-00007-43.jpg,43,32,32,0,11,1.0,0.7441860465116279
2022,KHOUALKA,CITRUS VOLKAMERIANA,501520,IMG-00015-43.jpg,18,10,10,0,8,1.0,0.5555555555555556
2022,KHOUALKA,CITRUS VOLKAMERIANA,501520,IMG-00020-43.jpg,48,42,41,1,7,0.9761904761904762,0.8541666666666666
2022,KHOUALKA,CITRUS VOLKAMERIANA,501540,IMG-00006-43.jpg,38,31,31,0,7,1.0,0.8157894736842105
2022,KHOUALKA,CITRUS VOLKAMERIANA,501540,IMG-00012-43.jpg,102,89,89,0,13,1.0,0.8725490196078431
2022,KHOUALKA,CITRUS VOLKAMERIANA,501540,IMG-00017-43.jpg,138,108,108,0,30,1.0,0.782608695652174
2022,KHOUALKA,CITRUS VOLKAMERIANA,501540,IMG-00018-43.jpg,51,44,42,2,9,0.9545454545454546,0.8235294117647058
2022,KHOUALKA,CITRUS VOLKAMERIANA,501660,IMG-00006-43.jpg,60,53,49,4,11,0.9245283018867924,0.8166666666666667
2022,KHOUALKA,CITRUS VOLKAMERIANA,501660,IMG-00016-43.jpg,63,49,49,0,14,1.0,0.7777777777777778
2022,KHOUALKA,CITRUS VOLKAMERIANA,501660,IMG-00018-43.jpg,112,81,79,2,33,0.9753086419753086,0.7053571428571429
2022,KHOUALKA,CITRUS VOLKAMERIANA,501660,IMG-00021-43.jpg,90,82,82,0,8,1.0,0.9111111111111112
2022,KHOUALKA,CITRUS VOLKAMERIANA,501680,IMG-00005-43.jpg,179,146,144,2,35,0.9863013698630136,0.8044692737430168
2022,KHOUALKA,CITRUS VOLKAMERIANA,501680,IMG-00011-43.jpg,101,65,65,0,36,1.0,0.6435643564356436
2022,KHOUALKA,CITRUS VOLKAMERIANA,501680,IMG-00012-43.jpg,76,46,45,1,31,0.9782608695652174,0.5921052631578947
2022,KHOUALKA,CITRUS VOLKAMERIANA,501680,IMG-00016-43.jpg,113,91,91,0,22,1.0,0.8053097345132744
2022,KHOUALKA,CITRUS VOLKAMERIANA,501690,IMG-00032-43.jpg,34,21,21,0,13,1.0,0.6176470588235294
2022,KHOUALKA,CITRUS VOLKAMERIANA,501690,IMG-00039-43.jpg,186,137,136,1,50,0.9927007299270072,0.7311827956989247
2022,KHOUALKA,CITRUS VOLKAMERIANA,501690,IMG-00047-43.jpg,103,66,66,0,37,1.0,0.6407766990291263
2022,KHOUALKA,CITRUS VOLKAMERIANA,501690,IMG-00049-43.jpg,166,125,125,0,41,1.0,0.7530120481927711
2022,KHOUALKA,CITRUS VOLKAMERIANA,501760,IMG-00001.jpg,94,49,49,0,45,1.0,0.5212765957446809
2022,KHOUALKA,CITRUS VOLKAMERIANA,501760,IMG-00034-43.jpg,45,18,18,0,27,1.0,0.4
2022,KHOUALKA,CITRUS VOLKAMERIANA,501760,IMG-00036-43.jpg,40,23,22,1,18,0.9565217391304348,0.55
2022,KHOUALKA,CITRUS VOLKAMERIANA,501760,IMG-00051-43.jpg,92,56,56,0,36,1.0,0.6086956521739131
2022,ONAGRI,CITRUMELO SACCATON,510910,IMG-00004-44.jpg,73,61,60,1,13,0.9836065573770492,0.821917808219178
2022,ONAGRI,CITRUMELO SACCATON,510910,IMG-00008-44.jpg,152,108,107,1,45,0.9907407407407408,0.7039473684210527
2022,ONAGRI,CITRUMELO SACCATON,510910,IMG-00010-44.jpg,107,88,86,2,21,0.9772727272727272,0.8037383177570093
2022,ONAGRI,CITRUMELO SACCATON,510910,IMG-00011-44.jpg,92,72,71,1,21,0.9861111111111112,0.7717391304347826
2022,ONAGRI,CITRUMELO SACCATON,510950,IMG-00006-44.jpg,70,58,58,0,12,1.0,0.8285714285714286
2022,ONAGRI,CITRUMELO SACCATON,510950,IMG-00008-44.jpg,75,59,58,1,17,0.9830508474576272,0.7733333333333333
2022,ONAGRI,CITRUMELO SACCATON,510950,IMG-00009-44.jpg,85,59,59,0,26,1.0,0.6941176470588235
2022,ONAGRI,CITRUMELO SACCATON,510950,IMG-00011-44.jpg,135,105,105,0,30,1.0,0.7777777777777778
2022,ONAGRI,MC PONSIRUCE TRIFOLIATA,510980,IMG-00014-44.jpg,67,49,49,0,18,1.0,0.7313432835820896
2022,ONAGRI,MC PONSIRUCE TRIFOLIATA,510980,IMG-00015-44.jpg,51,45,44,1,7,0.9777777777777776,0.8627450980392157
2022,ONAGRI,MC PONSIRUCE TRIFOLIATA,510980,IMG-00016-44.jpg,99,75,74,1,25,0.9866666666666668,0.7474747474747475
2022,ONAGRI,MC PONSIRUCE TRIFOLIATA,510980,IMG-00019-44.jpg,102,78,78,0,24,1.0,0.7647058823529411
2022,ONAGRI,MC PONSIRUCE TRIFOLIATA,510990,IMG-00006-44.jpg,135,108,106,2,29,0.9814814814814816,0.7851851851851852
2022,ONAGRI,MC PONSIRUCE TRIFOLIATA,510990,IMG-00008-44.jpg,110,100,100,0,10,1.0,0.9090909090909092
2022,ONAGRI,MC PONSIRUCE TRIFOLIATA,510990,IMG-00009-44.jpg,85,71,71,0,14,1.0,0.8352941176470589
2022,ONAGRI,MC PONSIRUCE TRIFOLIATA,510990,IMG-00024-44.jpg,65,53,53,0,12,1.0,0.8153846153846154
2022,ONAGRI,MC PONSIRUCE TRIFOLIATA,511030,IMG-00007-44.jpg,100,86,85,1,15,0.9883720930232558,0.85
2022,ONAGRI,MC PONSIRUCE TRIFOLIATA,511030,IMG-00016-44.jpg,63,55,55,0,8,1.0,0.873015873015873
2022,ONAGRI,MC PONSIRUCE TRIFOLIATA,511030,IMG-00022-44.jpg,98,82,81,1,17,0.9878048780487804,0.826530612244898
2022,ONAGRI,MC PONSIRUCE TRIFOLIATA,511030,IMG-00027-44.jpg,82,72,72,0,10,1.0,0.8780487804878049
2022,ONAGRI,MS PONSIRUCE TRIFOLIATA,511040,IMG-00004-44.jpg,77,68,66,2,11,0.9705882352941176,0.8571428571428571
2022,ONAGRI,MS PONSIRUCE TRIFOLIATA,511040,IMG-00014-44.jpg,48,38,36,2,12,0.9473684210526316,0.75
2022,ONAGRI,MS PONSIRUCE TRIFOLIATA,511040,IMG-00016-44.jpg,71,60,60,0,11,1.0,0.8450704225352113
2022,ONAGRI,MS PONSIRUCE TRIFOLIATA,511040,IMG-00025-44.jpg,56,40,39,1,17,0.975,0.6964285714285714
2022,ONAGRI,FUZHU,511050,IMG-00004-44.jpg,109,91,88,3,21,0.967032967032967,0.8073394495412844
2022,ONAGRI,FUZHU,511050,IMG-00006-44.jpg,142,119,116,3,26,0.9747899159663864,0.8169014084507042
2022,ONAGRI,FUZHU,511050,IMG-00011-44.jpg,172,154,152,2,20,0.987012987012987,0.8837209302325582
2022,ONAGRI,FUZHU,511050,IMG-00022-44.jpg,194,162,160,2,34,0.9876543209876544,0.8247422680412371
2022,ONAGRI,MS PONSIRUCE TRIFOLIATA,511060,IMG-00007-44.jpg,115,99,98,1,17,0.98989898989899,0.8521739130434782
2022,ONAGRI,MS PONSIRUCE TRIFOLIATA,511060,IMG-00016-44.jpg,102,76,74,2,28,0.9736842105263158,0.7254901960784313
2022,ONAGRI,MS PONSIRUCE TRIFOLIATA,511060,IMG-00017-44.jpg,59,44,44,0,15,1.0,0.7457627118644068
2022,ONAGRI,MS PONSIRUCE TRIFOLIATA,511060,IMG-00019-44.jpg,108,86,86,0,22,1.0,0.7962962962962963
2022,ONAGRI,FUZHU,511070,IMG-00006-44.jpg,82,73,71,2,11,0.9726027397260274,0.8658536585365854
2022,ONAGRI,FUZHU,511070,IMG-00016-44.jpg,96,74,73,1,23,0.9864864864864864,0.7604166666666666
2022,ONAGRI,FUZHU,511070,IMG-00018-44.jpg,93,70,69,1,24,0.9857142857142858,0.7419354838709677
2022,ONAGRI,FUZHU,511070,IMG-00019-44.jpg,142,116,115,1,27,0.9913793103448276,0.8098591549295775
