compagnie,Domaine,Porte-greffe,parcelle,Filename,True_count,detect_count,TP,FP,FN,Precision,Recall
2022,SAOUDA,BIGARADIER,10010,IMG-00011-45.jpg,28,37,28,9,0,0.7567567567567568,1.0
2022,SAOUDA,BIGARADIER,10010,IMG-00012-45.jpg,27,34,27,7,0,0.7941176470588235,1.0
2022,SAOUDA,BIGARADIER,10010,IMG-00014-45.jpg,50,61,48,13,2,0.7868852459016393,0.96
2022,SAOUDA,BIGARADIER,10010,IMG-00018-45.jpg,30,34,28,6,2,0.8235294117647058,0.9333333333333332
2022,SAOUDA,BIGARADIER,10010,IMG-00020-45.jpg,31,43,31,12,0,0.7209302325581395,1.0
2024,SAOUDA,BIGARADIER,10010,IMG-23410.jpg,85,65,63,2,22,0.9692307692307692,0.7411764705882353
2024,SAOUDA,BIGARADIER,10010,IMG-23417.jpg,86,65,64,1,22,0.9846153846153848,0.7441860465116279
2024,SAOUDA,BIGARADIER,10010,IMG-23430.jpg,74,62,62,0,12,1.0,0.8378378378378378
2024,SAOUDA,BIGARADIER,10010,IMG-23647.jpg,95,79,79,0,16,1.0,0.8315789473684211
2024,SAOUDA,BIGARADIER,10010,IMG-23672.jpg,47,28,27,1,20,0.9642857142857144,0.574468085106383
2024,SAOUDA,BIGARADIER,10010,IMG-23707.jpg,30,25,25,0,5,1.0,0.8333333333333334
2024,SAOUDA,BIGARADIER,10010,IMG-23709.jpg,31,24,24,0,7,1.0,0.7741935483870968
2024,SAOUDA,BIGARADIER,10010,IMG-23711.jpg,79,70,66,4,13,0.9428571428571428,0.8354430379746836
2022,SAOUDA,MACROPHYLLA,10030,IMG-00158-45.jpg,101,133,100,33,1,0.7518796992481203,0.99009900990099
2022,SAOUDA,MACROPHYLLA,10030,IMG-00159-45.jpg,155,181,150,31,5,0.8287292817679558,0.967741935483871
2022,SAOUDA,MACROPHYLLA,10030,IMG-00162-45.jpg,119,144,118,26,1,0.8194444444444444,0.9915966386554622
2022,SAOUDA,MACROPHYLLA,10030,IMG-00169-45.jpg,72,96,71,25,1,0.7395833333333334,0.9861111111111112
2022,SAOUDA,MACROPHYLLA,10031,IMG-00002-45.jpg,46,54,43,11,3,0.7962962962962963,0.9347826086956522
2022,SAOUDA,MACROPHYLLA,10031,IMG-00084-45.jpg,41,51,40,11,1,0.7843137254901961,0.975609756097561
2022,SAOUDA,MACROPHYLLA,10031,IMG-00450-45.jpg,27,42,26,16,1,0.6190476190476191,0.9629629629629628
2022,SAOUDA,MACROPHYLLA,10031,IMG-00451-45.jpg,34,47,33,14,1,0.7021276595744681,0.9705882352941176
2022,SAOUDA,MACROPHYLLA,10031,IMG-00464-45.jpg,33,42,32,10,1,0.7619047619047619,0.9696969696969696
2022,ONAGRI,CITRUS VOLKAMERIANA,10101,IMG-00003-39.jpg,120,122,114,8,6,0.9344262295081968,0.95
2022,ONAGRI,CITRUS VOLKAMERIANA,10101,IMG-00010-39.jpg,85,79,75,4,10,0.9493670886075948,0.8823529411764706
2024,ONAGRI,CITRUS VOLKAMERIANA,10101,IMG-10523.jpg,288,223,222,1,66,0.9955156950672646,0.7708333333333334
2024,ONAGRI,CITRUS VOLKAMERIANA,10101,IMG-10545.jpg,98,83,82,1,16,0.9879518072289156,0.8367346938775511
2024,ONAGRI,CITRUS VOLKAMERIANA,10101,IMG-10558.jpg,143,105,104,1,39,0.9904761904761904,0.7272727272727273
2022,ONAGRI,CITRUS VOLKAMERIANA,10102,IMG-00003-39.jpg,48,40,40,0,8,1.0,0.8333333333333334
2024,ONAGRI,CITRUS VOLKAMERIANA,10102,IMG-10637.jpg,140,119,118,1,22,0.9915966386554622,0.8428571428571429
2024,ONAGRI,CITRUS VOLKAMERIANA,10102,IMG-10658.jpg,163,135,132,3,31,0.9777777777777776,0.8098159509202454
2022,ONAGRI,CITRUS VOLKAMERIANA,10103,IMG-00003-39.jpg,215,194,189,5,26,0.9742268041237112,0.8790697674418605
2022,ONAGRI,CITRUS VOLKAMERIANA,10103,IMG-00008-39.jpg,195,193,181,12,14,0.9378238341968912,0.9282051282051282
2024,ONAGRI,CITRUS VOLKAMERIANA,10103,IMG-10614.jpg,134,116,115,1,19,0.9913793103448276,0.8582089552238806
2024,ONAGRI,CITRUS VOLKAMERIANA,10103,IMG-10630.jpg,213,170,168,2,45,0.9882352941176472,0.7887323943661971
2024,ONAGRI,CITRUS VOLKAMERIANA,10103,IMG-10631.jpg,134,104,104,0,30,1.0,0.7761194029850746
2022,ONAGRI,CITRUS VOLKAMERIANA,10104,IMG-00004-39.jpg,65,65,60,5,5,0.9230769230769232,0.9230769230769232
2022,ONAGRI,CITRUS VOLKAMERIANA,10104,IMG-00008-39.jpg,69,64,57,7,12,0.890625,0.8260869565217391
2024,ONAGRI,CITRUS VOLKAMERIANA,10104,IMG-11267.jpg,22,12,12,0,10,1.0,0.5454545454545454
2024,ONAGRI,CITRUS VOLKAMERIANA,10104,IMG-11327.jpg,128,100,98,2,30,0.98,0.765625
2024,ONAGRI,CITRUS VOLKAMERIANA,10104,IMG-11347.jpg,118,94,94,0,24,1.0,0.7966101694915254
2024,ONAGRI,CITRUS VOLKAMERIANA,10104,IMG-11366.jpg,351,267,263,4,88,0.9850187265917604,0.7492877492877493
2024,ONAGRI,CITRUS VOLKAMERIANA,10104,IMG-11386.jpg,99,73,73,0,26,1.0,0.7373737373737373
2022,ONAGRI,CITRUS VOLKAMERIANA,10105,IMG-00004-39.jpg,17,20,16,4,1,0.8,0.9411764705882352
2022,ONAGRI,CITRUS VOLKAMERIANA,10105,IMG-00005-39.jpg,68,72,65,7,3,0.9027777777777778,0.9558823529411764
2022,ONAGRI,CITRUS VOLKAMERIANA,10108,IMG-00003-39.jpg,61,58,54,4,7,0.9310344827586208,0.8852459016393442
2022,ONAGRI,CITRUS VOLKAMERIANA,10108,IMG-00007-39.jpg,69,59,59,0,10,1.0,0.855072463768116
2022,ONAGRI,CITRUS VOLKAMERIANA,10109,IMG-00003-39.jpg,4,4,4,0,0,1.0,1.0
2022,ONAGRI,CITRUS VOLKAMERIANA,10109,IMG-00008-39.jpg,105,102,99,3,6,0.9705882352941176,0.9428571428571428
2022,KHOUALKA,CITRANGE CARRIZO,10213,IMG-00001.jpg,77,86,74,12,3,0.8604651162790697,0.961038961038961
2022,KHOUALKA,CITRANGE CARRIZO,10213,IMG-00005-40.jpg,73,83,70,13,3,0.8433734939759037,0.958904109589041
2022,KHOUALKA,CITRANGE CARRIZO,10213,IMG-00009-40.jpg,14,19,14,5,0,0.7368421052631579,1.0
2022,KHOUALKA,CITRANGE CARRIZO,10213,IMG-00014-40.jpg,21,23,20,3,1,0.8695652173913043,0.9523809523809524
2022,KHOUALKA,CITRANGE CARRIZO,10213,IMG-00028-40.jpg,47,49,45,4,2,0.9183673469387756,0.9574468085106383
2022,KHOUALKA,CITRANGE CARRIZO,10213,IMG-00034-40.jpg,48,51,47,4,1,0.9215686274509804,0.9791666666666666
2022,KHOUALKA,CITRANGE CARRIZO,10213,IMG-00035-40.jpg,37,40,36,4,1,0.9,0.972972972972973
2022,KHOUALKA,CITRANGE CARRIZO,10213,IMG-00036-40.jpg,47,56,47,9,0,0.8392857142857143,1.0
2022,KHOUALKA,CITRANGE CARRIZO,10213,IMG-00042-40.jpg,22,26,22,4,0,0.8461538461538461,1.0
2022,KHOUALKA,CITRANGE CARRIZO,10213,IMG-00047-40.jpg,70,71,68,3,2,0.9577464788732394,0.9714285714285714
2022,KHOUALKA,CITRANGE CARRIZO,10213,IMG-00054-40.jpg,33,38,33,5,0,0.868421052631579,1.0
2022,KHOUALKA,CITRANGE CARRIZO,10213,IMG-00055-40.jpg,93,96,89,7,4,0.9270833333333334,0.956989247311828
2022,KHOUALKA,CITRANGE CARRIZO,10213,IMG-00061-40.jpg,113,125,109,16,4,0.872,0.9646017699115044
2022,KHOUALKA,CITRANGE CARRIZO,10213,IMG-00066-40.jpg,48,50,41,9,7,0.82,0.8541666666666666
2022,OUARGHA,MACROPHYLLA,11010,IMG-00001.jpg,40,44,39,5,1,0.8863636363636364,0.975
2022,OUARGHA,MACROPHYLLA,11010,IMG-00015-41.jpg,24,26,22,4,2,0.8461538461538461,0.9166666666666666
2022,OUARGHA,MACROPHYLLA,11010,IMG-00019-41.jpg,20,37,20,17,0,0.5405405405405406,1.0
2022,OUARGHA,MACROPHYLLA,11010,IMG-00024-41.jpg,21,24,21,3,0,0.875,1.0
2022,OUARGHA,MACROPHYLLA,11020,IMG-00017-41.jpg,51,60,51,9,0,0.85,1.0
2022,OUARGHA,MACROPHYLLA,11020,IMG-00018-41.jpg,13,14,13,1,0,0.9285714285714286,1.0
2022,OUARGHA,CITRANGE CARRIZO,13010,IMG-00067-41.jpg,55,72,53,19,2,0.7361111111111112,0.9636363636363636
2022,OUARGHA,CITRANGE CARRIZO,13010,IMG-00086-41.jpg,49,61,49,12,0,0.8032786885245902,1.0
2022,OUARGHA,CITRANGE CARRIZO,13010,IMG-00194-41.jpg,33,38,32,6,1,0.8421052631578947,0.9696969696969696
2022,OUARGHA,CITRANGE CARRIZO,13020,IMG-00023-41.jpg,31,41,31,10,0,0.7560975609756098,1.0
2022,OUARGHA,CITRANGE CARRIZO,13020,IMG-00024-41.jpg,18,28,18,10,0,0.6428571428571429,1.0
2022,OUARGHA,CITRANGE CARRIZO,13020,IMG-00039-41.jpg,4,12,4,8,0,0.3333333333333333,1.0
2022,OUARGHA,CITRANGE CARRIZO,13020,IMG-00040-41.jpg,6,13,6,7,0,0.4615384615384616,1.0
2022,OUARGHA,CITRUS VOLKAMERIANA,13030,IMG-00009-41.jpg,18,26,17,9,1,0.6538461538461539,0.9444444444444444
2022,OUARGHA,CITRUS VOLKAMERIANA,13030,IMG-00013-41.jpg,46,72,46,26,0,0.6388888888888888,1.0
2022,OUARGHA,CITRUS VOLKAMERIANA,13030,IMG-00027-41.jpg,12,29,11,18,1,0.3793103448275862,0.9166666666666666
2022,OUARGHA,CITRUS VOLKAMERIANA,13030,IMG-00029-41.jpg,18,32,18,14,0,0.5625,1.0
2022,OUARGHA,CITRUS VOLKAMERIANA,13030,IMG-00036-41.jpg,16,38,16,22,0,0.4210526315789473,1.0
2022,OUARGHA,CITRUS VOLKAMERIANA,14010,IMG-00008-41.jpg,40,51,39,12,1,0.7647058823529411,0.975
2022,OUARGHA,CITRUS VOLKAMERIANA,14010,IMG-00010-41.jpg,49,56,48,8,1,0.8571428571428571,0.979591836734694
2022,OUARGHA,CITRUS VOLKAMERIANA,14010,IMG-00011-41.jpg,47,58,46,12,1,0.7931034482758621,0.9787234042553192
2022,OUARGHA,CITRUS VOLKAMERIANA,14010,IMG-00018-41.jpg,44,58,41,17,3,0.7068965517241379,0.9318181818181818
2022,KHOUALKA,MACROPHYLLA,20118,IMG-00007-40.jpg,44,48,43,5,1,0.8958333333333334,0.9772727272727272
2022,KHOUALKA,MACROPHYLLA,20118,IMG-00008-40.jpg,115,128,115,13,0,0.8984375,1.0
2022,KHOUALKA,MACROPHYLLA,20118,IMG-00022-40.jpg,113,113,109,4,4,0.9646017699115044,0.9646017699115044
2022,KHOUALKA,MACROPHYLLA,20118,IMG-00033-40.jpg,58,63,56,7,2,0.8888888888888888,0.9655172413793104
2022,KHOUALKA,MACROPHYLLA,20118,IMG-00037-40.jpg,29,29,27,2,2,0.9310344827586208,0.9310344827586208
2022,KHOUALKA,MACROPHYLLA,20118,IMG-00042-40.jpg,137,146,133,13,4,0.910958904109589,0.9708029197080292
2022,KHOUALKA,MACROPHYLLA,20118,IMG-00046-40.jpg,45,54,44,10,1,0.8148148148148148,0.9777777777777776
2022,KHOUALKA,MACROPHYLLA,20118,IMG-00050-40.jpg,48,51,47,4,1,0.9215686274509804,0.9791666666666666
2022,KHOUALKA,MACROPHYLLA,20118,IMG-00055-40.jpg,52,57,52,5,0,0.912280701754386,1.0
2022,KHOUALKA,MACROPHYLLA,20118,IMG-00061-40.jpg,120,131,114,17,6,0.8702290076335878,0.95
2022,KHOUALKA,MACROPHYLLA,20118,IMG-00062-40.jpg,63,64,58,6,5,0.90625,0.9206349206349206
2022,KHOUALKA,MACROPHYLLA,20118,IMG-00063-40.jpg,47,55,45,10,2,0.8181818181818182,0.9574468085106383
2022,KHOUALKA,MACROPHYLLA,20118,IMG-00066-40.jpg,84,92,81,11,3,0.8804347826086957,0.9642857142857144
2024,KHOUALKA,MACROPHYLLA,20118,IMG-12691.jpg,22,15,15,0,7,1.0,0.6818181818181818
2024,KHOUALKA,MACROPHYLLA,20118,IMG-12729.jpg,56,45,45,0,11,1.0,0.8035714285714286
2024,KHOUALKA,MACROPHYLLA,20118,IMG-12735.jpg,88,67,65,2,23,0.9701492537313432,0.7386363636363636
2024,KHOUALKA,MACROPHYLLA,20118,IMG-12748.jpg,107,76,75,1,32,0.986842105263158,0.7009345794392523
2024,KHOUALKA,MACROPHYLLA,20118,IMG-12764.jpg,111,91,91,0,20,1.0,0.8198198198198198
2024,KHOUALKA,MACROPHYLLA,20118,IMG-12808.jpg,113,82,80,2,33,0.975609756097561,0.7079646017699115
2024,KHOUALKA,MACROPHYLLA,20118,IMG-12851.jpg,24,13,13,0,11,1.0,0.5416666666666666
2022,KHOUALKA,MACROPHYLLA,20119,IMG-00005-40.jpg,106,118,105,13,1,0.8898305084745762,0.9905660377358492
2022,KHOUALKA,MACROPHYLLA,20119,IMG-00008-40.jpg,142,152,137,15,5,0.9013157894736842,0.9647887323943662
2022,KHOUALKA,MACROPHYLLA,20119,IMG-00014-40.jpg,132,137,129,8,3,0.9416058394160584,0.9772727272727272
2022,KHOUALKA,BIGARADIER,20132,IMG-00004-40.jpg,181,181,175,6,6,0.9668508287292816,0.9668508287292816
2022,KHOUALKA,BIGARADIER,20132,IMG-00025-40.jpg,91,106,91,15,0,0.8584905660377359,1.0
2022,KHOUALKA,BIGARADIER,20132,IMG-00028-40.jpg,49,54,47,7,2,0.8703703703703703,0.9591836734693876
2022,KHOUALKA,BIGARADIER,20132,IMG-00035-40.jpg,103,119,102,17,1,0.8571428571428571,0.9902912621359224
2022,KHOUALKA,BIGARADIER,20132,IMG-00039-40.jpg,119,133,117,16,2,0.8796992481203008,0.9831932773109244
2022,KHOUALKA,BIGARADIER,20132,IMG-00046-40.jpg,156,171,154,17,2,0.9005847953216374,0.9871794871794872
2022,KHOUALKA,BIGARADIER,20132,IMG-00051-40.jpg,108,113,103,10,5,0.911504424778761,0.9537037037037036
2022,KHOUALKA,BIGARADIER,20132,IMG-00055-40.jpg,67,66,61,5,6,0.9242424242424242,0.9104477611940298
2022,KHOUALKA,BIGARADIER,20132,IMG-00058-40.jpg,89,90,87,3,2,0.9666666666666668,0.9775280898876404
2022,KHOUALKA,BIGARADIER,20132,IMG-00059-40.jpg,139,145,135,10,4,0.9310344827586208,0.9712230215827338
2022,KHOUALKA,BIGARADIER,20132,IMG-00060-40.jpg,57,60,55,5,2,0.9166666666666666,0.9649122807017544
2022,KHOUALKA,BIGARADIER,20132,IMG-00064-40.jpg,117,131,115,16,2,0.8778625954198473,0.9829059829059827
2022,KHOUALKA,BIGARADIER,20132,IMG-00075-40.jpg,69,76,69,7,0,0.9078947368421052,1.0
2022,ONAGRI,BIGARADIER,20139,IMG-00021-39.jpg,93,89,87,2,6,0.9775280898876404,0.935483870967742
2024,KHOUALKA,CITRUS VOLKAMERIANA,20205,IMG-12040.jpg,123,95,93,2,30,0.9789473684210528,0.7560975609756098
2024,KHOUALKA,CITRUS VOLKAMERIANA,20205,IMG-12058.jpg,116,110,110,0,6,1.0,0.9482758620689656
2022,SAOUDA,CITRUS VOLKAMERIANA,21020,IMG-00033-45.jpg,67,85,66,19,1,0.7764705882352941,0.9850746268656716
2022,SAOUDA,CITRUS VOLKAMERIANA,21020,IMG-00087-45.jpg,21,27,20,7,1,0.7407407407407407,0.9523809523809524
2022,SAOUDA,CITRUS VOLKAMERIANA,21020,IMG-00138-45.jpg,40,46,39,7,1,0.8478260869565217,0.975
2022,SAOUDA,CITRUS VOLKAMERIANA,21020,IMG-00145-45.jpg,37,42,37,5,0,0.8809523809523809,1.0
2022,SAOUDA,CITRUS VOLKAMERIANA,21020,IMG-00155-45.jpg,38,56,38,18,0,0.6785714285714286,1.0
2022,SAOUDA,CITRUS VOLKAMERIANA,21030,IMG-00521-45.jpg,31,43,31,12,0,0.7209302325581395,1.0
2022,SAOUDA,CITRUS VOLKAMERIANA,21030,IMG-00524-45.jpg,71,87,70,17,1,0.8045977011494253,0.9859154929577464
2022,SAOUDA,CITRUS VOLKAMERIANA,21030,IMG-00536-45.jpg,41,63,41,22,0,0.6507936507936508,1.0
2022,SAOUDA,CITRUS VOLKAMERIANA,21030,IMG-00537-45.jpg,52,65,47,18,5,0.7230769230769231,0.903846153846154
2022,SAOUDA,CITRUS VOLKAMERIANA,22020,IMG-00053-45.jpg,39,56,39,17,0,0.6964285714285714,1.0
2022,SAOUDA,CITRUS VOLKAMERIANA,22020,IMG-00059-45.jpg,46,55,44,11,2,0.8,0.9565217391304348
2022,SAOUDA,CITRUS VOLKAMERIANA,22020,IMG-00060-45.jpg,48,56,47,9,1,0.8392857142857143,0.9791666666666666
2022,SAOUDA,CITRUS VOLKAMERIANA,22020,IMG-00062-45.jpg,50,69,50,19,0,0.7246376811594203,1.0
2022,SAOUDA,CITRUS VOLKAMERIANA,22030,IMG-00062-45.jpg,62,72,62,10,0,0.8611111111111112,1.0
2022,SAOUDA,CITRUS VOLKAMERIANA,22030,IMG-00063-45.jpg,83,101,80,21,3,0.7920792079207921,0.963855421686747
2022,SAOUDA,CITRUS VOLKAMERIANA,22030,IMG-00065-45.jpg,58,66,57,9,1,0.8636363636363636,0.9827586206896552
2022,SAOUDA,CITRUS VOLKAMERIANA,22030,IMG-00068-45.jpg,66,81,65,16,1,0.8024691358024691,0.9848484848484848
2022,SAOUDA,CITRUS VOLKAMERIANA,23020,IMG-00024-45.jpg,47,62,46,16,1,0.7419354838709677,0.9787234042553192
2022,SAOUDA,CITRUS VOLKAMERIANA,23020,IMG-00032-45.jpg,33,37,33,4,0,0.8918918918918919,1.0
2022,SAOUDA,CITRUS VOLKAMERIANA,23020,IMG-00074-45.jpg,28,35,27,8,1,0.7714285714285715,0.9642857142857144
2022,SAOUDA,CITRUS VOLKAMERIANA,23020,IMG-00079-45.jpg,28,40,28,12,0,0.7,1.0
2022,SAOUDA,CITRUS VOLKAMERIANA,23030,IMG-00014-45.jpg,25,36,24,12,1,0.6666666666666666,0.96
2022,SAOUDA,CITRUS VOLKAMERIANA,23030,IMG-00034-45.jpg,43,60,42,18,1,0.7,0.9767441860465116
2022,SAOUDA,CITRUS VOLKAMERIANA,23030,IMG-00069-45.jpg,28,53,27,26,1,0.5094339622641509,0.9642857142857144
2022,SAOUDA,CITRUS VOLKAMERIANA,23030,IMG-00079-45.jpg,50,77,49,28,1,0.6363636363636364,0.98
2022,SAOUDA,CITRANGE CARRIZO,24010,IMG-00097-45.jpg,59,74,56,18,3,0.7567567567567568,0.9491525423728814
2022,SAOUDA,CITRANGE CARRIZO,24010,IMG-00101-45.jpg,27,34,26,8,1,0.7647058823529411,0.9629629629629628
2022,SAOUDA,CITRANGE CARRIZO,24010,IMG-00111-45.jpg,54,63,53,10,1,0.8412698412698413,0.9814814814814816
2022,SAOUDA,CITRANGE CARRIZO,24010,IMG-00112-45.jpg,40,54,40,14,0,0.7407407407407407,1.0
2022,SAOUDA,CITRANGE CARRIZO,25010,IMG-00006-45.jpg,55,70,55,15,0,0.7857142857142857,1.0
2022,SAOUDA,CITRANGE CARRIZO,25010,IMG-00007-45.jpg,77,95,77,18,0,0.8105263157894737,1.0
2022,SAOUDA,CITRANGE CARRIZO,25010,IMG-00010-45.jpg,53,71,53,18,0,0.7464788732394366,1.0
2022,SAOUDA,CITRANGE CARRIZO,25010,IMG-00011-45.jpg,26,31,26,5,0,0.8387096774193549,1.0
2022,SAOUDA,CITRANGE CARRIZO,26010,IMG-00008-45.jpg,39,42,39,3,0,0.9285714285714286,1.0
2022,SAOUDA,CITRANGE CARRIZO,26010,IMG-00013-45.jpg,36,46,36,10,0,0.782608695652174,1.0
2022,SAOUDA,CITRANGE CARRIZO,26010,IMG-00018-45.jpg,43,53,43,10,0,0.8113207547169812,1.0
2022,SAOUDA,CITRANGE CARRIZO,26010,IMG-00020-45.jpg,44,46,42,4,2,0.9130434782608696,0.9545454545454546
2022,KHOUALKA,CITRANGE CARRIZO,30138,IMG-00002-40.jpg,39,41,37,4,2,0.902439024390244,0.9487179487179488
2022,KHOUALKA,CITRANGE CARRIZO,30138,IMG-00003-40.jpg,59,67,57,10,2,0.8507462686567164,0.9661016949152542
2022,KHOUALKA,CITRANGE CARRIZO,30138,IMG-00005-40.jpg,58,69,58,11,0,0.8405797101449275,1.0
2022,KHOUALKA,CITRANGE CARRIZO,30138,IMG-00008-40.jpg,32,34,29,5,3,0.8529411764705882,0.90625
2022,KHOUALKA,CITRANGE CARRIZO,30138,IMG-00011-40.jpg,26,31,26,5,0,0.8387096774193549,1.0
2022,KHOUALKA,CITRANGE CARRIZO,30138,IMG-00019-40.jpg,2,1,1,0,1,1.0,0.5
2022,KHOUALKA,CITRANGE CARRIZO,30138,IMG-00037-40.jpg,30,31,28,3,2,0.9032258064516128,0.9333333333333332
2022,KHOUALKA,CITRANGE CARRIZO,30138,IMG-00040-40.jpg,41,43,40,3,1,0.9302325581395348,0.975609756097561
2022,KHOUALKA,CITRANGE CARRIZO,30138,IMG-00043-40.jpg,28,37,26,11,2,0.7027027027027027,0.9285714285714286
2022,KHOUALKA,CITRANGE CARRIZO,30138,IMG-00044-40.jpg,99,105,97,8,2,0.923809523809524,0.9797979797979798
2022,KHOUALKA,CITRANGE CARRIZO,30138,IMG-00048-40.jpg,37,43,35,8,2,0.813953488372093,0.945945945945946
2022,KHOUALKA,CITRANGE CARRIZO,30138,IMG-00057-40.jpg,73,76,70,6,3,0.9210526315789472,0.958904109589041
2022,KHOUALKA,CITRANGE CARRIZO,30138,IMG-00063-40.jpg,89,83,81,2,8,0.9759036144578314,0.9101123595505618
2022,ONAGRI,CITRUS VOLKAMERIANA,30145,IMG-00018-39.jpg,219,207,197,10,22,0.9516908212560388,0.8995433789954338
2022,ONAGRI,CITRUS VOLKAMERIANA,30145,IMG-00043-39.jpg,64,67,61,6,3,0.9104477611940298,0.953125
2022,ONAGRI,CITRUS VOLKAMERIANA,30146,IMG-00008-39.jpg,262,251,236,15,26,0.9402390438247012,0.900763358778626
2022,ONAGRI,CITRUS VOLKAMERIANA,30146,IMG-00045-39.jpg,190,198,182,16,8,0.9191919191919192,0.9578947368421052
2022,ONAGRI,CITRUS VOLKAMERIANA,30147,IMG-00002-39.jpg,269,256,246,10,23,0.9609375,0.9144981412639404
2022,ONAGRI,CITRUS VOLKAMERIANA,30147,IMG-00008-39.jpg,172,173,161,12,11,0.930635838150289,0.936046511627907
2022,ONAGRI,CITRUS VOLKAMERIANA,30148,IMG-00016-40.jpg,88,92,85,7,3,0.9239130434782608,0.9659090909090908
2022,ONAGRI,CITRUS VOLKAMERIANA,30148,IMG-00047-40.jpg,34,32,32,0,2,1.0,0.9411764705882352
2022,ONAGRI,CITRUS VOLKAMERIANA,30149,IMG-00018-39.jpg,151,136,134,2,17,0.9852941176470588,0.8874172185430463
2022,ONAGRI,CITRUS VOLKAMERIANA,30149,IMG-00027-39.jpg,226,196,195,1,31,0.9948979591836736,0.8628318584070797
2022,ONAGRI,CITRUS VOLKAMERIANA,30151,IMG-00012-39.jpg,185,166,158,8,27,0.9518072289156626,0.8540540540540541
2022,ONAGRI,CITRUS VOLKAMERIANA,30151,IMG-00033-39.jpg,214,211,199,12,15,0.943127962085308,0.9299065420560748
2024,ONAGRI,CITRUS VOLKAMERIANA,30151,IMG-21881.jpg,73,53,53,0,20,1.0,0.726027397260274
2024,ONAGRI,CITRUS VOLKAMERIANA,30151,IMG-21935.jpg,179,159,155,4,24,0.9748427672955976,0.8659217877094972
2024,ONAGRI,CITRUS VOLKAMERIANA,30151,IMG-21936.jpg,93,76,75,1,18,0.986842105263158,0.8064516129032258
2022,ONAGRI,CITRUS VOLKAMERIANA,30152,IMG-00016-39.jpg,39,37,35,2,4,0.945945945945946,0.8974358974358975
2022,ONAGRI,CITRUS VOLKAMERIANA,30152,IMG-00019-39.jpg,139,126,121,5,18,0.9603174603174603,0.8705035971223022
2022,ONAGRI,CITRUS VOLKAMERIANA,30153,IMG-00001.jpg,157,149,144,5,13,0.9664429530201344,0.9171974522292994
2022,ONAGRI,CITRUS VOLKAMERIANA,30153,IMG-00007-39.jpg,127,117,111,6,16,0.9487179487179488,0.8740157480314961
2022,ONAGRI,CITRUS VOLKAMERIANA,30153,IMG-00013-39.jpg,159,153,149,4,10,0.9738562091503268,0.9371069182389936
2022,ONAGRI,CITRUS VOLKAMERIANA,30153,IMG-00040-39.jpg,153,144,140,4,13,0.9722222222222222,0.915032679738562
2022,ONAGRI,CITRUS VOLKAMERIANA,30154,IMG-00017-39.jpg,160,155,151,4,9,0.9741935483870968,0.94375
2022,ONAGRI,CITRUS VOLKAMERIANA,30154,IMG-00027-39.jpg,220,222,213,9,7,0.9594594594594594,0.968181818181818
2022,ONAGRI,CITRUS VOLKAMERIANA,30154,IMG-00033-39.jpg,51,50,49,1,2,0.98,0.9607843137254902
2022,ONAGRI,CITRUS VOLKAMERIANA,30154,IMG-00036-39.jpg,137,138,131,7,6,0.9492753623188406,0.9562043795620438
2022,ONAGRI,CITRUS VOLKAMERIANA,30154,IMG-00038-39.jpg,242,244,233,11,9,0.9549180327868853,0.962809917355372
2022,ONAGRI,CITRUS VOLKAMERIANA,30154,IMG-00041-39.jpg,272,256,242,14,30,0.9453125,0.8897058823529411
2022,ONAGRI,CITRUS VOLKAMERIANA,30154,IMG-00044-39.jpg,141,146,136,10,5,0.9315068493150684,0.9645390070921984
2022,ONAGRI,BIGARADIER,30155,IMG-00002-39.jpg,139,146,136,10,3,0.9315068493150684,0.9784172661870504
2022,ONAGRI,BIGARADIER,30155,IMG-00003-39.jpg,115,116,111,5,4,0.956896551724138,0.9652173913043478
2022,ONAGRI,BIGARADIER,30155,IMG-00006-39.jpg,44,46,40,6,4,0.8695652173913043,0.9090909090909092
2022,ONAGRI,BIGARADIER,30155,IMG-00011-39.jpg,100,94,92,2,8,0.9787234042553192,0.92
2022,ONAGRI,BIGARADIER,30155,IMG-00019-39.jpg,142,137,129,8,13,0.9416058394160584,0.908450704225352
2022,ONAGRI,BIGARADIER,30155,IMG-00026-39.jpg,124,116,113,3,11,0.9741379310344828,0.9112903225806452
2022,ONAGRI,BIGARADIER,30155,IMG-00032-39.jpg,81,79,75,4,6,0.9493670886075948,0.925925925925926
2022,ONAGRI,BIGARADIER,30155,IMG-00039-39.jpg,19,17,15,2,4,0.8823529411764706,0.7894736842105263
2022,ONAGRI,BIGARADIER,30155,IMG-00043-39.jpg,130,133,125,8,5,0.9398496240601504,0.9615384615384616
2022,ONAGRI,CITRUS VOLKAMERIANA,30157,IMG-00003-39.jpg,227,222,216,6,11,0.972972972972973,0.9515418502202644
2022,ONAGRI,CITRUS VOLKAMERIANA,30157,IMG-00012-39.jpg,283,280,265,15,18,0.9464285714285714,0.9363957597173144
2022,ONAGRI,CITRUS VOLKAMERIANA,30157,IMG-00032-39.jpg,64,72,64,8,0,0.8888888888888888,1.0
2022,ONAGRI,CITRUS VOLKAMERIANA,30157,IMG-00035-39.jpg,159,153,148,5,11,0.9673202614379084,0.9308176100628932
2022,KHOUALKA,CITRUS VOLKAMERIANA,30235,IMG-00001.jpg,93,98,90,8,3,0.9183673469387756,0.967741935483871
2022,KHOUALKA,CITRUS VOLKAMERIANA,30235,IMG-00003-40.jpg,37,42,37,5,0,0.8809523809523809,1.0
2022,KHOUALKA,CITRUS VOLKAMERIANA,30235,IMG-00009-40.jpg,103,109,100,9,3,0.9174311926605504,0.970873786407767
2022,KHOUALKA,CITRUS VOLKAMERIANA,30235,IMG-00013-40.jpg,90,101,90,11,0,0.8910891089108911,1.0
2022,KHOUALKA,CITRUS VOLKAMERIANA,30235,IMG-00026-40.jpg,122,133,120,13,2,0.9022556390977444,0.9836065573770492
2022,KHOUALKA,CITRUS VOLKAMERIANA,30235,IMG-00047-40.jpg,47,50,41,9,6,0.82,0.8723404255319149
2022,KHOUALKA,CITRUS VOLKAMERIANA,30235,IMG-00048-40.jpg,90,100,87,13,3,0.87,0.9666666666666668
2022,KHOUALKA,CITRUS VOLKAMERIANA,30235,IMG-00049-40.jpg,44,51,42,9,2,0.8235294117647058,0.9545454545454546
2022,KHOUALKA,CITRUS VOLKAMERIANA,30235,IMG-00050-40.jpg,84,90,78,12,6,0.8666666666666667,0.9285714285714286
2022,KHOUALKA,CITRUS VOLKAMERIANA,30235,IMG-00052-40.jpg,98,114,97,17,1,0.8508771929824561,0.9897959183673468
2022,KHOUALKA,CITRUS VOLKAMERIANA,30235,IMG-00057-40.jpg,80,82,76,6,4,0.926829268292683,0.95
2022,KHOUALKA,CITRUS VOLKAMERIANA,30235,IMG-00064-40.jpg,38,46,35,11,3,0.7608695652173914,0.9210526315789472
2022,KHOUALKA,CITRUS VOLKAMERIANA,30235,IMG-00067-40.jpg,107,105,101,4,6,0.961904761904762,0.9439252336448598
2022,KHOUALKA,CITRUS VOLKAMERIANA,30235,IMG-00069-40.jpg,34,42,33,9,1,0.7857142857142857,0.9705882352941176
2022,KHOUALKA,CITRUS VOLKAMERIANA,30235,IMG-00075-40.jpg,95,103,92,11,3,0.8932038834951457,0.968421052631579
2022,KHOUALKA,BIGARADIER,40141,IMG-00006-40.jpg,7,9,6,3,1,0.6666666666666666,0.8571428571428571
2022,KHOUALKA,BIGARADIER,40141,IMG-00007-40.jpg,20,10,10,0,10,1.0,0.5
2022,KHOUALKA,BIGARADIER,40141,IMG-00008-40.jpg,15,16,13,3,2,0.8125,0.8666666666666667
2022,ONAGRI,CITRANGE C35,40166,IMG-00009-39.jpg,38,40,37,3,1,0.925,0.9736842105263158
2022,ONAGRI,CITRANGE C35,40166,IMG-00011-39.jpg,173,173,166,7,7,0.9595375722543352,0.9595375722543352
2022,ONAGRI,CITRANGE C35,40166,IMG-00014-39.jpg,179,180,175,5,4,0.9722222222222222,0.9776536312849162
2022,ONAGRI,CITRANGE C35,40166,IMG-00015-39.jpg,122,128,116,12,6,0.90625,0.9508196721311476
2022,ONAGRI,CITRANGE C35,40166,IMG-00041-39.jpg,102,100,99,1,3,0.99,0.9705882352941176
2022,ONAGRI,CITRANGE C35,40167,IMG-00019-39.jpg,197,197,192,5,5,0.9746192893401016,0.9746192893401016
2022,ONAGRI,CITRANGE C35,40167,IMG-00030-39.jpg,126,124,119,5,7,0.9596774193548387,0.9444444444444444
2022,ONAGRI,CITRANGE C35,40167,IMG-00039-39.jpg,217,213,200,13,17,0.9389671361502347,0.9216589861751152
2022,ONAGRI,CITRANGE C35,40171,IMG-00008-39.jpg,109,104,102,2,7,0.9807692307692308,0.9357798165137616
2022,ONAGRI,CITRANGE C35,40171,IMG-00037-39.jpg,94,88,84,4,10,0.9545454545454546,0.8936170212765957
2022,ONAGRI,CITRANGE C35,40171,IMG-00040-39.jpg,149,147,137,10,12,0.9319727891156464,0.9194630872483222
2022,ONAGRI,CITRANGE C35,40172,IMG-00012-39.jpg,89,83,82,1,7,0.9879518072289156,0.9213483146067416
2022,ONAGRI,CITRANGE C35,40172,IMG-00025-39.jpg,109,102,100,2,9,0.9803921568627452,0.9174311926605504
2022,ONAGRI,CITRANGE C35,40172,IMG-00027-39.jpg,103,96,91,5,12,0.9479166666666666,0.883495145631068
2022,ONAGRI,CITRANGE C35,40173,IMG-00004-39.jpg,133,120,118,2,15,0.9833333333333332,0.8872180451127819
2022,ONAGRI,CITRANGE C35,40173,IMG-00008-39.jpg,57,46,45,1,12,0.9782608695652174,0.7894736842105263
2022,ONAGRI,CITRANGE C35,40173,IMG-00010-39.jpg,53,60,51,9,2,0.85,0.9622641509433962
2022,ONAGRI,CITRANGE C35,40175,IMG-00005-39.jpg,95,89,83,6,12,0.9325842696629212,0.8736842105263158
2022,ONAGRI,CITRANGE C35,40175,IMG-00006-39.jpg,64,63,59,4,5,0.9365079365079364,0.921875
2022,ONAGRI,CITRANGE C35,40176,IMG-00004-39.jpg,79,84,73,11,6,0.8690476190476191,0.9240506329113924
2022,ONAGRI,CITRANGE C35,40176,IMG-00012-39.jpg,105,112,103,9,2,0.9196428571428572,0.9809523809523808
2022,ONAGRI,CITRANGE C35,40176,IMG-00014-39.jpg,91,97,86,11,5,0.8865979381443299,0.945054945054945
2022,ONAGRI,CITRUMELO SACCATON,40177,IMG-00012-39.jpg,89,97,86,11,3,0.8865979381443299,0.9662921348314608
2022,ONAGRI,CITRUMELO SACCATON,40177,IMG-00015-39.jpg,213,221,210,11,3,0.9502262443438914,0.9859154929577464
2022,ONAGRI,CITRUMELO SACCATON,40177,IMG-00037-39.jpg,95,99,92,7,3,0.9292929292929292,0.968421052631579
2022,ONAGRI,CITRANGE C35,40178,IMG-00013-39.jpg,76,82,76,6,0,0.926829268292683,1.0
2022,ONAGRI,CITRANGE C35,40178,IMG-00027-39.jpg,56,58,55,3,1,0.9482758620689656,0.9821428571428572
2022,ONAGRI,CITRANGE C35,40178,IMG-00031-39.jpg,30,34,30,4,0,0.8823529411764706,1.0
2022,ONAGRI,CITRANGE C35,40178,IMG-00032-39.jpg,27,30,27,3,0,0.9,1.0
2022,ONAGRI,CITRANGE C35,40178,IMG-00033-39.jpg,34,36,33,3,1,0.9166666666666666,0.9705882352941176
2022,ONAGRI,CITRANGE C35,40179,IMG-00001.jpg,83,86,79,7,4,0.9186046511627908,0.9518072289156626
2022,ONAGRI,CITRANGE C35,40179,IMG-00010-39.jpg,161,166,155,11,6,0.933734939759036,0.9627329192546584
2022,ONAGRI,CITRANGE C35,40179,IMG-00011-39.jpg,102,104,97,7,5,0.9326923076923076,0.9509803921568628
2022,ONAGRI,CITRANGE C35,40179,IMG-00018-39.jpg,9,9,8,1,1,0.8888888888888888,0.8888888888888888
2022,ONAGRI,CITRUMELO SACCATON,40182,IMG-00004-39.jpg,35,38,35,3,0,0.9210526315789472,1.0
2022,ONAGRI,CITRUMELO SACCATON,40182,IMG-00010-39.jpg,52,53,49,4,3,0.9245283018867924,0.9423076923076924
2022,ONAGRI,CITRUMELO SACCATON,40182,IMG-00015-39.jpg,85,89,80,9,5,0.898876404494382,0.9411764705882352
2022,ONAGRI,CITRUMELO SACCATON,40183,IMG-00005-39.jpg,68,69,67,2,1,0.9710144927536232,0.9852941176470588
2022,ONAGRI,CITRUMELO SACCATON,40183,IMG-00009-39.jpg,57,63,56,7,1,0.8888888888888888,0.9824561403508772
2022,ONAGRI,CITRUMELO SACCATON,40183,IMG-00010-39.jpg,48,48,45,3,3,0.9375,0.9375
2024,KHOUALKA,CITRUS VOLKAMERIANA,50152,IMG-17274.jpg,170,126,126,0,44,1.0,0.7411764705882353
2024,KHOUALKA,CITRUS VOLKAMERIANA,50152,IMG-17306.jpg,105,87,87,0,18,1.0,0.8285714285714286
2024,KHOUALKA,CITRUS VOLKAMERIANA,50152,IMG-17330.jpg,41,28,28,0,13,1.0,0.6829268292682927
2024,KHOUALKA,CITRUS VOLKAMERIANA,50152,IMG-17335.jpg,44,33,33,0,11,1.0,0.75
2024,KHOUALKA,CITRUS VOLKAMERIANA,50152,IMG-17340.jpg,108,74,73,1,35,0.9864864864864864,0.6759259259259259
2024,KHOUALKA,CITRUS VOLKAMERIANA,50152,IMG-17356.jpg,60,42,39,3,21,0.9285714285714286,0.65
2024,KHOUALKA,CITRUS VOLKAMERIANA,50152,IMG-17384.jpg,53,34,34,0,19,1.0,0.6415094339622641
2024,KHOUALKA,CITRUS VOLKAMERIANA,50154,IMG-17440.jpg,76,64,64,0,12,1.0,0.8421052631578947
2024,KHOUALKA,CITRUS VOLKAMERIANA,50154,IMG-17490.jpg,107,76,76,0,31,1.0,0.7102803738317757
2024,KHOUALKA,CITRUS VOLKAMERIANA,50154,IMG-17543.jpg,100,68,68,0,32,1.0,0.68
2024,KHOUALKA,CITRUS VOLKAMERIANA,50154,IMG-17545.jpg,94,68,68,0,26,1.0,0.723404255319149
2024,KHOUALKA,CITRUS VOLKAMERIANA,50154,IMG-17562.jpg,129,107,107,0,22,1.0,0.8294573643410853
2024,KHOUALKA,CITRUS VOLKAMERIANA,50154,IMG-17576.jpg,121,96,96,0,25,1.0,0.7933884297520661
2024,KHOUALKA,CITRUS VOLKAMERIANA,50154,IMG-17585.jpg,171,129,128,1,43,0.992248062015504,0.7485380116959064
2024,KHOUALKA,CITRUS VOLKAMERIANA,50168,IMG-13980.jpg,174,130,130,0,44,1.0,0.7471264367816092
2024,KHOUALKA,CITRUS VOLKAMERIANA,50168,IMG-15749.jpg,147,121,121,0,26,1.0,0.8231292517006803
2024,KHOUALKA,CITRUS VOLKAMERIANA,50168,IMG-15758.jpg,163,125,124,1,39,0.992,0.7607361963190185
2024,KHOUALKA,CITRUS VOLKAMERIANA,50168,IMG-15981.jpg,210,159,158,1,52,0.9937106918238994,0.7523809523809524
2024,KHOUALKA,CITRUS VOLKAMERIANA,50168,IMG-15983.jpg,120,98,96,2,24,0.979591836734694,0.8
2024,KHOUALKA,CITRUS VOLKAMERIANA,50176,IMG-16025.jpg,81,63,63,0,18,1.0,0.7777777777777778
2024,KHOUALKA,CITRUS VOLKAMERIANA,50176,IMG-16051.jpg,85,69,69,0,16,1.0,0.8117647058823529
2024,KHOUALKA,CITRUS VOLKAMERIANA,50176,IMG-16079.jpg,161,121,120,1,41,0.9917355371900828,0.7453416149068323
2024,KHOUALKA,CITRUS VOLKAMERIANA,50176,IMG-16095.jpg,101,67,67,0,34,1.0,0.6633663366336634
2024,KHOUALKA,CITRUS VOLKAMERIANA,50176,IMG-16105.jpg,43,34,34,0,9,1.0,0.7906976744186046
2022,ONAGRI,CITRUMELO SACCATON,50193,IMG-00007-39.jpg,218,240,218,22,0,0.9083333333333332,1.0
2022,ONAGRI,CITRUMELO SACCATON,50193,IMG-00016-39.jpg,64,75,62,13,2,0.8266666666666667,0.96875
2022,ONAGRI,CITRUMELO SACCATON,50193,IMG-00018-39.jpg,115,126,113,13,2,0.8968253968253969,0.982608695652174
2022,ONAGRI,CITRUMELO SACCATON,50193,IMG-00021-39.jpg,62,61,58,3,4,0.9508196721311476,0.935483870967742
2022,ONAGRI,CITRUMELO SACCATON,50193,IMG-00023-39.jpg,113,128,112,16,1,0.875,0.991150442477876
2022,ONAGRI,CITRUMELO SACCATON,50194,IMG-00032-39.jpg,162,171,153,18,9,0.8947368421052632,0.9444444444444444
2022,ONAGRI,CITRUMELO SACCATON,50194,IMG-00034-39.jpg,105,118,105,13,0,0.8898305084745762,1.0
2022,ONAGRI,CITRUMELO SACCATON,50194,IMG-00036-39.jpg,161,183,154,29,7,0.8415300546448088,0.9565217391304348
2022,ONAGRI,CITRUMELO SACCATON,50194,IMG-00038-39.jpg,100,111,97,14,3,0.8738738738738738,0.97
2022,ONAGRI,CITRUMELO SACCATON,50194,IMG-00039-39.jpg,65,69,64,5,1,0.927536231884058,0.9846153846153848
2022,ONAGRI,CITRUMELO SACCATON,50194,IMG-00041-39.jpg,153,158,147,11,6,0.930379746835443,0.9607843137254902
2022,ONAGRI,CITRUMELO SACCATON,50194,IMG-00051-39.jpg,137,145,135,10,2,0.9310344827586208,0.9854014598540146
2022,ONAGRI,CITRUMELO SACCATON,50194,IMG-00054-39.jpg,111,111,103,8,8,0.927927927927928,0.927927927927928
2022,ONAGRI,CITRUMELO SACCATON,51091,IMG-00015-39.jpg,85,98,84,14,1,0.8571428571428571,0.9882352941176472
2022,ONAGRI,CITRUMELO SACCATON,51091,IMG-00016-39.jpg,170,174,168,6,2,0.9655172413793104,0.9882352941176472
2022,ONAGRI,CITRUMELO SACCATON,51091,IMG-00018-39.jpg,185,208,183,25,2,0.8798076923076923,0.9891891891891892
2022,ONAGRI,CITRUMELO SACCATON,51091,IMG-00022-39.jpg,135,156,133,23,2,0.8525641025641025,0.9851851851851852
2022,ONAGRI,CITRUMELO SACCATON,51091,IMG-00023-39.jpg,140,148,135,13,5,0.9121621621621622,0.9642857142857144
2022,ONAGRI,CITRUMELO SACCATON,51091,IMG-00026-39.jpg,149,151,142,9,7,0.9403973509933776,0.953020134228188
2022,ONAGRI,CITRUMELO SACCATON,51091,IMG-00044-39.jpg,168,180,167,13,1,0.9277777777777778,0.9940476190476192
2022,ONAGRI,CITRUMELO SACCATON,51095,IMG-00004-39.jpg,201,224,198,26,3,0.8839285714285714,0.9850746268656716
2022,ONAGRI,CITRUMELO SACCATON,51095,IMG-00013-39.jpg,154,156,146,10,8,0.935897435897436,0.948051948051948
2022,ONAGRI,CITRUMELO SACCATON,51095,IMG-00014-39.jpg,140,152,136,16,4,0.8947368421052632,0.9714285714285714
2022,ONAGRI,CITRUMELO SACCATON,51095,IMG-00015-39.jpg,196,201,194,7,2,0.965174129353234,0.9897959183673468
2022,ONAGRI,CITRUMELO SACCATON,51095,IMG-00024-39.jpg,234,246,229,17,5,0.9308943089430894,0.9786324786324786
2022,ONAGRI,CITRUMELO SACCATON,51095,IMG-00025-39.jpg,198,213,195,18,3,0.9154929577464788,0.9848484848484848
2022,ONAGRI,CITRUMELO SACCATON,51096,IMG-00009-39.jpg,219,231,213,18,6,0.922077922077922,0.9726027397260274
2022,ONAGRI,CITRUMELO SACCATON,51096,IMG-00011-39.jpg,145,159,142,17,3,0.8930817610062893,0.9793103448275862
2022,ONAGRI,CITRUMELO SACCATON,51096,IMG-00012-39.jpg,114,118,108,10,6,0.9152542372881356,0.9473684210526316
2022,ONAGRI,CITRUMELO SACCATON,51096,IMG-00055-39.jpg,217,224,212,12,5,0.9464285714285714,0.976958525345622
2022,ONAGRI,MC PONSIRUCE TRIFOLIATA,51097,IMG-00025-39.jpg,121,134,115,19,6,0.8582089552238806,0.950413223140496
2022,ONAGRI,MC PONSIRUCE TRIFOLIATA,51097,IMG-00029-39.jpg,106,122,104,18,2,0.8524590163934426,0.981132075471698
2022,ONAGRI,MC PONSIRUCE TRIFOLIATA,51097,IMG-00044-39.jpg,182,199,178,21,4,0.8944723618090452,0.978021978021978
2022,ONAGRI,MC PONSIRUCE TRIFOLIATA,51098,IMG-00003-39.jpg,65,72,62,10,3,0.8611111111111112,0.953846153846154
2022,ONAGRI,MC PONSIRUCE TRIFOLIATA,51098,IMG-00010-39.jpg,184,191,179,12,5,0.93717277486911,0.9728260869565216
2022,ONAGRI,MC PONSIRUCE TRIFOLIATA,51098,IMG-00015-39.jpg,162,171,162,9,0,0.9473684210526316,1.0
2022,ONAGRI,MC PONSIRUCE TRIFOLIATA,51099,IMG-00012-39.jpg,133,147,131,16,2,0.891156462585034,0.9849624060150376
2024,ONAGRI,MC PONSIRUCE TRIFOLIATA,51101,IMG-12118.jpg,177,126,126,0,51,1.0,0.711864406779661
2024,ONAGRI,MC PONSIRUCE TRIFOLIATA,51101,IMG-14223.jpg,153,124,124,0,29,1.0,0.8104575163398693
2024,ONAGRI,MC PONSIRUCE TRIFOLIATA,51101,IMG-14226.jpg,151,127,126,1,25,0.9921259842519684,0.8344370860927153
2024,ONAGRI,MC PONSIRUCE TRIFOLIATA,51101,IMG-14255.jpg,189,156,155,1,34,0.9935897435897436,0.8201058201058201
2024,ONAGRI,MC PONSIRUCE TRIFOLIATA,51101,IMG-14281.jpg,150,122,121,1,29,0.9918032786885246,0.8066666666666666
2022,ONAGRI,CITRUS VOLKAMERIANA,101020,IMG-00001.jpg,6,6,6,0,0,1.0,1.0
2022,ONAGRI,CITRUS VOLKAMERIANA,101020,IMG-00004-44.jpg,53,50,47,3,6,0.94,0.8867924528301887
2022,ONAGRI,CITRUS VOLKAMERIANA,101030,IMG-00003-44.jpg,29,28,27,1,2,0.9642857142857144,0.9310344827586208
2022,ONAGRI,CITRUS VOLKAMERIANA,101030,IMG-00004-44.jpg,110,111,106,5,4,0.954954954954955,0.9636363636363636
2022,ONAGRI,CITRUS VOLKAMERIANA,101030,IMG-00005-44.jpg,134,132,126,6,8,0.9545454545454546,0.9402985074626866
2022,ONAGRI,CITRUS VOLKAMERIANA,101030,IMG-00017-44.jpg,79,74,72,2,7,0.972972972972973,0.9113924050632912
2022,ONAGRI,CITRUS VOLKAMERIANA,101040,IMG-00005-44.jpg,172,168,159,9,13,0.9464285714285714,0.9244186046511628
2022,ONAGRI,CITRUS VOLKAMERIANA,101040,IMG-00009-44.jpg,131,141,127,14,4,0.900709219858156,0.9694656488549618
2022,ONAGRI,CITRUS VOLKAMERIANA,101040,IMG-00011-44.jpg,64,62,61,1,3,0.9838709677419356,0.953125
2022,ONAGRI,CITRUS VOLKAMERIANA,101040,IMG-00012-44.jpg,139,135,128,7,11,0.9481481481481482,0.920863309352518
2022,ONAGRI,CITRUS VOLKAMERIANA,101050,IMG-00002-44.jpg,95,98,92,6,3,0.9387755102040816,0.968421052631579
2022,ONAGRI,CITRUS VOLKAMERIANA,101050,IMG-00005-44.jpg,59,54,53,1,6,0.9814814814814816,0.8983050847457628
2022,ONAGRI,CITRUS VOLKAMERIANA,101050,IMG-00011-44.jpg,46,44,43,1,3,0.9772727272727272,0.9347826086956522
2022,ONAGRI,CITRUS VOLKAMERIANA,101050,IMG-00024-44.jpg,40,42,39,3,1,0.9285714285714286,0.975
2022,ONAGRI,CITRUS VOLKAMERIANA,101080,IMG-00005-44.jpg,42,41,38,3,4,0.926829268292683,0.9047619047619048
2022,ONAGRI,CITRUS VOLKAMERIANA,101080,IMG-00006-44.jpg,79,70,69,1,10,0.9857142857142858,0.8734177215189873
2022,ONAGRI,CITRUS VOLKAMERIANA,101080,IMG-00023-44.jpg,7,8,7,1,0,0.875,1.0
2022,ONAGRI,CITRUS VOLKAMERIANA,101080,IMG-00024-44.jpg,27,26,25,1,2,0.9615384615384616,0.925925925925926
2022,ONAGRI,CITRUS VOLKAMERIANA,101090,IMG-00003-44.jpg,66,66,63,3,3,0.9545454545454546,0.9545454545454546
2022,ONAGRI,CITRUS VOLKAMERIANA,101090,IMG-00006-44.jpg,41,38,37,1,4,0.9736842105263158,0.902439024390244
2022,ONAGRI,CITRUS VOLKAMERIANA,101090,IMG-00019-44.jpg,35,38,34,4,1,0.8947368421052632,0.9714285714285714
2022,ONAGRI,CITRUS VOLKAMERIANA,101090,IMG-00020-44.jpg,42,40,39,1,3,0.975,0.9285714285714286
2022,KHOUALKA,CITRANGE CARRIZO,102130,IMG-00001.jpg,5,5,4,1,1,0.8,0.8
2022,KHOUALKA,CITRANGE CARRIZO,102130,IMG-00004-43.jpg,24,20,20,0,4,1.0,0.8333333333333334
2022,KHOUALKA,CITRANGE CARRIZO,102130,IMG-00019-43.jpg,33,34,31,3,2,0.9117647058823528,0.9393939393939394
2022,KHOUALKA,CITRANGE CARRIZO,102130,IMG-00020-43.jpg,18,23,17,6,1,0.7391304347826086,0.9444444444444444
2022,KHOUALKA,MACROPHYLLA,201180,IMG-00007-43.jpg,38,48,37,11,1,0.7708333333333334,0.9736842105263158
2022,KHOUALKA,MACROPHYLLA,201180,IMG-00011-43.jpg,64,65,58,7,6,0.8923076923076924,0.90625
2022,KHOUALKA,MACROPHYLLA,201180,IMG-00019-43.jpg,64,62,60,2,4,0.967741935483871,0.9375
2022,KHOUALKA,MACROPHYLLA,201180,IMG-00020-43.jpg,43,40,37,3,6,0.925,0.8604651162790697
2022,KHOUALKA,MACROPHYLLA,201190,IMG-00004-43.jpg,101,76,74,2,27,0.9736842105263158,0.7326732673267327
2022,KHOUALKA,MACROPHYLLA,201190,IMG-00010-43.jpg,90,77,75,2,15,0.974025974025974,0.8333333333333334
2022,KHOUALKA,MACROPHYLLA,201190,IMG-00011-43.jpg,134,105,102,3,32,0.9714285714285714,0.7611940298507462
2022,KHOUALKA,MACROPHYLLA,201190,IMG-00020-43.jpg,95,73,71,2,24,0.9726027397260274,0.7473684210526316
2022,KHOUALKA,CITRUS VOLKAMERIANA,201210,IMG-00011-43.jpg,103,101,99,2,4,0.9801980198019802,0.9611650485436892
2022,KHOUALKA,CITRUS VOLKAMERIANA,201210,IMG-00012-43.jpg,42,42,40,2,2,0.9523809523809524,0.9523809523809524
2022,KHOUALKA,CITRUS VOLKAMERIANA,201210,IMG-00015-43.jpg,77,75,72,3,5,0.96,0.935064935064935
2022,KHOUALKA,CITRUS VOLKAMERIANA,201210,IMG-00019-43.jpg,31,30,30,0,1,1.0,0.967741935483871
2022,KHOUALKA,BIGARADIER,201320,IMG-00006-43.jpg,87,74,72,2,15,0.972972972972973,0.8275862068965517
2022,KHOUALKA,BIGARADIER,201320,IMG-00016-43.jpg,97,94,91,3,6,0.9680851063829788,0.9381443298969072
2022,KHOUALKA,BIGARADIER,201320,IMG-00017-43.jpg,49,46,46,0,3,1.0,0.9387755102040816
2022,KHOUALKA,BIGARADIER,201320,IMG-00020-43.jpg,88,87,85,2,3,0.9770114942528736,0.9659090909090908
2022,ONAGRI,BIGARADIER,201390,IMG-00008-44.jpg,62,64,60,4,2,0.9375,0.967741935483871
2022,ONAGRI,BIGARADIER,201390,IMG-00011-44.jpg,90,84,83,1,7,0.988095238095238,0.9222222222222224
2022,ONAGRI,BIGARADIER,201390,IMG-00013-44.jpg,77,73,70,3,7,0.958904109589041,0.9090909090909092
2022,ONAGRI,BIGARADIER,201390,IMG-00016-44.jpg,69,66,62,4,7,0.9393939393939394,0.8985507246376812
2022,KHOUALKA,CITRUS VOLKAMERIANA,202050,IMG-00006-43.jpg,89,90,88,2,1,0.9777777777777776,0.9887640449438202
2022,KHOUALKA,CITRUS VOLKAMERIANA,202050,IMG-00010-43.jpg,94,90,90,0,4,1.0,0.9574468085106383
2022,KHOUALKA,CITRUS VOLKAMERIANA,202050,IMG-00011-43.jpg,151,151,145,6,6,0.9602649006622516,0.9602649006622516
2022,KHOUALKA,CITRUS VOLKAMERIANA,202050,IMG-00020-43.jpg,129,122,121,1,8,0.9918032786885246,0.937984496124031
2022,KHOUALKA,CITRUS VOLKAMERIANA,202070,IMG-00006-43.jpg,68,67,66,1,2,0.9850746268656716,0.9705882352941176
2022,KHOUALKA,CITRUS VOLKAMERIANA,202070,IMG-00009-43.jpg,120,118,116,2,4,0.9830508474576272,0.9666666666666668
2022,KHOUALKA,CITRUS VOLKAMERIANA,202070,IMG-00013-43.jpg,95,92,89,3,6,0.967391304347826,0.936842105263158
2022,KHOUALKA,CITRUS VOLKAMERIANA,202070,IMG-00019-43.jpg,57,57,56,1,1,0.9824561403508772,0.9824561403508772
2022,KHOUALKA,CITRUS VOLKAMERIANA,202080,IMG-00005-43.jpg,65,63,61,2,4,0.9682539682539684,0.9384615384615383
2022,KHOUALKA,CITRUS VOLKAMERIANA,202080,IMG-00008-43.jpg,31,32,31,1,0,0.96875,1.0
2022,KHOUALKA,CITRUS VOLKAMERIANA,202080,IMG-00015-43.jpg,220,219,213,6,7,0.9726027397260274,0.968181818181818
2022,KHOUALKA,CITRUS VOLKAMERIANA,202080,IMG-00016-43.jpg,131,133,128,5,3,0.962406015037594,0.9770992366412212
2022,KHOUALKA,CITRANGE CARRIZO,301380,IMG-00007-43.jpg,30,32,28,4,2,0.875,0.9333333333333332
2022,KHOUALKA,CITRANGE CARRIZO,301380,IMG-00011-43.jpg,53,56,53,3,0,0.9464285714285714,1.0
2022,KHOUALKA,CITRANGE CARRIZO,301380,IMG-00014-43.jpg,7,7,5,2,2,0.7142857142857143,0.7142857142857143
2022,KHOUALKA,CITRANGE CARRIZO,301380,IMG-00020-43.jpg,91,93,84,9,7,0.9032258064516128,0.9230769230769232
2022,ONAGRI,CITRUS VOLKAMERIANA,301470,IMG-00003-44.jpg,148,147,141,6,7,0.9591836734693876,0.9527027027027029
2022,ONAGRI,CITRUS VOLKAMERIANA,301470,IMG-00004-44.jpg,163,158,143,15,20,0.9050632911392406,0.8773006134969326
2022,ONAGRI,CITRUS VOLKAMERIANA,301470,IMG-00005-44.jpg,160,139,136,3,24,0.9784172661870504,0.85
2022,ONAGRI,CITRUS VOLKAMERIANA,301480,IMG-00001.jpg,92,71,71,0,21,1.0,0.7717391304347826
2022,ONAGRI,CITRUS VOLKAMERIANA,301480,IMG-00003-43.jpg,26,18,18,0,8,1.0,0.6923076923076923
2022,ONAGRI,CITRUS VOLKAMERIANA,301480,IMG-00012-43.jpg,50,41,39,2,11,0.951219512195122,0.78
2022,ONAGRI,CITRUS VOLKAMERIANA,301480,IMG-00014-43.jpg,77,65,65,0,12,1.0,0.8441558441558441
2022,ONAGRI,CITRUS VOLKAMERIANA,301490,IMG-00005-44.jpg,108,95,90,5,18,0.9473684210526316,0.8333333333333334
2022,ONAGRI,CITRUS VOLKAMERIANA,301490,IMG-00009-44.jpg,185,172,160,12,25,0.9302325581395348,0.8648648648648649
2022,ONAGRI,CITRUS VOLKAMERIANA,301490,IMG-00012-44.jpg,162,149,144,5,18,0.9664429530201344,0.8888888888888888
2022,ONAGRI,CITRUS VOLKAMERIANA,301490,IMG-00015-44.jpg,109,98,93,5,16,0.9489795918367347,0.8532110091743119
2022,ONAGRI,CITRUS VOLKAMERIANA,301510,IMG-00001.jpg,252,227,221,6,31,0.973568281938326,0.876984126984127
2022,ONAGRI,CITRUS VOLKAMERIANA,301510,IMG-00006-44.jpg,137,135,130,5,7,0.9629629629629628,0.948905109489051
2022,ONAGRI,CITRUS VOLKAMERIANA,301510,IMG-00007-44.jpg,115,120,104,16,11,0.8666666666666667,0.9043478260869564
2022,ONAGRI,CITRUS VOLKAMERIANA,301510,IMG-00008-44.jpg,150,133,125,8,25,0.9398496240601504,0.8333333333333334
2022,ONAGRI,BIGARADIER,301550,IMG-00008-44.jpg,144,137,134,3,10,0.978102189781022,0.9305555555555556
2022,ONAGRI,BIGARADIER,301550,IMG-00011-44.jpg,40,39,37,2,3,0.9487179487179488,0.925
2022,ONAGRI,BIGARADIER,301550,IMG-00013-44.jpg,76,66,65,1,11,0.9848484848484848,0.8552631578947368
2022,ONAGRI,BIGARADIER,301550,IMG-00014-44.jpg,80,84,77,7,3,0.9166666666666666,0.9625
2022,ONAGRI,CITRUS VOLKAMERIANA,301570,IMG-00004-44.jpg,158,154,145,9,13,0.9415584415584416,0.9177215189873418
2022,ONAGRI,CITRUS VOLKAMERIANA,301570,IMG-00007-44.jpg,152,141,135,6,17,0.9574468085106383,0.8881578947368421
2022,ONAGRI,CITRUS VOLKAMERIANA,301570,IMG-00008-44.jpg,103,96,87,9,16,0.90625,0.8446601941747572
2022,ONAGRI,CITRUS VOLKAMERIANA,301570,IMG-00017-44.jpg,218,201,193,8,25,0.9601990049751244,0.8853211009174312
2022,KHOUALKA,CITRUS VOLKAMERIANA,302340,IMG-00004-43.jpg,106,100,96,4,10,0.96,0.9056603773584906
2022,KHOUALKA,CITRUS VOLKAMERIANA,302340,IMG-00005-43.jpg,105,90,89,1,16,0.9888888888888888,0.8476190476190476
2022,KHOUALKA,CITRUS VOLKAMERIANA,302340,IMG-00011-43.jpg,75,73,72,1,3,0.9863013698630136,0.96
2022,KHOUALKA,CITRUS VOLKAMERIANA,302340,IMG-00015-43.jpg,92,84,83,1,9,0.988095238095238,0.9021739130434784
2022,KHOUALKA,CITRUS VOLKAMERIANA,302350,IMG-00008-43.jpg,33,30,30,0,3,1.0,0.9090909090909092
2022,KHOUALKA,CITRUS VOLKAMERIANA,302350,IMG-00013-43.jpg,80,77,73,4,7,0.948051948051948,0.9125
2022,KHOUALKA,CITRUS VOLKAMERIANA,302350,IMG-00014-43.jpg,76,76,69,7,7,0.9078947368421052,0.9078947368421052
2022,KHOUALKA,CITRUS VOLKAMERIANA,302350,IMG-00018-43.jpg,44,45,43,2,1,0.9555555555555556,0.9772727272727272
2022,KHOUALKA,CITRUS VOLKAMERIANA,302360,IMG-00005-43.jpg,97,94,93,1,4,0.9893617021276596,0.9587628865979382
2022,KHOUALKA,CITRUS VOLKAMERIANA,302360,IMG-00006-43.jpg,118,113,111,2,7,0.9823008849557522,0.940677966101695
2022,KHOUALKA,CITRUS VOLKAMERIANA,302360,IMG-00016-43.jpg,67,66,66,0,1,1.0,0.9850746268656716
2022,KHOUALKA,CITRUS VOLKAMERIANA,302360,IMG-00021-43.jpg,65,67,64,3,1,0.9552238805970148,0.9846153846153848
2022,KHOUALKA,CITRUS VOLKAMERIANA,302510,IMG-00001.jpg,73,64,63,1,10,0.984375,0.863013698630137
2022,KHOUALKA,CITRUS VOLKAMERIANA,302510,IMG-00002-43.jpg,44,38,37,1,7,0.9736842105263158,0.8409090909090909
2022,KHOUALKA,CITRUS VOLKAMERIANA,302510,IMG-00003-43.jpg,78,78,76,2,2,0.9743589743589745,0.9743589743589745
2022,KHOUALKA,CITRUS VOLKAMERIANA,302510,IMG-00015-43.jpg,49,37,36,1,13,0.972972972972973,0.7346938775510204
2022,KHOUALKA,BIGARADIER,401410,IMG-00093-43.jpg,35,23,22,1,13,0.9565217391304348,0.6285714285714286
2022,KHOUALKA,BIGARADIER,401410,IMG-00099-43.jpg,6,4,4,0,2,1.0,0.6666666666666666
2022,KHOUALKA,BIGARADIER,401410,IMG-00102-43.jpg,78,62,62,0,16,1.0,0.7948717948717948
2022,KHOUALKA,BIGARADIER,401410,IMG-00104-43.jpg,81,64,61,3,20,0.953125,0.7530864197530864
2022,ONAGRI,CITRANGE C35,401660,IMG-00001.jpg,56,57,54,3,2,0.9473684210526316,0.9642857142857144
2022,ONAGRI,CITRANGE C35,401660,IMG-00008-44.jpg,42,42,41,1,1,0.9761904761904762,0.9761904761904762
2022,ONAGRI,CITRANGE C35,401660,IMG-00010-44.jpg,29,29,28,1,1,0.9655172413793104,0.9655172413793104
2022,ONAGRI,CITRANGE C35,401660,IMG-00016-44.jpg,64,61,59,2,5,0.9672131147540984,0.921875
2022,ONAGRI,CITRANGE C35,401710,IMG-00003-44.jpg,51,41,41,0,10,1.0,0.803921568627451
2022,ONAGRI,CITRANGE C35,401710,IMG-00012-44.jpg,19,18,18,0,1,1.0,0.9473684210526316
2022,ONAGRI,CITRANGE C35,401710,IMG-00013-44.jpg,33,33,32,1,1,0.9696969696969696,0.9696969696969696
2022,ONAGRI,CITRANGE C35,401710,IMG-00019-44.jpg,76,76,74,2,2,0.9736842105263158,0.9736842105263158
2022,ONAGRI,CITRANGE C35,401720,IMG-00007-44.jpg,93,92,88,4,5,0.9565217391304348,0.946236559139785
2022,ONAGRI,CITRANGE C35,401720,IMG-00008-44.jpg,38,32,32,0,6,1.0,0.8421052631578947
2022,ONAGRI,CITRANGE C35,401720,IMG-00010-44.jpg,50,33,33,0,17,1.0,0.66
2022,ONAGRI,CITRANGE C35,401720,IMG-00017-44.jpg,68,54,54,0,14,1.0,0.7941176470588235
2022,ONAGRI,CITRANGE C35,401730,IMG-00001.jpg,19,18,18,0,1,1.0,0.9473684210526316
2022,ONAGRI,CITRANGE C35,401730,IMG-00010-44.jpg,50,47,47,0,3,1.0,0.94
2022,ONAGRI,CITRANGE C35,401730,IMG-00013-44.jpg,75,70,69,1,6,0.9857142857142858,0.92
2022,ONAGRI,CITRANGE C35,401730,IMG-00016-44.jpg,36,33,32,1,4,0.9696969696969696,0.8888888888888888
2022,ONAGRI,CITRANGE C35,401750,IMG-00005-44.jpg,88,73,68,5,20,0.9315068493150684,0.7727272727272727
2022,ONAGRI,CITRANGE C35,401750,IMG-00009-44.jpg,127,108,104,4,23,0.9629629629629628,0.8188976377952756
2022,ONAGRI,CITRANGE C35,401750,IMG-00016-44.jpg,107,89,86,3,21,0.9662921348314608,0.8037383177570093
2022,ONAGRI,CITRANGE C35,401750,IMG-00024-44.jpg,50,43,39,4,11,0.9069767441860463,0.78
2022,ONAGRI,CITRUMELO SACCATON,401770,IMG-00003-44.jpg,24,23,20,3,4,0.8695652173913043,0.8333333333333334
2022,ONAGRI,CITRUMELO SACCATON,401770,IMG-00008-44.jpg,72,72,67,5,5,0.9305555555555556,0.9305555555555556
2022,ONAGRI,CITRUMELO SACCATON,401770,IMG-00009-44.jpg,14,13,12,1,2,0.9230769230769232,0.8571428571428571
2022,ONAGRI,CITRUMELO SACCATON,401770,IMG-00017-44.jpg,20,16,15,1,5,0.9375,0.75
2022,KHOUALKA,BIGARADIER,402440,IMG-00005-43.jpg,17,10,9,1,8,0.9,0.5294117647058824
2022,KHOUALKA,BIGARADIER,402440,IMG-00012-43.jpg,46,40,39,1,7,0.975,0.8478260869565217
2022,KHOUALKA,BIGARADIER,402440,IMG-00014-43.jpg,11,8,8,0,3,1.0,0.7272727272727273
2022,KHOUALKA,BIGARADIER,402440,IMG-00015-43.jpg,22,11,11,0,11,1.0,0.5
2022,KHOUALKA,BIGARADIER,402590,IMG-00007-43.jpg,104,81,79,2,25,0.9753086419753086,0.7596153846153846
2022,KHOUALKA,BIGARADIER,402590,IMG-00012-43.jpg,45,40,40,0,5,1.0,0.8888888888888888
2022,KHOUALKA,BIGARADIER,402590,IMG-00015-43.jpg,58,54,50,4,8,0.925925925925926,0.8620689655172413
2022,KHOUALKA,BIGARADIER,402590,IMG-00019-43.jpg,64,61,61,0,3,1.0,0.953125
2022,KHOUALKA,CITRUS VOLKAMERIANA,501520,IMG-00004-43.jpg,39,38,37,1,2,0.9736842105263158,0.9487179487179488
2022,KHOUALKA,CITRUS VOLKAMERIANA,501520,IMG-00007-43.jpg,43,37,37,0,6,1.0,0.8604651162790697
2022,KHOUALKA,CITRUS VOLKAMERIANA,501520,IMG-00015-43.jpg,18,13,13,0,5,1.0,0.7222222222222222
2022,KHOUALKA,CITRUS VOLKAMERIANA,501520,IMG-00020-43.jpg,48,45,45,0,3,1.0,0.9375
2022,KHOUALKA,CITRUS VOLKAMERIANA,501540,IMG-00006-43.jpg,38,33,33,0,5,1.0,0.868421052631579
2022,KHOUALKA,CITRUS VOLKAMERIANA,501540,IMG-00012-43.jpg,102,99,98,1,4,0.98989898989899,0.9607843137254902
2022,KHOUALKA,CITRUS VOLKAMERIANA,501540,IMG-00017-43.jpg,138,130,129,1,9,0.9923076923076924,0.9347826086956522
2022,KHOUALKA,CITRUS VOLKAMERIANA,501540,IMG-00018-43.jpg,51,49,48,1,3,0.979591836734694,0.9411764705882352
2022,KHOUALKA,CITRUS VOLKAMERIANA,501660,IMG-00006-43.jpg,60,62,59,3,1,0.9516129032258064,0.9833333333333332
2022,KHOUALKA,CITRUS VOLKAMERIANA,501660,IMG-00016-43.jpg,63,60,58,2,5,0.9666666666666668,0.9206349206349206
2022,KHOUALKA,CITRUS VOLKAMERIANA,501660,IMG-00018-43.jpg,112,99,97,2,15,0.9797979797979798,0.8660714285714286
2022,KHOUALKA,CITRUS VOLKAMERIANA,501660,IMG-00021-43.jpg,90,93,89,4,1,0.956989247311828,0.9888888888888888
2022,KHOUALKA,CITRUS VOLKAMERIANA,501680,IMG-00005-43.jpg,179,157,157,0,22,1.0,0.8770949720670391
2022,KHOUALKA,CITRUS VOLKAMERIANA,501680,IMG-00011-43.jpg,101,79,77,2,24,0.9746835443037974,0.7623762376237624
2022,KHOUALKA,CITRUS VOLKAMERIANA,501680,IMG-00012-43.jpg,76,53,52,1,24,0.981132075471698,0.6842105263157895
2022,KHOUALKA,CITRUS VOLKAMERIANA,501680,IMG-00016-43.jpg,113,95,95,0,18,1.0,0.8407079646017699
2022,KHOUALKA,CITRUS VOLKAMERIANA,501690,IMG-00032-43.jpg,34,26,25,1,9,0.9615384615384616,0.7352941176470589
2022,KHOUALKA,CITRUS VOLKAMERIANA,501690,IMG-00039-43.jpg,186,156,153,3,33,0.9807692307692308,0.8225806451612904
2022,KHOUALKA,CITRUS VOLKAMERIANA,501690,IMG-00047-43.jpg,103,79,78,1,25,0.9873417721518988,0.7572815533980582
2022,KHOUALKA,CITRUS VOLKAMERIANA,501690,IMG-00049-43.jpg,166,142,140,2,26,0.9859154929577464,0.8433734939759037
2022,KHOUALKA,CITRUS VOLKAMERIANA,501760,IMG-00001.jpg,94,52,52,0,42,1.0,0.5531914893617021
2022,KHOUALKA,CITRUS VOLKAMERIANA,501760,IMG-00034-43.jpg,45,24,24,0,21,1.0,0.5333333333333333
2022,KHOUALKA,CITRUS VOLKAMERIANA,501760,IMG-00036-43.jpg,40,30,30,0,10,1.0,0.75
2022,KHOUALKA,CITRUS VOLKAMERIANA,501760,IMG-00051-43.jpg,92,61,61,0,31,1.0,0.6630434782608695
2022,ONAGRI,CITRUMELO SACCATON,510910,IMG-00004-44.jpg,73,63,62,1,11,0.984126984126984,0.8493150684931506
2022,ONAGRI,CITRUMELO SACCATON,510910,IMG-00008-44.jpg,152,108,108,0,44,1.0,0.7105263157894737
2022,ONAGRI,CITRUMELO SACCATON,510910,IMG-00010-44.jpg,107,86,84,2,23,0.9767441860465116,0.7850467289719626
2022,ONAGRI,CITRUMELO SACCATON,510910,IMG-00011-44.jpg,92,76,75,1,17,0.986842105263158,0.8152173913043478
2022,ONAGRI,CITRUMELO SACCATON,510950,IMG-00006-44.jpg,70,61,61,0,9,1.0,0.8714285714285714
2022,ONAGRI,CITRUMELO SACCATON,510950,IMG-00008-44.jpg,75,63,61,2,14,0.9682539682539684,0.8133333333333334
2022,ONAGRI,CITRUMELO SACCATON,510950,IMG-00009-44.jpg,85,64,63,1,22,0.984375,0.7411764705882353
2022,ONAGRI,CITRUMELO SACCATON,510950,IMG-00011-44.jpg,135,109,109,0,26,1.0,0.8074074074074075
2022,ONAGRI,MC PONSIRUCE TRIFOLIATA,510980,IMG-00014-44.jpg,67,55,54,1,13,0.9818181818181818,0.8059701492537313
2022,ONAGRI,MC PONSIRUCE TRIFOLIATA,510980,IMG-00015-44.jpg,51,45,43,2,8,0.9555555555555556,0.8431372549019608
2022,ONAGRI,MC PONSIRUCE TRIFOLIATA,510980,IMG-00016-44.jpg,99,81,79,2,20,0.9753086419753086,0.797979797979798
2022,ONAGRI,MC PONSIRUCE TRIFOLIATA,510980,IMG-00019-44.jpg,102,80,79,1,23,0.9875,0.7745098039215687
2022,ONAGRI,MC PONSIRUCE TRIFOLIATA,510990,IMG-00006-44.jpg,135,112,111,1,24,0.9910714285714286,0.8222222222222222
2022,ONAGRI,MC PONSIRUCE TRIFOLIATA,510990,IMG-00008-44.jpg,110,100,100,0,10,1.0,0.9090909090909092
2022,ONAGRI,MC PONSIRUCE TRIFOLIATA,510990,IMG-00009-44.jpg,85,74,74,0,11,1.0,0.8705882352941177
2022,ONAGRI,MC PONSIRUCE TRIFOLIATA,510990,IMG-00024-44.jpg,65,56,56,0,9,1.0,0.8615384615384616
2022,ONAGRI,MC PONSIRUCE TRIFOLIATA,511030,IMG-00007-44.jpg,100,82,81,1,19,0.9878048780487804,0.81
2022,ONAGRI,MC PONSIRUCE TRIFOLIATA,511030,IMG-00016-44.jpg,63,57,56,1,7,0.9824561403508772,0.8888888888888888
2022,ONAGRI,MC PONSIRUCE TRIFOLIATA,511030,IMG-00022-44.jpg,98,88,85,3,13,0.9659090909090908,0.8673469387755102
2022,ONAGRI,MC PONSIRUCE TRIFOLIATA,511030,IMG-00027-44.jpg,82,73,73,0,9,1.0,0.8902439024390244
2022,ONAGRI,MS PONSIRUCE TRIFOLIATA,511040,IMG-00004-44.jpg,77,67,66,1,11,0.9850746268656716,0.8571428571428571
2022,ONAGRI,MS PONSIRUCE TRIFOLIATA,511040,IMG-00014-44.jpg,48,41,38,3,10,0.926829268292683,0.7916666666666666
2022,ONAGRI,MS PONSIRUCE TRIFOLIATA,511040,IMG-00016-44.jpg,71,67,65,2,6,0.9701492537313432,0.9154929577464788
2022,ONAGRI,MS PONSIRUCE TRIFOLIATA,511040,IMG-00025-44.jpg,56,43,43,0,13,1.0,0.7678571428571429
2022,ONAGRI,FUZHU,511050,IMG-00004-44.jpg,109,96,92,4,17,0.9583333333333334,0.8440366972477065
2022,ONAGRI,FUZHU,511050,IMG-00006-44.jpg,142,116,112,4,30,0.9655172413793104,0.7887323943661971
2022,ONAGRI,FUZHU,511050,IMG-00011-44.jpg,172,156,150,6,22,0.9615384615384616,0.872093023255814
2022,ONAGRI,FUZHU,511050,IMG-00022-44.jpg,194,171,166,5,28,0.9707602339181286,0.8556701030927835
2022,ONAGRI,MS PONSIRUCE TRIFOLIATA,511060,IMG-00007-44.jpg,115,100,100,0,15,1.0,0.8695652173913043
2022,ONAGRI,MS PONSIRUCE TRIFOLIATA,511060,IMG-00016-44.jpg,102,80,78,2,24,0.975,0.7647058823529411
2022,ONAGRI,MS PONSIRUCE TRIFOLIATA,511060,IMG-00017-44.jpg,59,42,42,0,17,1.0,0.711864406779661
2022,ONAGRI,MS PONSIRUCE TRIFOLIATA,511060,IMG-00019-44.jpg,108,84,83,1,25,0.988095238095238,0.7685185185185185
2022,ONAGRI,FUZHU,511070,IMG-00006-44.jpg,82,74,72,2,10,0.972972972972973,0.8780487804878049
2022,ONAGRI,FUZHU,511070,IMG-00016-44.jpg,96,79,76,3,20,0.9620253164556962,0.7916666666666666
2022,ONAGRI,FUZHU,511070,IMG-00018-44.jpg,93,77,75,2,18,0.974025974025974,0.8064516129032258
2022,ONAGRI,FUZHU,511070,IMG-00019-44.jpg,142,119,116,3,26,0.9747899159663864,0.8169014084507042
