compagnie,Domaine,Porte-greffe,parcelle,Filename,True_count,detect_count,TP,FP,FN,Precision,Recall
2022,SAOUDA,BIGARADIER,10010,IMG-00011-45.jpg,28,30,27,3,1,0.9,0.9642857142857144
2022,SAOUDA,BIGARADIER,10010,IMG-00012-45.jpg,27,25,24,1,3,0.96,0.8888888888888888
2022,SAOUDA,BIGARADIER,10010,IMG-00014-45.jpg,50,50,47,3,3,0.94,0.94
2022,SAOUDA,BIGARADIER,10010,IMG-00018-45.jpg,30,29,27,2,3,0.9310344827586208,0.9
2022,SAOUDA,BIGARADIER,10010,IMG-00020-45.jpg,31,26,25,1,6,0.9615384615384616,0.8064516129032258
2024,SAOUDA,BIGARADIER,10010,IMG-23410.jpg,85,17,17,0,68,1.0,0.2
2024,SAOUDA,BIGARADIER,10010,IMG-23417.jpg,86,29,29,0,57,1.0,0.3372093023255814
2024,SAOUDA,BIGARADIER,10010,IMG-23430.jpg,74,27,27,0,47,1.0,0.3648648648648649
2024,SAOUDA,BIGARADIER,10010,IMG-23647.jpg,95,27,27,0,68,1.0,0.2842105263157895
2024,SAOUDA,BIGARADIER,10010,IMG-23672.jpg,47,9,9,0,38,1.0,0.1914893617021277
2024,SAOUDA,BIGARADIER,10010,IMG-23707.jpg,30,14,14,0,16,1.0,0.4666666666666667
2024,SAOUDA,BIGARADIER,10010,IMG-23709.jpg,31,7,7,0,24,1.0,0.2258064516129032
2024,SAOUDA,BIGARADIER,10010,IMG-23711.jpg,79,20,19,1,60,0.95,0.2405063291139241
2022,SAOUDA,MACROPHYLLA,10030,IMG-00158-45.jpg,101,102,88,14,13,0.8627450980392157,0.8712871287128713
2022,SAOUDA,MACROPHYLLA,10030,IMG-00159-45.jpg,155,151,135,16,20,0.8940397350993378,0.8709677419354839
2022,SAOUDA,MACROPHYLLA,10030,IMG-00162-45.jpg,119,119,110,9,9,0.9243697478991596,0.9243697478991596
2022,SAOUDA,MACROPHYLLA,10030,IMG-00169-45.jpg,72,69,64,5,8,0.927536231884058,0.8888888888888888
2022,SAOUDA,MACROPHYLLA,10031,IMG-00002-45.jpg,46,40,36,4,10,0.9,0.782608695652174
2022,SAOUDA,MACROPHYLLA,10031,IMG-00084-45.jpg,41,44,34,10,7,0.7727272727272727,0.8292682926829268
2022,SAOUDA,MACROPHYLLA,10031,IMG-00450-45.jpg,27,25,21,4,6,0.84,0.7777777777777778
2022,SAOUDA,MACROPHYLLA,10031,IMG-00451-45.jpg,34,28,25,3,9,0.8928571428571429,0.7352941176470589
2022,SAOUDA,MACROPHYLLA,10031,IMG-00464-45.jpg,33,31,28,3,5,0.9032258064516128,0.8484848484848485
2022,ONAGRI,CITRUS VOLKAMERIANA,10101,IMG-00003-39.jpg,120,120,115,5,5,0.9583333333333334,0.9583333333333334
2022,ONAGRI,CITRUS VOLKAMERIANA,10101,IMG-00010-39.jpg,85,85,80,5,5,0.9411764705882352,0.9411764705882352
2024,ONAGRI,CITRUS VOLKAMERIANA,10101,IMG-10523.jpg,288,232,226,6,62,0.9741379310344828,0.7847222222222222
2024,ONAGRI,CITRUS VOLKAMERIANA,10101,IMG-10545.jpg,98,74,72,2,26,0.972972972972973,0.7346938775510204
2024,ONAGRI,CITRUS VOLKAMERIANA,10101,IMG-10558.jpg,143,96,94,2,49,0.9791666666666666,0.6573426573426573
2022,ONAGRI,CITRUS VOLKAMERIANA,10102,IMG-00003-39.jpg,48,45,43,2,5,0.9555555555555556,0.8958333333333334
2024,ONAGRI,CITRUS VOLKAMERIANA,10102,IMG-10637.jpg,140,111,109,2,31,0.981981981981982,0.7785714285714286
2024,ONAGRI,CITRUS VOLKAMERIANA,10102,IMG-10658.jpg,163,124,121,3,42,0.9758064516129032,0.7423312883435583
2022,ONAGRI,CITRUS VOLKAMERIANA,10103,IMG-00003-39.jpg,215,215,208,7,7,0.9674418604651164,0.9674418604651164
2022,ONAGRI,CITRUS VOLKAMERIANA,10103,IMG-00008-39.jpg,195,190,174,16,21,0.9157894736842104,0.8923076923076924
2024,ONAGRI,CITRUS VOLKAMERIANA,10103,IMG-10614.jpg,134,108,105,3,29,0.9722222222222222,0.7835820895522388
2024,ONAGRI,CITRUS VOLKAMERIANA,10103,IMG-10630.jpg,213,175,172,3,41,0.9828571428571428,0.8075117370892019
2024,ONAGRI,CITRUS VOLKAMERIANA,10103,IMG-10631.jpg,134,97,93,4,41,0.9587628865979382,0.6940298507462687
2022,ONAGRI,CITRUS VOLKAMERIANA,10104,IMG-00004-39.jpg,65,62,59,3,6,0.9516129032258064,0.9076923076923076
2022,ONAGRI,CITRUS VOLKAMERIANA,10104,IMG-00008-39.jpg,69,72,65,7,4,0.9027777777777778,0.9420289855072465
2024,ONAGRI,CITRUS VOLKAMERIANA,10104,IMG-11267.jpg,22,13,12,1,10,0.9230769230769232,0.5454545454545454
2024,ONAGRI,CITRUS VOLKAMERIANA,10104,IMG-11327.jpg,128,91,89,2,39,0.978021978021978,0.6953125
2024,ONAGRI,CITRUS VOLKAMERIANA,10104,IMG-11347.jpg,118,86,83,3,35,0.9651162790697676,0.7033898305084746
2024,ONAGRI,CITRUS VOLKAMERIANA,10104,IMG-11366.jpg,351,257,249,8,102,0.9688715953307392,0.7094017094017094
2024,ONAGRI,CITRUS VOLKAMERIANA,10104,IMG-11386.jpg,99,75,73,2,26,0.9733333333333334,0.7373737373737373
2022,ONAGRI,CITRUS VOLKAMERIANA,10105,IMG-00004-39.jpg,17,20,16,4,1,0.8,0.9411764705882352
2022,ONAGRI,CITRUS VOLKAMERIANA,10105,IMG-00005-39.jpg,68,66,65,1,3,0.9848484848484848,0.9558823529411764
2022,ONAGRI,CITRUS VOLKAMERIANA,10108,IMG-00003-39.jpg,61,60,55,5,6,0.9166666666666666,0.9016393442622952
2022,ONAGRI,CITRUS VOLKAMERIANA,10108,IMG-00007-39.jpg,69,59,54,5,15,0.9152542372881356,0.782608695652174
2022,ONAGRI,CITRUS VOLKAMERIANA,10109,IMG-00003-39.jpg,4,4,4,0,0,1.0,1.0
2022,ONAGRI,CITRUS VOLKAMERIANA,10109,IMG-00008-39.jpg,105,105,93,12,12,0.8857142857142857,0.8857142857142857
2022,KHOUALKA,CITRANGE CARRIZO,10213,IMG-00001.jpg,77,77,73,4,4,0.948051948051948,0.948051948051948
2022,KHOUALKA,CITRANGE CARRIZO,10213,IMG-00005-40.jpg,73,74,70,4,3,0.945945945945946,0.958904109589041
2022,KHOUALKA,CITRANGE CARRIZO,10213,IMG-00009-40.jpg,14,15,13,2,1,0.8666666666666667,0.9285714285714286
2022,KHOUALKA,CITRANGE CARRIZO,10213,IMG-00014-40.jpg,21,20,17,3,4,0.85,0.8095238095238095
2022,KHOUALKA,CITRANGE CARRIZO,10213,IMG-00028-40.jpg,47,47,42,5,5,0.8936170212765957,0.8936170212765957
2022,KHOUALKA,CITRANGE CARRIZO,10213,IMG-00034-40.jpg,48,50,46,4,2,0.92,0.9583333333333334
2022,KHOUALKA,CITRANGE CARRIZO,10213,IMG-00035-40.jpg,37,40,36,4,1,0.9,0.972972972972973
2022,KHOUALKA,CITRANGE CARRIZO,10213,IMG-00036-40.jpg,47,52,46,6,1,0.8846153846153846,0.9787234042553192
2022,KHOUALKA,CITRANGE CARRIZO,10213,IMG-00042-40.jpg,22,24,22,2,0,0.9166666666666666,1.0
2022,KHOUALKA,CITRANGE CARRIZO,10213,IMG-00047-40.jpg,70,68,64,4,6,0.9411764705882352,0.9142857142857144
2022,KHOUALKA,CITRANGE CARRIZO,10213,IMG-00054-40.jpg,33,35,31,4,2,0.8857142857142857,0.9393939393939394
2022,KHOUALKA,CITRANGE CARRIZO,10213,IMG-00055-40.jpg,93,97,89,8,4,0.9175257731958762,0.956989247311828
2022,KHOUALKA,CITRANGE CARRIZO,10213,IMG-00061-40.jpg,113,118,110,8,3,0.9322033898305084,0.9734513274336284
2022,KHOUALKA,CITRANGE CARRIZO,10213,IMG-00066-40.jpg,48,51,41,10,7,0.803921568627451,0.8541666666666666
2022,OUARGHA,MACROPHYLLA,11010,IMG-00001.jpg,40,38,38,0,2,1.0,0.95
2022,OUARGHA,MACROPHYLLA,11010,IMG-00015-41.jpg,24,22,20,2,4,0.9090909090909092,0.8333333333333334
2022,OUARGHA,MACROPHYLLA,11010,IMG-00019-41.jpg,20,18,16,2,4,0.8888888888888888,0.8
2022,OUARGHA,MACROPHYLLA,11010,IMG-00024-41.jpg,21,22,20,2,1,0.9090909090909092,0.9523809523809524
2022,OUARGHA,MACROPHYLLA,11020,IMG-00017-41.jpg,51,52,48,4,3,0.9230769230769232,0.9411764705882352
2022,OUARGHA,MACROPHYLLA,11020,IMG-00018-41.jpg,13,13,12,1,1,0.9230769230769232,0.9230769230769232
2022,OUARGHA,CITRANGE CARRIZO,13010,IMG-00067-41.jpg,55,55,49,6,6,0.8909090909090909,0.8909090909090909
2022,OUARGHA,CITRANGE CARRIZO,13010,IMG-00086-41.jpg,49,50,47,3,2,0.94,0.9591836734693876
2022,OUARGHA,CITRANGE CARRIZO,13010,IMG-00194-41.jpg,33,32,32,0,1,1.0,0.9696969696969696
2022,OUARGHA,CITRANGE CARRIZO,13020,IMG-00023-41.jpg,31,28,26,2,5,0.9285714285714286,0.8387096774193549
2022,OUARGHA,CITRANGE CARRIZO,13020,IMG-00024-41.jpg,18,16,15,1,3,0.9375,0.8333333333333334
2022,OUARGHA,CITRANGE CARRIZO,13020,IMG-00039-41.jpg,4,1,1,0,3,1.0,0.25
2022,OUARGHA,CITRANGE CARRIZO,13020,IMG-00040-41.jpg,6,6,6,0,0,1.0,1.0
2022,OUARGHA,CITRUS VOLKAMERIANA,13030,IMG-00009-41.jpg,18,11,11,0,7,1.0,0.6111111111111112
2022,OUARGHA,CITRUS VOLKAMERIANA,13030,IMG-00013-41.jpg,46,43,42,1,4,0.9767441860465116,0.9130434782608696
2022,OUARGHA,CITRUS VOLKAMERIANA,13030,IMG-00027-41.jpg,12,12,10,2,2,0.8333333333333334,0.8333333333333334
2022,OUARGHA,CITRUS VOLKAMERIANA,13030,IMG-00029-41.jpg,18,17,14,3,4,0.8235294117647058,0.7777777777777778
2022,OUARGHA,CITRUS VOLKAMERIANA,13030,IMG-00036-41.jpg,16,17,14,3,2,0.8235294117647058,0.875
2022,OUARGHA,CITRUS VOLKAMERIANA,14010,IMG-00008-41.jpg,40,36,33,3,7,0.9166666666666666,0.825
2022,OUARGHA,CITRUS VOLKAMERIANA,14010,IMG-00010-41.jpg,49,47,44,3,5,0.9361702127659576,0.8979591836734694
2022,OUARGHA,CITRUS VOLKAMERIANA,14010,IMG-00011-41.jpg,47,44,41,3,6,0.9318181818181818,0.8723404255319149
2022,OUARGHA,CITRUS VOLKAMERIANA,14010,IMG-00018-41.jpg,44,45,41,4,3,0.9111111111111112,0.9318181818181818
2022,KHOUALKA,MACROPHYLLA,20118,IMG-00007-40.jpg,44,43,39,4,5,0.9069767441860463,0.8863636363636364
2022,KHOUALKA,MACROPHYLLA,20118,IMG-00008-40.jpg,115,117,108,9,7,0.9230769230769232,0.9391304347826088
2022,KHOUALKA,MACROPHYLLA,20118,IMG-00022-40.jpg,113,107,103,4,10,0.9626168224299064,0.911504424778761
2022,KHOUALKA,MACROPHYLLA,20118,IMG-00033-40.jpg,58,68,56,12,2,0.8235294117647058,0.9655172413793104
2022,KHOUALKA,MACROPHYLLA,20118,IMG-00037-40.jpg,29,29,27,2,2,0.9310344827586208,0.9310344827586208
2022,KHOUALKA,MACROPHYLLA,20118,IMG-00042-40.jpg,137,139,129,10,8,0.9280575539568344,0.9416058394160584
2022,KHOUALKA,MACROPHYLLA,20118,IMG-00046-40.jpg,45,48,43,5,2,0.8958333333333334,0.9555555555555556
2022,KHOUALKA,MACROPHYLLA,20118,IMG-00050-40.jpg,48,44,40,4,8,0.9090909090909092,0.8333333333333334
2022,KHOUALKA,MACROPHYLLA,20118,IMG-00055-40.jpg,52,52,48,4,4,0.9230769230769232,0.9230769230769232
2022,KHOUALKA,MACROPHYLLA,20118,IMG-00061-40.jpg,120,123,108,15,12,0.8780487804878049,0.9
2022,KHOUALKA,MACROPHYLLA,20118,IMG-00062-40.jpg,63,60,53,7,10,0.8833333333333333,0.8412698412698413
2022,KHOUALKA,MACROPHYLLA,20118,IMG-00063-40.jpg,47,45,41,4,6,0.9111111111111112,0.8723404255319149
2022,KHOUALKA,MACROPHYLLA,20118,IMG-00066-40.jpg,84,87,78,9,6,0.896551724137931,0.9285714285714286
2024,KHOUALKA,MACROPHYLLA,20118,IMG-12691.jpg,22,15,15,0,7,1.0,0.6818181818181818
2024,KHOUALKA,MACROPHYLLA,20118,IMG-12729.jpg,56,42,42,0,14,1.0,0.75
2024,KHOUALKA,MACROPHYLLA,20118,IMG-12735.jpg,88,64,61,3,27,0.953125,0.6931818181818182
2024,KHOUALKA,MACROPHYLLA,20118,IMG-12748.jpg,107,77,74,3,33,0.961038961038961,0.6915887850467289
2024,KHOUALKA,MACROPHYLLA,20118,IMG-12764.jpg,111,95,89,6,22,0.936842105263158,0.8018018018018018
2024,KHOUALKA,MACROPHYLLA,20118,IMG-12808.jpg,113,78,74,4,39,0.9487179487179488,0.6548672566371682
2024,KHOUALKA,MACROPHYLLA,20118,IMG-12851.jpg,24,13,11,2,13,0.8461538461538461,0.4583333333333333
2022,KHOUALKA,MACROPHYLLA,20119,IMG-00005-40.jpg,106,105,103,2,3,0.9809523809523808,0.9716981132075472
2022,KHOUALKA,MACROPHYLLA,20119,IMG-00008-40.jpg,142,136,135,1,7,0.9926470588235294,0.9507042253521126
2022,KHOUALKA,MACROPHYLLA,20119,IMG-00014-40.jpg,132,129,128,1,4,0.992248062015504,0.9696969696969696
2022,KHOUALKA,BIGARADIER,20132,IMG-00004-40.jpg,181,174,166,8,15,0.9540229885057472,0.9171270718232044
2022,KHOUALKA,BIGARADIER,20132,IMG-00025-40.jpg,91,84,78,6,13,0.9285714285714286,0.8571428571428571
2022,KHOUALKA,BIGARADIER,20132,IMG-00028-40.jpg,49,46,44,2,5,0.9565217391304348,0.8979591836734694
2022,KHOUALKA,BIGARADIER,20132,IMG-00035-40.jpg,103,110,101,9,2,0.9181818181818182,0.9805825242718448
2022,KHOUALKA,BIGARADIER,20132,IMG-00039-40.jpg,119,123,112,11,7,0.9105691056910568,0.9411764705882352
2022,KHOUALKA,BIGARADIER,20132,IMG-00046-40.jpg,156,159,148,11,8,0.9308176100628932,0.9487179487179488
2022,KHOUALKA,BIGARADIER,20132,IMG-00051-40.jpg,108,103,98,5,10,0.9514563106796116,0.9074074074074074
2022,KHOUALKA,BIGARADIER,20132,IMG-00055-40.jpg,67,62,60,2,7,0.967741935483871,0.8955223880597015
2022,KHOUALKA,BIGARADIER,20132,IMG-00058-40.jpg,89,87,84,3,5,0.9655172413793104,0.9438202247191012
2022,KHOUALKA,BIGARADIER,20132,IMG-00059-40.jpg,139,133,126,7,13,0.9473684210526316,0.9064748201438848
2022,KHOUALKA,BIGARADIER,20132,IMG-00060-40.jpg,57,53,50,3,7,0.9433962264150944,0.8771929824561403
2022,KHOUALKA,BIGARADIER,20132,IMG-00064-40.jpg,117,110,105,5,12,0.9545454545454546,0.8974358974358975
2022,KHOUALKA,BIGARADIER,20132,IMG-00075-40.jpg,69,69,64,5,5,0.927536231884058,0.927536231884058
2022,ONAGRI,BIGARADIER,20139,IMG-00021-39.jpg,93,88,88,0,5,1.0,0.946236559139785
2024,KHOUALKA,CITRUS VOLKAMERIANA,20205,IMG-12040.jpg,123,89,85,4,38,0.9550561797752808,0.6910569105691057
2024,KHOUALKA,CITRUS VOLKAMERIANA,20205,IMG-12058.jpg,116,117,109,8,7,0.9316239316239316,0.9396551724137931
2022,SAOUDA,CITRUS VOLKAMERIANA,21020,IMG-00033-45.jpg,67,67,62,5,5,0.9253731343283582,0.9253731343283582
2022,SAOUDA,CITRUS VOLKAMERIANA,21020,IMG-00087-45.jpg,21,21,17,4,4,0.8095238095238095,0.8095238095238095
2022,SAOUDA,CITRUS VOLKAMERIANA,21020,IMG-00138-45.jpg,40,39,38,1,2,0.9743589743589745,0.95
2022,SAOUDA,CITRUS VOLKAMERIANA,21020,IMG-00145-45.jpg,37,36,33,3,4,0.9166666666666666,0.8918918918918919
2022,SAOUDA,CITRUS VOLKAMERIANA,21020,IMG-00155-45.jpg,38,42,34,8,4,0.8095238095238095,0.8947368421052632
2022,SAOUDA,CITRUS VOLKAMERIANA,21030,IMG-00521-45.jpg,31,30,27,3,4,0.9,0.8709677419354839
2022,SAOUDA,CITRUS VOLKAMERIANA,21030,IMG-00524-45.jpg,71,64,61,3,10,0.953125,0.8591549295774648
2022,SAOUDA,CITRUS VOLKAMERIANA,21030,IMG-00536-45.jpg,41,46,38,8,3,0.8260869565217391,0.926829268292683
2022,SAOUDA,CITRUS VOLKAMERIANA,21030,IMG-00537-45.jpg,52,45,39,6,13,0.8666666666666667,0.75
2022,SAOUDA,CITRUS VOLKAMERIANA,22020,IMG-00053-45.jpg,39,32,31,1,8,0.96875,0.7948717948717948
2022,SAOUDA,CITRUS VOLKAMERIANA,22020,IMG-00059-45.jpg,46,36,33,3,13,0.9166666666666666,0.717391304347826
2022,SAOUDA,CITRUS VOLKAMERIANA,22020,IMG-00060-45.jpg,48,46,41,5,7,0.8913043478260869,0.8541666666666666
2022,SAOUDA,CITRUS VOLKAMERIANA,22020,IMG-00062-45.jpg,50,49,45,4,5,0.9183673469387756,0.9
2022,SAOUDA,CITRUS VOLKAMERIANA,22030,IMG-00062-45.jpg,62,57,55,2,7,0.9649122807017544,0.8870967741935484
2022,SAOUDA,CITRUS VOLKAMERIANA,22030,IMG-00063-45.jpg,83,74,70,4,13,0.945945945945946,0.8433734939759037
2022,SAOUDA,CITRUS VOLKAMERIANA,22030,IMG-00065-45.jpg,58,53,47,6,11,0.8867924528301887,0.8103448275862069
2022,SAOUDA,CITRUS VOLKAMERIANA,22030,IMG-00068-45.jpg,66,54,53,1,13,0.9814814814814816,0.803030303030303
2022,SAOUDA,CITRUS VOLKAMERIANA,23020,IMG-00024-45.jpg,47,49,41,8,6,0.8367346938775511,0.8723404255319149
2022,SAOUDA,CITRUS VOLKAMERIANA,23020,IMG-00032-45.jpg,33,30,30,0,3,1.0,0.9090909090909092
2022,SAOUDA,CITRUS VOLKAMERIANA,23020,IMG-00074-45.jpg,28,26,22,4,6,0.8461538461538461,0.7857142857142857
2022,SAOUDA,CITRUS VOLKAMERIANA,23020,IMG-00079-45.jpg,28,28,26,2,2,0.9285714285714286,0.9285714285714286
2022,SAOUDA,CITRUS VOLKAMERIANA,23030,IMG-00014-45.jpg,25,24,21,3,4,0.875,0.84
2022,SAOUDA,CITRUS VOLKAMERIANA,23030,IMG-00034-45.jpg,43,40,38,2,5,0.95,0.8837209302325582
2022,SAOUDA,CITRUS VOLKAMERIANA,23030,IMG-00069-45.jpg,28,26,22,4,6,0.8461538461538461,0.7857142857142857
2022,SAOUDA,CITRUS VOLKAMERIANA,23030,IMG-00079-45.jpg,50,55,46,9,4,0.8363636363636363,0.92
2022,SAOUDA,CITRANGE CARRIZO,24010,IMG-00097-45.jpg,59,58,55,3,4,0.9482758620689656,0.9322033898305084
2022,SAOUDA,CITRANGE CARRIZO,24010,IMG-00101-45.jpg,27,27,25,2,2,0.925925925925926,0.925925925925926
2022,SAOUDA,CITRANGE CARRIZO,24010,IMG-00111-45.jpg,54,54,52,2,2,0.9629629629629628,0.9629629629629628
2022,SAOUDA,CITRANGE CARRIZO,24010,IMG-00112-45.jpg,40,39,38,1,2,0.9743589743589745,0.95
2022,SAOUDA,CITRANGE CARRIZO,25010,IMG-00006-45.jpg,55,53,48,5,7,0.9056603773584906,0.8727272727272727
2022,SAOUDA,CITRANGE CARRIZO,25010,IMG-00007-45.jpg,77,79,74,5,3,0.9367088607594936,0.961038961038961
2022,SAOUDA,CITRANGE CARRIZO,25010,IMG-00010-45.jpg,53,49,41,8,12,0.8367346938775511,0.7735849056603774
2022,SAOUDA,CITRANGE CARRIZO,25010,IMG-00011-45.jpg,26,28,26,2,0,0.9285714285714286,1.0
2022,SAOUDA,CITRANGE CARRIZO,26010,IMG-00008-45.jpg,39,41,39,2,0,0.951219512195122,1.0
2022,SAOUDA,CITRANGE CARRIZO,26010,IMG-00013-45.jpg,36,33,31,2,5,0.9393939393939394,0.8611111111111112
2022,SAOUDA,CITRANGE CARRIZO,26010,IMG-00018-45.jpg,43,47,42,5,1,0.8936170212765957,0.9767441860465116
2022,SAOUDA,CITRANGE CARRIZO,26010,IMG-00020-45.jpg,44,46,42,4,2,0.9130434782608696,0.9545454545454546
2022,KHOUALKA,CITRANGE CARRIZO,30138,IMG-00002-40.jpg,39,38,37,1,2,0.9736842105263158,0.9487179487179488
2022,KHOUALKA,CITRANGE CARRIZO,30138,IMG-00003-40.jpg,59,58,56,2,3,0.9655172413793104,0.9491525423728814
2022,KHOUALKA,CITRANGE CARRIZO,30138,IMG-00005-40.jpg,58,53,47,6,11,0.8867924528301887,0.8103448275862069
2022,KHOUALKA,CITRANGE CARRIZO,30138,IMG-00008-40.jpg,32,29,27,2,5,0.9310344827586208,0.84375
2022,KHOUALKA,CITRANGE CARRIZO,30138,IMG-00011-40.jpg,26,30,26,4,0,0.8666666666666667,1.0
2022,KHOUALKA,CITRANGE CARRIZO,30138,IMG-00019-40.jpg,2,3,2,1,0,0.6666666666666666,1.0
2022,KHOUALKA,CITRANGE CARRIZO,30138,IMG-00037-40.jpg,30,32,27,5,3,0.84375,0.9
2022,KHOUALKA,CITRANGE CARRIZO,30138,IMG-00040-40.jpg,41,43,39,4,2,0.9069767441860463,0.951219512195122
2022,KHOUALKA,CITRANGE CARRIZO,30138,IMG-00043-40.jpg,28,27,22,5,6,0.8148148148148148,0.7857142857142857
2022,KHOUALKA,CITRANGE CARRIZO,30138,IMG-00044-40.jpg,99,94,90,4,9,0.9574468085106383,0.9090909090909092
2022,KHOUALKA,CITRANGE CARRIZO,30138,IMG-00048-40.jpg,37,40,33,7,4,0.825,0.8918918918918919
2022,KHOUALKA,CITRANGE CARRIZO,30138,IMG-00057-40.jpg,73,72,66,6,7,0.9166666666666666,0.9041095890410958
2022,KHOUALKA,CITRANGE CARRIZO,30138,IMG-00063-40.jpg,89,77,74,3,15,0.961038961038961,0.8314606741573034
2022,ONAGRI,CITRUS VOLKAMERIANA,30145,IMG-00018-39.jpg,219,231,214,17,5,0.9264069264069263,0.9771689497716894
2022,ONAGRI,CITRUS VOLKAMERIANA,30145,IMG-00043-39.jpg,64,66,61,5,3,0.9242424242424242,0.953125
2022,ONAGRI,CITRUS VOLKAMERIANA,30146,IMG-00008-39.jpg,262,260,252,8,10,0.9692307692307692,0.9618320610687024
2022,ONAGRI,CITRUS VOLKAMERIANA,30146,IMG-00045-39.jpg,190,205,169,36,21,0.824390243902439,0.8894736842105263
2022,ONAGRI,CITRUS VOLKAMERIANA,30147,IMG-00002-39.jpg,269,277,262,15,7,0.9458483754512635,0.9739776951672864
2022,ONAGRI,CITRUS VOLKAMERIANA,30147,IMG-00008-39.jpg,172,172,155,17,17,0.9011627906976744,0.9011627906976744
2022,ONAGRI,CITRUS VOLKAMERIANA,30148,IMG-00016-40.jpg,88,86,84,2,4,0.9767441860465116,0.9545454545454546
2022,ONAGRI,CITRUS VOLKAMERIANA,30148,IMG-00047-40.jpg,34,31,30,1,4,0.967741935483871,0.8823529411764706
2022,ONAGRI,CITRUS VOLKAMERIANA,30149,IMG-00018-39.jpg,151,145,143,2,8,0.986206896551724,0.9470198675496688
2022,ONAGRI,CITRUS VOLKAMERIANA,30149,IMG-00027-39.jpg,226,200,188,12,38,0.94,0.831858407079646
2022,ONAGRI,CITRUS VOLKAMERIANA,30151,IMG-00012-39.jpg,185,176,172,4,13,0.9772727272727272,0.9297297297297298
2022,ONAGRI,CITRUS VOLKAMERIANA,30151,IMG-00033-39.jpg,214,210,192,18,22,0.9142857142857144,0.897196261682243
2024,ONAGRI,CITRUS VOLKAMERIANA,30151,IMG-21881.jpg,73,50,48,2,25,0.96,0.6575342465753424
2024,ONAGRI,CITRUS VOLKAMERIANA,30151,IMG-21935.jpg,179,84,82,2,97,0.9761904761904762,0.4581005586592179
2024,ONAGRI,CITRUS VOLKAMERIANA,30151,IMG-21936.jpg,93,50,50,0,43,1.0,0.5376344086021505
2022,ONAGRI,CITRUS VOLKAMERIANA,30152,IMG-00016-39.jpg,39,37,34,3,5,0.918918918918919,0.8717948717948718
2022,ONAGRI,CITRUS VOLKAMERIANA,30152,IMG-00019-39.jpg,139,143,136,7,3,0.951048951048951,0.9784172661870504
2022,ONAGRI,CITRUS VOLKAMERIANA,30153,IMG-00001.jpg,157,148,145,3,12,0.9797297297297296,0.9235668789808916
2022,ONAGRI,CITRUS VOLKAMERIANA,30153,IMG-00007-39.jpg,127,124,122,2,5,0.9838709677419356,0.9606299212598424
2022,ONAGRI,CITRUS VOLKAMERIANA,30153,IMG-00013-39.jpg,159,134,131,3,28,0.9776119402985076,0.8238993710691824
2022,ONAGRI,CITRUS VOLKAMERIANA,30153,IMG-00040-39.jpg,153,149,146,3,7,0.9798657718120806,0.954248366013072
2022,ONAGRI,CITRUS VOLKAMERIANA,30154,IMG-00017-39.jpg,160,163,157,6,3,0.9631901840490796,0.98125
2022,ONAGRI,CITRUS VOLKAMERIANA,30154,IMG-00027-39.jpg,220,217,212,5,8,0.976958525345622,0.9636363636363636
2022,ONAGRI,CITRUS VOLKAMERIANA,30154,IMG-00033-39.jpg,51,49,49,0,2,1.0,0.9607843137254902
2022,ONAGRI,CITRUS VOLKAMERIANA,30154,IMG-00036-39.jpg,137,135,131,4,6,0.9703703703703704,0.9562043795620438
2022,ONAGRI,CITRUS VOLKAMERIANA,30154,IMG-00038-39.jpg,242,243,236,7,6,0.97119341563786,0.975206611570248
2022,ONAGRI,CITRUS VOLKAMERIANA,30154,IMG-00041-39.jpg,272,271,262,9,10,0.966789667896679,0.9632352941176472
2022,ONAGRI,CITRUS VOLKAMERIANA,30154,IMG-00044-39.jpg,141,147,130,17,11,0.8843537414965986,0.9219858156028368
2022,ONAGRI,BIGARADIER,30155,IMG-00002-39.jpg,139,140,134,6,5,0.9571428571428572,0.9640287769784172
2022,ONAGRI,BIGARADIER,30155,IMG-00003-39.jpg,115,113,112,1,3,0.991150442477876,0.9739130434782608
2022,ONAGRI,BIGARADIER,30155,IMG-00006-39.jpg,44,44,43,1,1,0.9772727272727272,0.9772727272727272
2022,ONAGRI,BIGARADIER,30155,IMG-00011-39.jpg,100,101,97,4,3,0.9603960396039604,0.97
2022,ONAGRI,BIGARADIER,30155,IMG-00019-39.jpg,142,135,130,5,12,0.9629629629629628,0.9154929577464788
2022,ONAGRI,BIGARADIER,30155,IMG-00026-39.jpg,124,124,118,6,6,0.9516129032258064,0.9516129032258064
2022,ONAGRI,BIGARADIER,30155,IMG-00032-39.jpg,81,81,80,1,1,0.9876543209876544,0.9876543209876544
2022,ONAGRI,BIGARADIER,30155,IMG-00039-39.jpg,19,17,17,0,2,1.0,0.8947368421052632
2022,ONAGRI,BIGARADIER,30155,IMG-00043-39.jpg,130,131,127,4,3,0.9694656488549618,0.9769230769230768
2022,ONAGRI,CITRUS VOLKAMERIANA,30157,IMG-00003-39.jpg,227,208,203,5,24,0.9759615384615384,0.8942731277533039
2022,ONAGRI,CITRUS VOLKAMERIANA,30157,IMG-00012-39.jpg,283,278,270,8,13,0.9712230215827338,0.9540636042402828
2022,ONAGRI,CITRUS VOLKAMERIANA,30157,IMG-00032-39.jpg,64,66,58,8,6,0.8787878787878788,0.90625
2022,ONAGRI,CITRUS VOLKAMERIANA,30157,IMG-00035-39.jpg,159,154,152,2,7,0.987012987012987,0.9559748427672956
2022,KHOUALKA,CITRUS VOLKAMERIANA,30235,IMG-00001.jpg,93,92,88,4,5,0.9565217391304348,0.946236559139785
2022,KHOUALKA,CITRUS VOLKAMERIANA,30235,IMG-00003-40.jpg,37,37,33,4,4,0.8918918918918919,0.8918918918918919
2022,KHOUALKA,CITRUS VOLKAMERIANA,30235,IMG-00009-40.jpg,103,106,99,7,4,0.9339622641509434,0.9611650485436892
2022,KHOUALKA,CITRUS VOLKAMERIANA,30235,IMG-00013-40.jpg,90,90,84,6,6,0.9333333333333332,0.9333333333333332
2022,KHOUALKA,CITRUS VOLKAMERIANA,30235,IMG-00026-40.jpg,122,122,116,6,6,0.9508196721311476,0.9508196721311476
2022,KHOUALKA,CITRUS VOLKAMERIANA,30235,IMG-00047-40.jpg,47,47,43,4,4,0.9148936170212766,0.9148936170212766
2022,KHOUALKA,CITRUS VOLKAMERIANA,30235,IMG-00048-40.jpg,90,92,84,8,6,0.9130434782608696,0.9333333333333332
2022,KHOUALKA,CITRUS VOLKAMERIANA,30235,IMG-00049-40.jpg,44,43,39,4,5,0.9069767441860463,0.8863636363636364
2022,KHOUALKA,CITRUS VOLKAMERIANA,30235,IMG-00050-40.jpg,84,80,74,6,10,0.925,0.8809523809523809
2022,KHOUALKA,CITRUS VOLKAMERIANA,30235,IMG-00052-40.jpg,98,102,95,7,3,0.931372549019608,0.9693877551020408
2022,KHOUALKA,CITRUS VOLKAMERIANA,30235,IMG-00057-40.jpg,80,79,73,6,7,0.9240506329113924,0.9125
2022,KHOUALKA,CITRUS VOLKAMERIANA,30235,IMG-00064-40.jpg,38,35,30,5,8,0.8571428571428571,0.7894736842105263
2022,KHOUALKA,CITRUS VOLKAMERIANA,30235,IMG-00067-40.jpg,107,93,90,3,17,0.967741935483871,0.8411214953271028
2022,KHOUALKA,CITRUS VOLKAMERIANA,30235,IMG-00069-40.jpg,34,31,28,3,6,0.9032258064516128,0.8235294117647058
2022,KHOUALKA,CITRUS VOLKAMERIANA,30235,IMG-00075-40.jpg,95,94,86,8,9,0.9148936170212766,0.9052631578947368
2022,KHOUALKA,BIGARADIER,40141,IMG-00006-40.jpg,7,6,6,0,1,1.0,0.8571428571428571
2022,KHOUALKA,BIGARADIER,40141,IMG-00007-40.jpg,20,15,15,0,5,1.0,0.75
2022,KHOUALKA,BIGARADIER,40141,IMG-00008-40.jpg,15,14,14,0,1,1.0,0.9333333333333332
2022,ONAGRI,CITRANGE C35,40166,IMG-00009-39.jpg,38,37,36,1,2,0.972972972972973,0.9473684210526316
2022,ONAGRI,CITRANGE C35,40166,IMG-00011-39.jpg,173,170,156,14,17,0.9176470588235294,0.9017341040462428
2022,ONAGRI,CITRANGE C35,40166,IMG-00014-39.jpg,179,173,166,7,13,0.9595375722543352,0.9273743016759776
2022,ONAGRI,CITRANGE C35,40166,IMG-00015-39.jpg,122,120,117,3,5,0.975,0.9590163934426228
2022,ONAGRI,CITRANGE C35,40166,IMG-00041-39.jpg,102,100,98,2,4,0.98,0.9607843137254902
2022,ONAGRI,CITRANGE C35,40167,IMG-00019-39.jpg,197,186,181,5,16,0.9731182795698924,0.9187817258883249
2022,ONAGRI,CITRANGE C35,40167,IMG-00030-39.jpg,126,120,118,2,8,0.9833333333333332,0.9365079365079364
2022,ONAGRI,CITRANGE C35,40167,IMG-00039-39.jpg,217,189,176,13,41,0.9312169312169312,0.8110599078341014
2022,ONAGRI,CITRANGE C35,40171,IMG-00008-39.jpg,109,96,95,1,14,0.9895833333333334,0.8715596330275229
2022,ONAGRI,CITRANGE C35,40171,IMG-00037-39.jpg,94,88,80,8,14,0.9090909090909092,0.851063829787234
2022,ONAGRI,CITRANGE C35,40171,IMG-00040-39.jpg,149,132,123,9,26,0.9318181818181818,0.825503355704698
2022,ONAGRI,CITRANGE C35,40172,IMG-00012-39.jpg,89,86,85,1,4,0.9883720930232558,0.9550561797752808
2022,ONAGRI,CITRANGE C35,40172,IMG-00025-39.jpg,109,101,101,0,8,1.0,0.926605504587156
2022,ONAGRI,CITRANGE C35,40172,IMG-00027-39.jpg,103,97,96,1,7,0.9896907216494846,0.9320388349514565
2022,ONAGRI,CITRANGE C35,40173,IMG-00004-39.jpg,133,110,108,2,25,0.9818181818181818,0.8120300751879699
2022,ONAGRI,CITRANGE C35,40173,IMG-00008-39.jpg,57,50,49,1,8,0.98,0.8596491228070176
2022,ONAGRI,CITRANGE C35,40173,IMG-00010-39.jpg,53,53,51,2,2,0.9622641509433962,0.9622641509433962
2022,ONAGRI,CITRANGE C35,40175,IMG-00005-39.jpg,95,88,85,3,10,0.9659090909090908,0.8947368421052632
2022,ONAGRI,CITRANGE C35,40175,IMG-00006-39.jpg,64,59,59,0,5,1.0,0.921875
2022,ONAGRI,CITRANGE C35,40176,IMG-00004-39.jpg,79,92,75,17,4,0.8152173913043478,0.9493670886075948
2022,ONAGRI,CITRANGE C35,40176,IMG-00012-39.jpg,105,107,101,6,4,0.9439252336448598,0.961904761904762
2022,ONAGRI,CITRANGE C35,40176,IMG-00014-39.jpg,91,90,81,9,10,0.9,0.8901098901098901
2022,ONAGRI,CITRUMELO SACCATON,40177,IMG-00012-39.jpg,89,89,80,9,9,0.898876404494382,0.898876404494382
2022,ONAGRI,CITRUMELO SACCATON,40177,IMG-00015-39.jpg,213,221,211,10,2,0.9547511312217196,0.9906103286384976
2022,ONAGRI,CITRUMELO SACCATON,40177,IMG-00037-39.jpg,95,100,92,8,3,0.92,0.968421052631579
2022,ONAGRI,CITRANGE C35,40178,IMG-00013-39.jpg,76,71,69,2,7,0.971830985915493,0.9078947368421052
2022,ONAGRI,CITRANGE C35,40178,IMG-00027-39.jpg,56,55,53,2,3,0.9636363636363636,0.9464285714285714
2022,ONAGRI,CITRANGE C35,40178,IMG-00031-39.jpg,30,32,29,3,1,0.90625,0.9666666666666668
2022,ONAGRI,CITRANGE C35,40178,IMG-00032-39.jpg,27,28,26,2,1,0.9285714285714286,0.9629629629629628
2022,ONAGRI,CITRANGE C35,40178,IMG-00033-39.jpg,34,38,34,4,0,0.8947368421052632,1.0
2022,ONAGRI,CITRANGE C35,40179,IMG-00001.jpg,83,88,82,6,1,0.9318181818181818,0.9879518072289156
2022,ONAGRI,CITRANGE C35,40179,IMG-00010-39.jpg,161,174,157,17,4,0.9022988505747126,0.9751552795031057
2022,ONAGRI,CITRANGE C35,40179,IMG-00011-39.jpg,102,108,100,8,2,0.925925925925926,0.9803921568627452
2022,ONAGRI,CITRANGE C35,40179,IMG-00018-39.jpg,9,9,8,1,1,0.8888888888888888,0.8888888888888888
2022,ONAGRI,CITRUMELO SACCATON,40182,IMG-00004-39.jpg,35,37,34,3,1,0.918918918918919,0.9714285714285714
2022,ONAGRI,CITRUMELO SACCATON,40182,IMG-00010-39.jpg,52,52,50,2,2,0.9615384615384616,0.9615384615384616
2022,ONAGRI,CITRUMELO SACCATON,40182,IMG-00015-39.jpg,85,80,75,5,10,0.9375,0.8823529411764706
2022,ONAGRI,CITRUMELO SACCATON,40183,IMG-00005-39.jpg,68,61,60,1,8,0.9836065573770492,0.8823529411764706
2022,ONAGRI,CITRUMELO SACCATON,40183,IMG-00009-39.jpg,57,60,55,5,2,0.9166666666666666,0.9649122807017544
2022,ONAGRI,CITRUMELO SACCATON,40183,IMG-00010-39.jpg,48,48,43,5,5,0.8958333333333334,0.8958333333333334
2024,KHOUALKA,CITRUS VOLKAMERIANA,50152,IMG-17274.jpg,170,130,125,5,45,0.9615384615384616,0.7352941176470589
2024,KHOUALKA,CITRUS VOLKAMERIANA,50152,IMG-17306.jpg,105,84,82,2,23,0.9761904761904762,0.780952380952381
2024,KHOUALKA,CITRUS VOLKAMERIANA,50152,IMG-17330.jpg,41,32,31,1,10,0.96875,0.7560975609756098
2024,KHOUALKA,CITRUS VOLKAMERIANA,50152,IMG-17335.jpg,44,34,34,0,10,1.0,0.7727272727272727
2024,KHOUALKA,CITRUS VOLKAMERIANA,50152,IMG-17340.jpg,108,74,70,4,38,0.945945945945946,0.6481481481481481
2024,KHOUALKA,CITRUS VOLKAMERIANA,50152,IMG-17356.jpg,60,40,37,3,23,0.925,0.6166666666666667
2024,KHOUALKA,CITRUS VOLKAMERIANA,50152,IMG-17384.jpg,53,29,28,1,25,0.9655172413793104,0.5283018867924528
2024,KHOUALKA,CITRUS VOLKAMERIANA,50154,IMG-17440.jpg,76,61,60,1,16,0.9836065573770492,0.7894736842105263
2024,KHOUALKA,CITRUS VOLKAMERIANA,50154,IMG-17490.jpg,107,74,73,1,34,0.9864864864864864,0.6822429906542056
2024,KHOUALKA,CITRUS VOLKAMERIANA,50154,IMG-17543.jpg,100,65,65,0,35,1.0,0.65
2024,KHOUALKA,CITRUS VOLKAMERIANA,50154,IMG-17545.jpg,94,66,65,1,29,0.9848484848484848,0.6914893617021277
2024,KHOUALKA,CITRUS VOLKAMERIANA,50154,IMG-17562.jpg,129,104,101,3,28,0.971153846153846,0.7829457364341085
2024,KHOUALKA,CITRUS VOLKAMERIANA,50154,IMG-17576.jpg,121,88,88,0,33,1.0,0.7272727272727273
2024,KHOUALKA,CITRUS VOLKAMERIANA,50154,IMG-17585.jpg,171,110,110,0,61,1.0,0.6432748538011696
2024,KHOUALKA,CITRUS VOLKAMERIANA,50168,IMG-13980.jpg,174,120,119,1,55,0.9916666666666668,0.6839080459770115
2024,KHOUALKA,CITRUS VOLKAMERIANA,50168,IMG-15749.jpg,147,110,108,2,39,0.9818181818181818,0.7346938775510204
2024,KHOUALKA,CITRUS VOLKAMERIANA,50168,IMG-15758.jpg,163,112,109,3,54,0.9732142857142856,0.6687116564417178
2024,KHOUALKA,CITRUS VOLKAMERIANA,50168,IMG-15981.jpg,210,161,160,1,50,0.9937888198757764,0.7619047619047619
2024,KHOUALKA,CITRUS VOLKAMERIANA,50168,IMG-15983.jpg,120,85,84,1,36,0.9882352941176472,0.7
2024,KHOUALKA,CITRUS VOLKAMERIANA,50176,IMG-16025.jpg,81,55,54,1,27,0.9818181818181818,0.6666666666666666
2024,KHOUALKA,CITRUS VOLKAMERIANA,50176,IMG-16051.jpg,85,55,53,2,32,0.9636363636363636,0.6235294117647059
2024,KHOUALKA,CITRUS VOLKAMERIANA,50176,IMG-16079.jpg,161,106,105,1,56,0.9905660377358492,0.6521739130434783
2024,KHOUALKA,CITRUS VOLKAMERIANA,50176,IMG-16095.jpg,101,58,58,0,43,1.0,0.5742574257425742
2024,KHOUALKA,CITRUS VOLKAMERIANA,50176,IMG-16105.jpg,43,28,27,1,16,0.9642857142857144,0.627906976744186
2022,ONAGRI,CITRUMELO SACCATON,50193,IMG-00007-39.jpg,218,246,217,29,1,0.8821138211382114,0.9954128440366972
2022,ONAGRI,CITRUMELO SACCATON,50193,IMG-00016-39.jpg,64,78,63,15,1,0.8076923076923077,0.984375
2022,ONAGRI,CITRUMELO SACCATON,50193,IMG-00018-39.jpg,115,121,110,11,5,0.9090909090909092,0.9565217391304348
2022,ONAGRI,CITRUMELO SACCATON,50193,IMG-00021-39.jpg,62,62,57,5,5,0.9193548387096774,0.9193548387096774
2022,ONAGRI,CITRUMELO SACCATON,50193,IMG-00023-39.jpg,113,126,113,13,0,0.8968253968253969,1.0
2022,ONAGRI,CITRUMELO SACCATON,50194,IMG-00032-39.jpg,162,184,156,28,6,0.8478260869565217,0.9629629629629628
2022,ONAGRI,CITRUMELO SACCATON,50194,IMG-00034-39.jpg,105,118,105,13,0,0.8898305084745762,1.0
2022,ONAGRI,CITRUMELO SACCATON,50194,IMG-00036-39.jpg,161,178,159,19,2,0.8932584269662921,0.9875776397515528
2022,ONAGRI,CITRUMELO SACCATON,50194,IMG-00038-39.jpg,100,124,99,25,1,0.7983870967741935,0.99
2022,ONAGRI,CITRUMELO SACCATON,50194,IMG-00039-39.jpg,65,72,63,9,2,0.875,0.9692307692307692
2022,ONAGRI,CITRUMELO SACCATON,50194,IMG-00041-39.jpg,153,166,152,14,1,0.9156626506024096,0.9934640522875816
2022,ONAGRI,CITRUMELO SACCATON,50194,IMG-00051-39.jpg,137,138,130,8,7,0.9420289855072465,0.948905109489051
2022,ONAGRI,CITRUMELO SACCATON,50194,IMG-00054-39.jpg,111,116,104,12,7,0.896551724137931,0.9369369369369368
2022,ONAGRI,CITRUMELO SACCATON,51091,IMG-00015-39.jpg,85,98,85,13,0,0.8673469387755102,1.0
2022,ONAGRI,CITRUMELO SACCATON,51091,IMG-00016-39.jpg,170,179,166,13,4,0.9273743016759776,0.976470588235294
2022,ONAGRI,CITRUMELO SACCATON,51091,IMG-00018-39.jpg,185,206,182,24,3,0.883495145631068,0.9837837837837838
2022,ONAGRI,CITRUMELO SACCATON,51091,IMG-00022-39.jpg,135,139,131,8,4,0.9424460431654677,0.9703703703703704
2022,ONAGRI,CITRUMELO SACCATON,51091,IMG-00023-39.jpg,140,132,126,6,14,0.9545454545454546,0.9
2022,ONAGRI,CITRUMELO SACCATON,51091,IMG-00026-39.jpg,149,143,137,6,12,0.958041958041958,0.9194630872483222
2022,ONAGRI,CITRUMELO SACCATON,51091,IMG-00044-39.jpg,168,175,166,9,2,0.9485714285714286,0.988095238095238
2022,ONAGRI,CITRUMELO SACCATON,51095,IMG-00004-39.jpg,201,218,196,22,5,0.8990825688073395,0.9751243781094528
2022,ONAGRI,CITRUMELO SACCATON,51095,IMG-00013-39.jpg,154,147,142,5,12,0.9659863945578232,0.922077922077922
2022,ONAGRI,CITRUMELO SACCATON,51095,IMG-00014-39.jpg,140,137,131,6,9,0.9562043795620438,0.9357142857142856
2022,ONAGRI,CITRUMELO SACCATON,51095,IMG-00015-39.jpg,196,192,187,5,9,0.9739583333333334,0.9540816326530612
2022,ONAGRI,CITRUMELO SACCATON,51095,IMG-00024-39.jpg,234,232,218,14,16,0.9396551724137931,0.9316239316239316
2022,ONAGRI,CITRUMELO SACCATON,51095,IMG-00025-39.jpg,198,204,191,13,7,0.9362745098039216,0.9646464646464646
2022,ONAGRI,CITRUMELO SACCATON,51096,IMG-00009-39.jpg,219,218,205,13,14,0.9403669724770642,0.9360730593607306
2022,ONAGRI,CITRUMELO SACCATON,51096,IMG-00011-39.jpg,145,167,140,27,5,0.8383233532934131,0.9655172413793104
2022,ONAGRI,CITRUMELO SACCATON,51096,IMG-00012-39.jpg,114,116,109,7,5,0.9396551724137931,0.956140350877193
2022,ONAGRI,CITRUMELO SACCATON,51096,IMG-00055-39.jpg,217,215,204,11,13,0.9488372093023256,0.9400921658986175
2022,ONAGRI,MC PONSIRUCE TRIFOLIATA,51097,IMG-00025-39.jpg,121,124,111,13,10,0.8951612903225806,0.9173553719008264
2022,ONAGRI,MC PONSIRUCE TRIFOLIATA,51097,IMG-00029-39.jpg,106,114,96,18,10,0.8421052631578947,0.9056603773584906
2022,ONAGRI,MC PONSIRUCE TRIFOLIATA,51097,IMG-00044-39.jpg,182,185,170,15,12,0.918918918918919,0.934065934065934
2022,ONAGRI,MC PONSIRUCE TRIFOLIATA,51098,IMG-00003-39.jpg,65,65,60,5,5,0.9230769230769232,0.9230769230769232
2022,ONAGRI,MC PONSIRUCE TRIFOLIATA,51098,IMG-00010-39.jpg,184,182,170,12,14,0.934065934065934,0.9239130434782608
2022,ONAGRI,MC PONSIRUCE TRIFOLIATA,51098,IMG-00015-39.jpg,162,153,152,1,10,0.9934640522875816,0.9382716049382716
2022,ONAGRI,MC PONSIRUCE TRIFOLIATA,51099,IMG-00012-39.jpg,133,135,121,14,12,0.8962962962962963,0.9097744360902256
2024,ONAGRI,MC PONSIRUCE TRIFOLIATA,51101,IMG-12118.jpg,177,119,119,0,58,1.0,0.672316384180791
2024,ONAGRI,MC PONSIRUCE TRIFOLIATA,51101,IMG-14223.jpg,153,113,113,0,40,1.0,0.738562091503268
2024,ONAGRI,MC PONSIRUCE TRIFOLIATA,51101,IMG-14226.jpg,151,119,116,3,35,0.9747899159663864,0.7682119205298014
2024,ONAGRI,MC PONSIRUCE TRIFOLIATA,51101,IMG-14255.jpg,189,147,145,2,44,0.9863945578231292,0.7671957671957672
2024,ONAGRI,MC PONSIRUCE TRIFOLIATA,51101,IMG-14281.jpg,150,111,110,1,40,0.990990990990991,0.7333333333333333
2022,ONAGRI,CITRUS VOLKAMERIANA,101020,IMG-00001.jpg,6,5,5,0,1,1.0,0.8333333333333334
2022,ONAGRI,CITRUS VOLKAMERIANA,101020,IMG-00004-44.jpg,53,43,40,3,13,0.9302325581395348,0.7547169811320755
2022,ONAGRI,CITRUS VOLKAMERIANA,101030,IMG-00003-44.jpg,29,29,27,2,2,0.9310344827586208,0.9310344827586208
2022,ONAGRI,CITRUS VOLKAMERIANA,101030,IMG-00004-44.jpg,110,92,90,2,20,0.9782608695652174,0.8181818181818182
2022,ONAGRI,CITRUS VOLKAMERIANA,101030,IMG-00005-44.jpg,134,112,108,4,26,0.9642857142857144,0.8059701492537313
2022,ONAGRI,CITRUS VOLKAMERIANA,101030,IMG-00017-44.jpg,79,60,55,5,24,0.9166666666666666,0.6962025316455697
2022,ONAGRI,CITRUS VOLKAMERIANA,101040,IMG-00005-44.jpg,172,124,122,2,50,0.9838709677419356,0.7093023255813954
2022,ONAGRI,CITRUS VOLKAMERIANA,101040,IMG-00009-44.jpg,131,98,96,2,35,0.979591836734694,0.732824427480916
2022,ONAGRI,CITRUS VOLKAMERIANA,101040,IMG-00011-44.jpg,64,39,36,3,28,0.9230769230769232,0.5625
2022,ONAGRI,CITRUS VOLKAMERIANA,101040,IMG-00012-44.jpg,139,89,86,3,53,0.9662921348314608,0.6187050359712231
2022,ONAGRI,CITRUS VOLKAMERIANA,101050,IMG-00002-44.jpg,95,75,70,5,25,0.9333333333333332,0.7368421052631579
2022,ONAGRI,CITRUS VOLKAMERIANA,101050,IMG-00005-44.jpg,59,45,44,1,15,0.9777777777777776,0.7457627118644068
2022,ONAGRI,CITRUS VOLKAMERIANA,101050,IMG-00011-44.jpg,46,23,21,2,25,0.9130434782608696,0.4565217391304348
2022,ONAGRI,CITRUS VOLKAMERIANA,101050,IMG-00024-44.jpg,40,26,25,1,15,0.9615384615384616,0.625
2022,ONAGRI,CITRUS VOLKAMERIANA,101080,IMG-00005-44.jpg,42,26,24,2,18,0.9230769230769232,0.5714285714285714
2022,ONAGRI,CITRUS VOLKAMERIANA,101080,IMG-00006-44.jpg,79,50,50,0,29,1.0,0.6329113924050633
2022,ONAGRI,CITRUS VOLKAMERIANA,101080,IMG-00023-44.jpg,7,6,6,0,1,1.0,0.8571428571428571
2022,ONAGRI,CITRUS VOLKAMERIANA,101080,IMG-00024-44.jpg,27,12,11,1,16,0.9166666666666666,0.4074074074074074
2022,ONAGRI,CITRUS VOLKAMERIANA,101090,IMG-00003-44.jpg,66,54,52,2,14,0.9629629629629628,0.7878787878787878
2022,ONAGRI,CITRUS VOLKAMERIANA,101090,IMG-00006-44.jpg,41,27,26,1,15,0.9629629629629628,0.6341463414634146
2022,ONAGRI,CITRUS VOLKAMERIANA,101090,IMG-00019-44.jpg,35,27,24,3,11,0.8888888888888888,0.6857142857142857
2022,ONAGRI,CITRUS VOLKAMERIANA,101090,IMG-00020-44.jpg,42,31,29,2,13,0.935483870967742,0.6904761904761905
2022,KHOUALKA,CITRANGE CARRIZO,102130,IMG-00001.jpg,5,1,1,0,4,1.0,0.2
2022,KHOUALKA,CITRANGE CARRIZO,102130,IMG-00004-43.jpg,24,5,4,1,20,0.8,0.1666666666666667
2022,KHOUALKA,CITRANGE CARRIZO,102130,IMG-00019-43.jpg,33,19,18,1,15,0.9473684210526316,0.5454545454545454
2022,KHOUALKA,CITRANGE CARRIZO,102130,IMG-00020-43.jpg,18,12,10,2,8,0.8333333333333334,0.5555555555555556
2022,KHOUALKA,MACROPHYLLA,201180,IMG-00007-43.jpg,38,32,29,3,9,0.90625,0.7631578947368421
2022,KHOUALKA,MACROPHYLLA,201180,IMG-00011-43.jpg,64,38,37,1,27,0.9736842105263158,0.578125
2022,KHOUALKA,MACROPHYLLA,201180,IMG-00019-43.jpg,64,41,40,1,24,0.975609756097561,0.625
2022,KHOUALKA,MACROPHYLLA,201180,IMG-00020-43.jpg,43,32,29,3,14,0.90625,0.6744186046511628
2022,KHOUALKA,MACROPHYLLA,201190,IMG-00004-43.jpg,101,49,49,0,52,1.0,0.4851485148514851
2022,KHOUALKA,MACROPHYLLA,201190,IMG-00010-43.jpg,90,27,27,0,63,1.0,0.3
2022,KHOUALKA,MACROPHYLLA,201190,IMG-00011-43.jpg,134,51,51,0,83,1.0,0.3805970149253731
2022,KHOUALKA,MACROPHYLLA,201190,IMG-00020-43.jpg,95,54,50,4,45,0.925925925925926,0.5263157894736842
2022,KHOUALKA,CITRUS VOLKAMERIANA,201210,IMG-00011-43.jpg,103,61,60,1,43,0.9836065573770492,0.5825242718446602
2022,KHOUALKA,CITRUS VOLKAMERIANA,201210,IMG-00012-43.jpg,42,22,22,0,20,1.0,0.5238095238095238
2022,KHOUALKA,CITRUS VOLKAMERIANA,201210,IMG-00015-43.jpg,77,39,39,0,38,1.0,0.5064935064935064
2022,KHOUALKA,CITRUS VOLKAMERIANA,201210,IMG-00019-43.jpg,31,17,17,0,14,1.0,0.5483870967741935
2022,KHOUALKA,BIGARADIER,201320,IMG-00006-43.jpg,87,50,49,1,38,0.98,0.5632183908045977
2022,KHOUALKA,BIGARADIER,201320,IMG-00016-43.jpg,97,70,68,2,29,0.9714285714285714,0.7010309278350515
2022,KHOUALKA,BIGARADIER,201320,IMG-00017-43.jpg,49,35,34,1,15,0.9714285714285714,0.6938775510204082
2022,KHOUALKA,BIGARADIER,201320,IMG-00020-43.jpg,88,64,61,3,27,0.953125,0.6931818181818182
2022,ONAGRI,BIGARADIER,201390,IMG-00008-44.jpg,62,32,31,1,31,0.96875,0.5
2022,ONAGRI,BIGARADIER,201390,IMG-00011-44.jpg,90,46,42,4,48,0.9130434782608696,0.4666666666666667
2022,ONAGRI,BIGARADIER,201390,IMG-00013-44.jpg,77,27,26,1,51,0.9629629629629628,0.3376623376623377
2022,ONAGRI,BIGARADIER,201390,IMG-00016-44.jpg,69,29,26,3,43,0.896551724137931,0.3768115942028986
2022,KHOUALKA,CITRUS VOLKAMERIANA,202050,IMG-00006-43.jpg,89,46,45,1,44,0.9782608695652174,0.5056179775280899
2022,KHOUALKA,CITRUS VOLKAMERIANA,202050,IMG-00010-43.jpg,94,55,55,0,39,1.0,0.5851063829787234
2022,KHOUALKA,CITRUS VOLKAMERIANA,202050,IMG-00011-43.jpg,151,100,94,6,57,0.94,0.6225165562913907
2022,KHOUALKA,CITRUS VOLKAMERIANA,202050,IMG-00020-43.jpg,129,68,67,1,62,0.9852941176470588,0.5193798449612403
2022,KHOUALKA,CITRUS VOLKAMERIANA,202070,IMG-00006-43.jpg,68,33,29,4,39,0.8787878787878788,0.4264705882352941
2022,KHOUALKA,CITRUS VOLKAMERIANA,202070,IMG-00009-43.jpg,120,65,61,4,59,0.9384615384615383,0.5083333333333333
2022,KHOUALKA,CITRUS VOLKAMERIANA,202070,IMG-00013-43.jpg,95,46,46,0,49,1.0,0.4842105263157895
2022,KHOUALKA,CITRUS VOLKAMERIANA,202070,IMG-00019-43.jpg,57,35,34,1,23,0.9714285714285714,0.5964912280701754
2022,KHOUALKA,CITRUS VOLKAMERIANA,202080,IMG-00005-43.jpg,65,38,37,1,28,0.9736842105263158,0.5692307692307692
2022,KHOUALKA,CITRUS VOLKAMERIANA,202080,IMG-00008-43.jpg,31,22,22,0,9,1.0,0.7096774193548387
2022,KHOUALKA,CITRUS VOLKAMERIANA,202080,IMG-00015-43.jpg,220,120,113,7,107,0.9416666666666668,0.5136363636363637
2022,KHOUALKA,CITRUS VOLKAMERIANA,202080,IMG-00016-43.jpg,131,71,69,2,62,0.971830985915493,0.5267175572519084
2022,KHOUALKA,CITRANGE CARRIZO,301380,IMG-00007-43.jpg,30,15,13,2,17,0.8666666666666667,0.4333333333333333
2022,KHOUALKA,CITRANGE CARRIZO,301380,IMG-00011-43.jpg,53,38,36,2,17,0.9473684210526316,0.6792452830188679
2022,KHOUALKA,CITRANGE CARRIZO,301380,IMG-00014-43.jpg,7,4,4,0,3,1.0,0.5714285714285714
2022,KHOUALKA,CITRANGE CARRIZO,301380,IMG-00020-43.jpg,91,53,51,2,40,0.9622641509433962,0.5604395604395604
2022,ONAGRI,CITRUS VOLKAMERIANA,301470,IMG-00003-44.jpg,148,103,101,2,47,0.9805825242718448,0.6824324324324325
2022,ONAGRI,CITRUS VOLKAMERIANA,301470,IMG-00004-44.jpg,163,73,71,2,92,0.9726027397260274,0.4355828220858896
2022,ONAGRI,CITRUS VOLKAMERIANA,301470,IMG-00005-44.jpg,160,81,79,2,81,0.9753086419753086,0.49375
2022,ONAGRI,CITRUS VOLKAMERIANA,301480,IMG-00001.jpg,92,36,34,2,58,0.9444444444444444,0.3695652173913043
2022,ONAGRI,CITRUS VOLKAMERIANA,301480,IMG-00003-43.jpg,26,8,8,0,18,1.0,0.3076923076923077
2022,ONAGRI,CITRUS VOLKAMERIANA,301480,IMG-00012-43.jpg,50,25,25,0,25,1.0,0.5
2022,ONAGRI,CITRUS VOLKAMERIANA,301480,IMG-00014-43.jpg,77,40,40,0,37,1.0,0.5194805194805194
2022,ONAGRI,CITRUS VOLKAMERIANA,301490,IMG-00005-44.jpg,108,48,47,1,61,0.9791666666666666,0.4351851851851852
2022,ONAGRI,CITRUS VOLKAMERIANA,301490,IMG-00009-44.jpg,185,87,81,6,104,0.9310344827586208,0.4378378378378379
2022,ONAGRI,CITRUS VOLKAMERIANA,301490,IMG-00012-44.jpg,162,81,79,2,83,0.9753086419753086,0.4876543209876543
2022,ONAGRI,CITRUS VOLKAMERIANA,301490,IMG-00015-44.jpg,109,53,52,1,57,0.981132075471698,0.4770642201834863
2022,ONAGRI,CITRUS VOLKAMERIANA,301510,IMG-00001.jpg,252,114,110,4,142,0.9649122807017544,0.4365079365079365
2022,ONAGRI,CITRUS VOLKAMERIANA,301510,IMG-00006-44.jpg,137,64,64,0,73,1.0,0.4671532846715328
2022,ONAGRI,CITRUS VOLKAMERIANA,301510,IMG-00007-44.jpg,115,49,47,2,68,0.9591836734693876,0.4086956521739131
2022,ONAGRI,CITRUS VOLKAMERIANA,301510,IMG-00008-44.jpg,150,78,75,3,75,0.9615384615384616,0.5
2022,ONAGRI,BIGARADIER,301550,IMG-00008-44.jpg,144,75,74,1,70,0.9866666666666668,0.5138888888888888
2022,ONAGRI,BIGARADIER,301550,IMG-00011-44.jpg,40,19,18,1,22,0.9473684210526316,0.45
2022,ONAGRI,BIGARADIER,301550,IMG-00013-44.jpg,76,30,30,0,46,1.0,0.3947368421052632
2022,ONAGRI,BIGARADIER,301550,IMG-00014-44.jpg,80,41,37,4,43,0.902439024390244,0.4625
2022,ONAGRI,CITRUS VOLKAMERIANA,301570,IMG-00004-44.jpg,158,77,74,3,84,0.961038961038961,0.4683544303797468
2022,ONAGRI,CITRUS VOLKAMERIANA,301570,IMG-00007-44.jpg,152,70,69,1,83,0.9857142857142858,0.4539473684210527
2022,ONAGRI,CITRUS VOLKAMERIANA,301570,IMG-00008-44.jpg,103,39,38,1,65,0.9743589743589745,0.3689320388349515
2022,ONAGRI,CITRUS VOLKAMERIANA,301570,IMG-00017-44.jpg,218,95,90,5,128,0.9473684210526316,0.4128440366972477
2022,KHOUALKA,CITRUS VOLKAMERIANA,302340,IMG-00004-43.jpg,106,51,49,2,57,0.9607843137254902,0.4622641509433962
2022,KHOUALKA,CITRUS VOLKAMERIANA,302340,IMG-00005-43.jpg,105,53,53,0,52,1.0,0.5047619047619047
2022,KHOUALKA,CITRUS VOLKAMERIANA,302340,IMG-00011-43.jpg,75,34,33,1,42,0.9705882352941176,0.44
2022,KHOUALKA,CITRUS VOLKAMERIANA,302340,IMG-00015-43.jpg,92,31,29,2,63,0.935483870967742,0.3152173913043478
2022,KHOUALKA,CITRUS VOLKAMERIANA,302350,IMG-00008-43.jpg,33,19,19,0,14,1.0,0.5757575757575758
2022,KHOUALKA,CITRUS VOLKAMERIANA,302350,IMG-00013-43.jpg,80,42,42,0,38,1.0,0.525
2022,KHOUALKA,CITRUS VOLKAMERIANA,302350,IMG-00014-43.jpg,76,43,42,1,34,0.9767441860465116,0.5526315789473685
2022,KHOUALKA,CITRUS VOLKAMERIANA,302350,IMG-00018-43.jpg,44,28,27,1,17,0.9642857142857144,0.6136363636363636
2022,KHOUALKA,CITRUS VOLKAMERIANA,302360,IMG-00005-43.jpg,97,39,39,0,58,1.0,0.4020618556701031
2022,KHOUALKA,CITRUS VOLKAMERIANA,302360,IMG-00006-43.jpg,118,40,39,1,79,0.975,0.3305084745762712
2022,KHOUALKA,CITRUS VOLKAMERIANA,302360,IMG-00016-43.jpg,67,27,27,0,40,1.0,0.4029850746268657
2022,KHOUALKA,CITRUS VOLKAMERIANA,302360,IMG-00021-43.jpg,65,37,33,4,32,0.8918918918918919,0.5076923076923077
2022,KHOUALKA,CITRUS VOLKAMERIANA,302510,IMG-00001.jpg,73,33,33,0,40,1.0,0.4520547945205479
2022,KHOUALKA,CITRUS VOLKAMERIANA,302510,IMG-00002-43.jpg,44,16,14,2,30,0.875,0.3181818181818182
2022,KHOUALKA,CITRUS VOLKAMERIANA,302510,IMG-00003-43.jpg,78,43,43,0,35,1.0,0.5512820512820513
2022,KHOUALKA,CITRUS VOLKAMERIANA,302510,IMG-00015-43.jpg,49,25,23,2,26,0.92,0.4693877551020408
2022,KHOUALKA,BIGARADIER,401410,IMG-00093-43.jpg,35,19,17,2,18,0.8947368421052632,0.4857142857142857
2022,KHOUALKA,BIGARADIER,401410,IMG-00099-43.jpg,6,2,2,0,4,1.0,0.3333333333333333
2022,KHOUALKA,BIGARADIER,401410,IMG-00102-43.jpg,78,31,31,0,47,1.0,0.3974358974358974
2022,KHOUALKA,BIGARADIER,401410,IMG-00104-43.jpg,81,41,40,1,41,0.975609756097561,0.4938271604938271
2022,ONAGRI,CITRANGE C35,401660,IMG-00001.jpg,56,38,36,2,20,0.9473684210526316,0.6428571428571429
2022,ONAGRI,CITRANGE C35,401660,IMG-00008-44.jpg,42,26,24,2,18,0.9230769230769232,0.5714285714285714
2022,ONAGRI,CITRANGE C35,401660,IMG-00010-44.jpg,29,20,19,1,10,0.95,0.6551724137931034
2022,ONAGRI,CITRANGE C35,401660,IMG-00016-44.jpg,64,38,36,2,28,0.9473684210526316,0.5625
2022,ONAGRI,CITRANGE C35,401710,IMG-00003-44.jpg,51,26,26,0,25,1.0,0.5098039215686274
2022,ONAGRI,CITRANGE C35,401710,IMG-00012-44.jpg,19,11,11,0,8,1.0,0.5789473684210527
2022,ONAGRI,CITRANGE C35,401710,IMG-00013-44.jpg,33,26,24,2,9,0.9230769230769232,0.7272727272727273
2022,ONAGRI,CITRANGE C35,401710,IMG-00019-44.jpg,76,48,48,0,28,1.0,0.631578947368421
2022,ONAGRI,CITRANGE C35,401720,IMG-00007-44.jpg,93,58,55,3,38,0.9482758620689656,0.5913978494623656
2022,ONAGRI,CITRANGE C35,401720,IMG-00008-44.jpg,38,24,23,1,15,0.9583333333333334,0.6052631578947368
2022,ONAGRI,CITRANGE C35,401720,IMG-00010-44.jpg,50,17,16,1,34,0.9411764705882352,0.32
2022,ONAGRI,CITRANGE C35,401720,IMG-00017-44.jpg,68,42,41,1,27,0.9761904761904762,0.6029411764705882
2022,ONAGRI,CITRANGE C35,401730,IMG-00001.jpg,19,6,5,1,14,0.8333333333333334,0.2631578947368421
2022,ONAGRI,CITRANGE C35,401730,IMG-00010-44.jpg,50,25,25,0,25,1.0,0.5
2022,ONAGRI,CITRANGE C35,401730,IMG-00013-44.jpg,75,59,58,1,17,0.9830508474576272,0.7733333333333333
2022,ONAGRI,CITRANGE C35,401730,IMG-00016-44.jpg,36,20,20,0,16,1.0,0.5555555555555556
2022,ONAGRI,CITRANGE C35,401750,IMG-00005-44.jpg,88,39,38,1,50,0.9743589743589745,0.4318181818181818
2022,ONAGRI,CITRANGE C35,401750,IMG-00009-44.jpg,127,72,70,2,57,0.9722222222222222,0.5511811023622047
2022,ONAGRI,CITRANGE C35,401750,IMG-00016-44.jpg,107,61,61,0,46,1.0,0.5700934579439252
2022,ONAGRI,CITRANGE C35,401750,IMG-00024-44.jpg,50,27,27,0,23,1.0,0.54
2022,ONAGRI,CITRUMELO SACCATON,401770,IMG-00003-44.jpg,24,18,16,2,8,0.8888888888888888,0.6666666666666666
2022,ONAGRI,CITRUMELO SACCATON,401770,IMG-00008-44.jpg,72,38,37,1,35,0.9736842105263158,0.5138888888888888
2022,ONAGRI,CITRUMELO SACCATON,401770,IMG-00009-44.jpg,14,8,8,0,6,1.0,0.5714285714285714
2022,ONAGRI,CITRUMELO SACCATON,401770,IMG-00017-44.jpg,20,13,11,2,9,0.8461538461538461,0.55
2022,KHOUALKA,BIGARADIER,402440,IMG-00005-43.jpg,17,2,2,0,15,1.0,0.1176470588235294
2022,KHOUALKA,BIGARADIER,402440,IMG-00012-43.jpg,46,25,23,2,23,0.92,0.5
2022,KHOUALKA,BIGARADIER,402440,IMG-00014-43.jpg,11,4,4,0,7,1.0,0.3636363636363636
2022,KHOUALKA,BIGARADIER,402440,IMG-00015-43.jpg,22,5,5,0,17,1.0,0.2272727272727273
2022,KHOUALKA,BIGARADIER,402590,IMG-00007-43.jpg,104,50,48,2,56,0.96,0.4615384615384616
2022,KHOUALKA,BIGARADIER,402590,IMG-00012-43.jpg,45,21,18,3,27,0.8571428571428571,0.4
2022,KHOUALKA,BIGARADIER,402590,IMG-00015-43.jpg,58,34,33,1,25,0.9705882352941176,0.5689655172413793
2022,KHOUALKA,BIGARADIER,402590,IMG-00019-43.jpg,64,34,33,1,31,0.9705882352941176,0.515625
2022,KHOUALKA,CITRUS VOLKAMERIANA,501520,IMG-00004-43.jpg,39,19,18,1,21,0.9473684210526316,0.4615384615384616
2022,KHOUALKA,CITRUS VOLKAMERIANA,501520,IMG-00007-43.jpg,43,18,18,0,25,1.0,0.4186046511627907
2022,KHOUALKA,CITRUS VOLKAMERIANA,501520,IMG-00015-43.jpg,18,9,8,1,10,0.8888888888888888,0.4444444444444444
2022,KHOUALKA,CITRUS VOLKAMERIANA,501520,IMG-00020-43.jpg,48,24,23,1,25,0.9583333333333334,0.4791666666666667
2022,KHOUALKA,CITRUS VOLKAMERIANA,501540,IMG-00006-43.jpg,38,31,26,5,12,0.8387096774193549,0.6842105263157895
2022,KHOUALKA,CITRUS VOLKAMERIANA,501540,IMG-00012-43.jpg,102,60,59,1,43,0.9833333333333332,0.5784313725490197
2022,KHOUALKA,CITRUS VOLKAMERIANA,501540,IMG-00017-43.jpg,138,57,56,1,82,0.9824561403508772,0.4057971014492754
2022,KHOUALKA,CITRUS VOLKAMERIANA,501540,IMG-00018-43.jpg,51,29,27,2,24,0.9310344827586208,0.5294117647058824
2022,KHOUALKA,CITRUS VOLKAMERIANA,501660,IMG-00006-43.jpg,60,32,30,2,30,0.9375,0.5
2022,KHOUALKA,CITRUS VOLKAMERIANA,501660,IMG-00016-43.jpg,63,36,32,4,31,0.8888888888888888,0.5079365079365079
2022,KHOUALKA,CITRUS VOLKAMERIANA,501660,IMG-00018-43.jpg,112,52,51,1,61,0.9807692307692308,0.4553571428571428
2022,KHOUALKA,CITRUS VOLKAMERIANA,501660,IMG-00021-43.jpg,90,50,49,1,41,0.98,0.5444444444444444
2022,KHOUALKA,CITRUS VOLKAMERIANA,501680,IMG-00005-43.jpg,179,89,88,1,91,0.9887640449438202,0.4916201117318436
2022,KHOUALKA,CITRUS VOLKAMERIANA,501680,IMG-00011-43.jpg,101,40,39,1,62,0.975,0.3861386138613861
2022,KHOUALKA,CITRUS VOLKAMERIANA,501680,IMG-00012-43.jpg,76,27,26,1,50,0.9629629629629628,0.3421052631578947
2022,KHOUALKA,CITRUS VOLKAMERIANA,501680,IMG-00016-43.jpg,113,63,60,3,53,0.9523809523809524,0.5309734513274337
2022,KHOUALKA,CITRUS VOLKAMERIANA,501690,IMG-00032-43.jpg,34,13,12,1,22,0.9230769230769232,0.3529411764705883
2022,KHOUALKA,CITRUS VOLKAMERIANA,501690,IMG-00039-43.jpg,186,100,96,4,90,0.96,0.5161290322580645
2022,KHOUALKA,CITRUS VOLKAMERIANA,501690,IMG-00047-43.jpg,103,44,43,1,60,0.9772727272727272,0.4174757281553398
2022,KHOUALKA,CITRUS VOLKAMERIANA,501690,IMG-00049-43.jpg,166,74,74,0,92,1.0,0.4457831325301205
2022,KHOUALKA,CITRUS VOLKAMERIANA,501760,IMG-00001.jpg,94,29,29,0,65,1.0,0.3085106382978723
2022,KHOUALKA,CITRUS VOLKAMERIANA,501760,IMG-00034-43.jpg,45,6,6,0,39,1.0,0.1333333333333333
2022,KHOUALKA,CITRUS VOLKAMERIANA,501760,IMG-00036-43.jpg,40,13,12,1,28,0.9230769230769232,0.3
2022,KHOUALKA,CITRUS VOLKAMERIANA,501760,IMG-00051-43.jpg,92,23,23,0,69,1.0,0.25
2022,ONAGRI,CITRUMELO SACCATON,510910,IMG-00004-44.jpg,73,44,44,0,29,1.0,0.6027397260273972
2022,ONAGRI,CITRUMELO SACCATON,510910,IMG-00008-44.jpg,152,74,71,3,81,0.9594594594594594,0.4671052631578947
2022,ONAGRI,CITRUMELO SACCATON,510910,IMG-00010-44.jpg,107,64,62,2,45,0.96875,0.5794392523364486
2022,ONAGRI,CITRUMELO SACCATON,510910,IMG-00011-44.jpg,92,52,49,3,43,0.9423076923076924,0.532608695652174
2022,ONAGRI,CITRUMELO SACCATON,510950,IMG-00006-44.jpg,70,48,48,0,22,1.0,0.6857142857142857
2022,ONAGRI,CITRUMELO SACCATON,510950,IMG-00008-44.jpg,75,44,43,1,32,0.9772727272727272,0.5733333333333334
2022,ONAGRI,CITRUMELO SACCATON,510950,IMG-00009-44.jpg,85,52,49,3,36,0.9423076923076924,0.5764705882352941
2022,ONAGRI,CITRUMELO SACCATON,510950,IMG-00011-44.jpg,135,96,93,3,42,0.96875,0.6888888888888889
2022,ONAGRI,MC PONSIRUCE TRIFOLIATA,510980,IMG-00014-44.jpg,67,38,35,3,32,0.9210526315789472,0.5223880597014925
2022,ONAGRI,MC PONSIRUCE TRIFOLIATA,510980,IMG-00015-44.jpg,51,35,33,2,18,0.9428571428571428,0.6470588235294118
2022,ONAGRI,MC PONSIRUCE TRIFOLIATA,510980,IMG-00016-44.jpg,99,57,55,2,44,0.9649122807017544,0.5555555555555556
2022,ONAGRI,MC PONSIRUCE TRIFOLIATA,510980,IMG-00019-44.jpg,102,58,56,2,46,0.9655172413793104,0.5490196078431373
2022,ONAGRI,MC PONSIRUCE TRIFOLIATA,510990,IMG-00006-44.jpg,135,82,79,3,56,0.9634146341463414,0.5851851851851851
2022,ONAGRI,MC PONSIRUCE TRIFOLIATA,510990,IMG-00008-44.jpg,110,75,73,2,37,0.9733333333333334,0.6636363636363637
2022,ONAGRI,MC PONSIRUCE TRIFOLIATA,510990,IMG-00009-44.jpg,85,54,53,1,32,0.9814814814814816,0.6235294117647059
2022,ONAGRI,MC PONSIRUCE TRIFOLIATA,510990,IMG-00024-44.jpg,65,36,35,1,30,0.9722222222222222,0.5384615384615384
2022,ONAGRI,MC PONSIRUCE TRIFOLIATA,511030,IMG-00007-44.jpg,100,74,71,3,29,0.9594594594594594,0.71
2022,ONAGRI,MC PONSIRUCE TRIFOLIATA,511030,IMG-00016-44.jpg,63,48,47,1,16,0.9791666666666666,0.746031746031746
2022,ONAGRI,MC PONSIRUCE TRIFOLIATA,511030,IMG-00022-44.jpg,98,78,73,5,25,0.935897435897436,0.7448979591836735
2022,ONAGRI,MC PONSIRUCE TRIFOLIATA,511030,IMG-00027-44.jpg,82,66,61,5,21,0.9242424242424242,0.7439024390243902
2022,ONAGRI,MS PONSIRUCE TRIFOLIATA,511040,IMG-00004-44.jpg,77,54,53,1,24,0.9814814814814816,0.6883116883116883
2022,ONAGRI,MS PONSIRUCE TRIFOLIATA,511040,IMG-00014-44.jpg,48,32,29,3,19,0.90625,0.6041666666666666
2022,ONAGRI,MS PONSIRUCE TRIFOLIATA,511040,IMG-00016-44.jpg,71,42,40,2,31,0.9523809523809524,0.5633802816901409
2022,ONAGRI,MS PONSIRUCE TRIFOLIATA,511040,IMG-00025-44.jpg,56,35,32,3,24,0.9142857142857144,0.5714285714285714
2022,ONAGRI,FUZHU,511050,IMG-00004-44.jpg,109,60,57,3,52,0.95,0.5229357798165137
2022,ONAGRI,FUZHU,511050,IMG-00006-44.jpg,142,92,85,7,57,0.9239130434782608,0.5985915492957746
2022,ONAGRI,FUZHU,511050,IMG-00011-44.jpg,172,123,118,5,54,0.959349593495935,0.686046511627907
2022,ONAGRI,FUZHU,511050,IMG-00022-44.jpg,194,128,124,4,70,0.96875,0.6391752577319587
2022,ONAGRI,MS PONSIRUCE TRIFOLIATA,511060,IMG-00007-44.jpg,115,72,71,1,44,0.9861111111111112,0.6173913043478261
2022,ONAGRI,MS PONSIRUCE TRIFOLIATA,511060,IMG-00016-44.jpg,102,57,53,4,49,0.9298245614035088,0.5196078431372549
2022,ONAGRI,MS PONSIRUCE TRIFOLIATA,511060,IMG-00017-44.jpg,59,27,27,0,32,1.0,0.4576271186440678
2022,ONAGRI,MS PONSIRUCE TRIFOLIATA,511060,IMG-00019-44.jpg,108,64,60,4,48,0.9375,0.5555555555555556
2022,ONAGRI,FUZHU,511070,IMG-00006-44.jpg,82,63,60,3,22,0.9523809523809524,0.7317073170731707
2022,ONAGRI,FUZHU,511070,IMG-00016-44.jpg,96,52,51,1,45,0.9807692307692308,0.53125
2022,ONAGRI,FUZHU,511070,IMG-00018-44.jpg,93,56,53,3,40,0.9464285714285714,0.5698924731182796
2022,ONAGRI,FUZHU,511070,IMG-00019-44.jpg,142,79,77,2,65,0.9746835443037974,0.5422535211267606
