compagnie,Domaine,Porte-greffe,parcelle,Filename,True_count,detect_count,TP,FP,FN,Precision,Recall
2022,SAOUDA,BIGARADIER,10010,IMG-00011-45.jpg,28,28,28,0,0,1.0,1.0
2022,SAOUDA,BIGARADIER,10010,IMG-00012-45.jpg,27,27,27,0,0,1.0,1.0
2022,SAOUDA,BIGARADIER,10010,IMG-00014-45.jpg,50,50,49,1,1,0.98,0.98
2022,SAOUDA,BIGARADIER,10010,IMG-00018-45.jpg,30,29,29,0,1,1.0,0.9666666666666668
2022,SAOUDA,BIGARADIER,10010,IMG-00020-45.jpg,31,34,30,4,1,0.8823529411764706,0.967741935483871
2024,SAOUDA,BIGARADIER,10010,IMG-23410.jpg,85,65,63,2,22,0.9692307692307692,0.7411764705882353
2024,SAOUDA,BIGARADIER,10010,IMG-23417.jpg,86,63,63,0,23,1.0,0.7325581395348837
2024,SAOUDA,BIGARADIER,10010,IMG-23430.jpg,74,60,59,1,15,0.9833333333333332,0.7972972972972973
2024,SAOUDA,BIGARADIER,10010,IMG-23647.jpg,95,83,81,2,14,0.9759036144578314,0.8526315789473684
2024,SAOUDA,BIGARADIER,10010,IMG-23672.jpg,47,32,32,0,15,1.0,0.6808510638297872
2024,SAOUDA,BIGARADIER,10010,IMG-23707.jpg,30,26,26,0,4,1.0,0.8666666666666667
2024,SAOUDA,BIGARADIER,10010,IMG-23709.jpg,31,26,26,0,5,1.0,0.8387096774193549
2024,SAOUDA,BIGARADIER,10010,IMG-23711.jpg,79,60,58,2,21,0.9666666666666668,0.7341772151898734
2022,SAOUDA,MACROPHYLLA,10030,IMG-00158-45.jpg,101,106,96,10,5,0.9056603773584906,0.9504950495049505
2022,SAOUDA,MACROPHYLLA,10030,IMG-00159-45.jpg,155,159,150,9,5,0.9433962264150944,0.967741935483871
2022,SAOUDA,MACROPHYLLA,10030,IMG-00162-45.jpg,119,120,113,7,6,0.9416666666666668,0.9495798319327732
2022,SAOUDA,MACROPHYLLA,10030,IMG-00169-45.jpg,72,74,70,4,2,0.945945945945946,0.9722222222222222
2022,SAOUDA,MACROPHYLLA,10031,IMG-00002-45.jpg,46,44,40,4,6,0.9090909090909092,0.8695652173913043
2022,SAOUDA,MACROPHYLLA,10031,IMG-00084-45.jpg,41,47,41,6,0,0.8723404255319149,1.0
2022,SAOUDA,MACROPHYLLA,10031,IMG-00450-45.jpg,27,27,25,2,2,0.925925925925926,0.925925925925926
2022,SAOUDA,MACROPHYLLA,10031,IMG-00451-45.jpg,34,33,32,1,2,0.9696969696969696,0.9411764705882352
2022,SAOUDA,MACROPHYLLA,10031,IMG-00464-45.jpg,33,33,30,3,3,0.9090909090909092,0.9090909090909092
2022,ONAGRI,CITRUS VOLKAMERIANA,10101,IMG-00003-39.jpg,120,117,112,5,8,0.9572649572649572,0.9333333333333332
2022,ONAGRI,CITRUS VOLKAMERIANA,10101,IMG-00010-39.jpg,85,76,72,4,13,0.9473684210526316,0.8470588235294118
2024,ONAGRI,CITRUS VOLKAMERIANA,10101,IMG-10523.jpg,288,221,219,2,69,0.990950226244344,0.7604166666666666
2024,ONAGRI,CITRUS VOLKAMERIANA,10101,IMG-10545.jpg,98,76,75,1,23,0.986842105263158,0.7653061224489796
2024,ONAGRI,CITRUS VOLKAMERIANA,10101,IMG-10558.jpg,143,95,94,1,49,0.9894736842105264,0.6573426573426573
2022,ONAGRI,CITRUS VOLKAMERIANA,10102,IMG-00003-39.jpg,48,37,36,1,12,0.972972972972973,0.75
2024,ONAGRI,CITRUS VOLKAMERIANA,10102,IMG-10637.jpg,140,118,117,1,23,0.9915254237288136,0.8357142857142857
2024,ONAGRI,CITRUS VOLKAMERIANA,10102,IMG-10658.jpg,163,131,130,1,33,0.9923664122137404,0.7975460122699386
2022,ONAGRI,CITRUS VOLKAMERIANA,10103,IMG-00003-39.jpg,215,196,189,7,26,0.9642857142857144,0.8790697674418605
2022,ONAGRI,CITRUS VOLKAMERIANA,10103,IMG-00008-39.jpg,195,182,173,9,22,0.9505494505494504,0.8871794871794871
2024,ONAGRI,CITRUS VOLKAMERIANA,10103,IMG-10614.jpg,134,113,112,1,22,0.991150442477876,0.835820895522388
2024,ONAGRI,CITRUS VOLKAMERIANA,10103,IMG-10630.jpg,213,175,172,3,41,0.9828571428571428,0.8075117370892019
2024,ONAGRI,CITRUS VOLKAMERIANA,10103,IMG-10631.jpg,134,100,100,0,34,1.0,0.746268656716418
2022,ONAGRI,CITRUS VOLKAMERIANA,10104,IMG-00004-39.jpg,65,60,57,3,8,0.95,0.8769230769230769
2022,ONAGRI,CITRUS VOLKAMERIANA,10104,IMG-00008-39.jpg,69,58,55,3,14,0.9482758620689656,0.7971014492753623
2024,ONAGRI,CITRUS VOLKAMERIANA,10104,IMG-11267.jpg,22,12,12,0,10,1.0,0.5454545454545454
2024,ONAGRI,CITRUS VOLKAMERIANA,10104,IMG-11327.jpg,128,95,94,1,34,0.9894736842105264,0.734375
2024,ONAGRI,CITRUS VOLKAMERIANA,10104,IMG-11347.jpg,118,85,85,0,33,1.0,0.7203389830508474
2024,ONAGRI,CITRUS VOLKAMERIANA,10104,IMG-11366.jpg,351,258,255,3,96,0.9883720930232558,0.7264957264957265
2024,ONAGRI,CITRUS VOLKAMERIANA,10104,IMG-11386.jpg,99,72,72,0,27,1.0,0.7272727272727273
2022,ONAGRI,CITRUS VOLKAMERIANA,10105,IMG-00004-39.jpg,17,16,12,4,5,0.75,0.7058823529411765
2022,ONAGRI,CITRUS VOLKAMERIANA,10105,IMG-00005-39.jpg,68,67,61,6,7,0.9104477611940298,0.8970588235294118
2022,ONAGRI,CITRUS VOLKAMERIANA,10108,IMG-00003-39.jpg,61,55,54,1,7,0.9818181818181818,0.8852459016393442
2022,ONAGRI,CITRUS VOLKAMERIANA,10108,IMG-00007-39.jpg,69,56,55,1,14,0.9821428571428572,0.7971014492753623
2022,ONAGRI,CITRUS VOLKAMERIANA,10109,IMG-00003-39.jpg,4,4,4,0,0,1.0,1.0
2022,ONAGRI,CITRUS VOLKAMERIANA,10109,IMG-00008-39.jpg,105,103,98,5,7,0.9514563106796116,0.9333333333333332
2022,KHOUALKA,CITRANGE CARRIZO,10213,IMG-00001.jpg,77,78,75,3,2,0.9615384615384616,0.974025974025974
2022,KHOUALKA,CITRANGE CARRIZO,10213,IMG-00005-40.jpg,73,72,71,1,2,0.9861111111111112,0.9726027397260274
2022,KHOUALKA,CITRANGE CARRIZO,10213,IMG-00009-40.jpg,14,17,14,3,0,0.8235294117647058,1.0
2022,KHOUALKA,CITRANGE CARRIZO,10213,IMG-00014-40.jpg,21,22,21,1,0,0.9545454545454546,1.0
2022,KHOUALKA,CITRANGE CARRIZO,10213,IMG-00028-40.jpg,47,49,47,2,0,0.9591836734693876,1.0
2022,KHOUALKA,CITRANGE CARRIZO,10213,IMG-00034-40.jpg,48,49,48,1,0,0.979591836734694,1.0
2022,KHOUALKA,CITRANGE CARRIZO,10213,IMG-00035-40.jpg,37,38,37,1,0,0.9736842105263158,1.0
2022,KHOUALKA,CITRANGE CARRIZO,10213,IMG-00036-40.jpg,47,51,47,4,0,0.9215686274509804,1.0
2022,KHOUALKA,CITRANGE CARRIZO,10213,IMG-00042-40.jpg,22,22,20,2,2,0.9090909090909092,0.9090909090909092
2022,KHOUALKA,CITRANGE CARRIZO,10213,IMG-00047-40.jpg,70,69,69,0,1,1.0,0.9857142857142858
2022,KHOUALKA,CITRANGE CARRIZO,10213,IMG-00054-40.jpg,33,35,33,2,0,0.9428571428571428,1.0
2022,KHOUALKA,CITRANGE CARRIZO,10213,IMG-00055-40.jpg,93,91,91,0,2,1.0,0.978494623655914
2022,KHOUALKA,CITRANGE CARRIZO,10213,IMG-00061-40.jpg,113,114,111,3,2,0.9736842105263158,0.9823008849557522
2022,KHOUALKA,CITRANGE CARRIZO,10213,IMG-00066-40.jpg,48,46,45,1,3,0.9782608695652174,0.9375
2024,KHOUALKA,CITRANGE CARRIZO,10213,IMG-12628.jpg,119,102,102,0,17,1.0,0.8571428571428571
2024,KHOUALKA,CITRANGE CARRIZO,10213,IMG-12774.jpg,118,98,96,2,22,0.979591836734694,0.8135593220338984
2024,KHOUALKA,CITRANGE CARRIZO,10213,IMG-12780.jpg,44,38,38,0,6,1.0,0.8636363636363636
2024,KHOUALKA,CITRANGE CARRIZO,10213,IMG-12791.jpg,166,122,120,2,46,0.9836065573770492,0.7228915662650602
2024,KHOUALKA,CITRANGE CARRIZO,10213,IMG-12834.jpg,57,43,42,1,15,0.9767441860465116,0.7368421052631579
2024,KHOUALKA,CITRANGE CARRIZO,10213,IMG-12945.jpg,130,101,101,0,29,1.0,0.7769230769230769
2022,OUARGHA,MACROPHYLLA,11010,IMG-00001.jpg,40,40,40,0,0,1.0,1.0
2022,OUARGHA,MACROPHYLLA,11010,IMG-00015-41.jpg,24,24,23,1,1,0.9583333333333334,0.9583333333333334
2022,OUARGHA,MACROPHYLLA,11010,IMG-00019-41.jpg,20,21,17,4,3,0.8095238095238095,0.85
2022,OUARGHA,MACROPHYLLA,11010,IMG-00024-41.jpg,21,22,20,2,1,0.9090909090909092,0.9523809523809524
2022,OUARGHA,MACROPHYLLA,11020,IMG-00017-41.jpg,51,54,51,3,0,0.9444444444444444,1.0
2022,OUARGHA,MACROPHYLLA,11020,IMG-00018-41.jpg,13,13,13,0,0,1.0,1.0
2022,OUARGHA,CITRANGE CARRIZO,13010,IMG-00067-41.jpg,55,53,53,0,2,1.0,0.9636363636363636
2022,OUARGHA,CITRANGE CARRIZO,13010,IMG-00086-41.jpg,49,50,49,1,0,0.98,1.0
2022,OUARGHA,CITRANGE CARRIZO,13010,IMG-00194-41.jpg,33,35,33,2,0,0.9428571428571428,1.0
2022,OUARGHA,CITRANGE CARRIZO,13020,IMG-00023-41.jpg,31,31,29,2,2,0.935483870967742,0.935483870967742
2022,OUARGHA,CITRANGE CARRIZO,13020,IMG-00024-41.jpg,18,18,18,0,0,1.0,1.0
2022,OUARGHA,CITRANGE CARRIZO,13020,IMG-00039-41.jpg,4,4,4,0,0,1.0,1.0
2022,OUARGHA,CITRANGE CARRIZO,13020,IMG-00040-41.jpg,6,5,5,0,1,1.0,0.8333333333333334
2022,OUARGHA,CITRUS VOLKAMERIANA,13030,IMG-00009-41.jpg,18,18,18,0,0,1.0,1.0
2022,OUARGHA,CITRUS VOLKAMERIANA,13030,IMG-00013-41.jpg,46,44,44,0,2,1.0,0.9565217391304348
2022,OUARGHA,CITRUS VOLKAMERIANA,13030,IMG-00027-41.jpg,12,10,10,0,2,1.0,0.8333333333333334
2022,OUARGHA,CITRUS VOLKAMERIANA,13030,IMG-00029-41.jpg,18,18,17,1,1,0.9444444444444444,0.9444444444444444
2022,OUARGHA,CITRUS VOLKAMERIANA,13030,IMG-00036-41.jpg,16,17,14,3,2,0.8235294117647058,0.875
2022,OUARGHA,CITRUS VOLKAMERIANA,14010,IMG-00008-41.jpg,40,41,37,4,3,0.902439024390244,0.925
2022,OUARGHA,CITRUS VOLKAMERIANA,14010,IMG-00010-41.jpg,49,50,49,1,0,0.98,1.0
2022,OUARGHA,CITRUS VOLKAMERIANA,14010,IMG-00011-41.jpg,47,48,47,1,0,0.9791666666666666,1.0
2022,OUARGHA,CITRUS VOLKAMERIANA,14010,IMG-00018-41.jpg,44,45,43,2,1,0.9555555555555556,0.9772727272727272
2022,KHOUALKA,MACROPHYLLA,20118,IMG-00007-40.jpg,44,46,43,3,1,0.9347826086956522,0.9772727272727272
2022,KHOUALKA,MACROPHYLLA,20118,IMG-00008-40.jpg,115,118,115,3,0,0.9745762711864406,1.0
2022,KHOUALKA,MACROPHYLLA,20118,IMG-00022-40.jpg,113,111,111,0,2,1.0,0.9823008849557522
2022,KHOUALKA,MACROPHYLLA,20118,IMG-00033-40.jpg,58,62,57,5,1,0.9193548387096774,0.9827586206896552
2022,KHOUALKA,MACROPHYLLA,20118,IMG-00037-40.jpg,29,30,28,2,1,0.9333333333333332,0.9655172413793104
2022,KHOUALKA,MACROPHYLLA,20118,IMG-00042-40.jpg,137,133,133,0,4,1.0,0.9708029197080292
2022,KHOUALKA,MACROPHYLLA,20118,IMG-00046-40.jpg,45,47,43,4,2,0.9148936170212766,0.9555555555555556
2022,KHOUALKA,MACROPHYLLA,20118,IMG-00050-40.jpg,48,48,48,0,0,1.0,1.0
2022,KHOUALKA,MACROPHYLLA,20118,IMG-00055-40.jpg,52,52,50,2,2,0.9615384615384616,0.9615384615384616
2022,KHOUALKA,MACROPHYLLA,20118,IMG-00061-40.jpg,120,122,118,4,2,0.9672131147540984,0.9833333333333332
2022,KHOUALKA,MACROPHYLLA,20118,IMG-00062-40.jpg,63,63,58,5,5,0.9206349206349206,0.9206349206349206
2022,KHOUALKA,MACROPHYLLA,20118,IMG-00063-40.jpg,47,53,47,6,0,0.8867924528301887,1.0
2022,KHOUALKA,MACROPHYLLA,20118,IMG-00066-40.jpg,84,86,84,2,0,0.9767441860465116,1.0
2024,KHOUALKA,MACROPHYLLA,20118,IMG-12691.jpg,22,14,14,0,8,1.0,0.6363636363636364
2024,KHOUALKA,MACROPHYLLA,20118,IMG-12729.jpg,56,40,40,0,16,1.0,0.7142857142857143
2024,KHOUALKA,MACROPHYLLA,20118,IMG-12735.jpg,88,66,65,1,23,0.9848484848484848,0.7386363636363636
2024,KHOUALKA,MACROPHYLLA,20118,IMG-12748.jpg,107,74,74,0,33,1.0,0.6915887850467289
2024,KHOUALKA,MACROPHYLLA,20118,IMG-12764.jpg,111,94,93,1,18,0.9893617021276596,0.8378378378378378
2024,KHOUALKA,MACROPHYLLA,20118,IMG-12808.jpg,113,80,79,1,34,0.9875,0.6991150442477876
2024,KHOUALKA,MACROPHYLLA,20118,IMG-12851.jpg,24,15,15,0,9,1.0,0.625
2022,KHOUALKA,MACROPHYLLA,20119,IMG-00005-40.jpg,106,107,103,4,3,0.9626168224299064,0.9716981132075472
2022,KHOUALKA,MACROPHYLLA,20119,IMG-00008-40.jpg,142,140,134,6,8,0.9571428571428572,0.943661971830986
2022,KHOUALKA,MACROPHYLLA,20119,IMG-00014-40.jpg,132,132,126,6,6,0.9545454545454546,0.9545454545454546
2022,KHOUALKA,BIGARADIER,20132,IMG-00004-40.jpg,181,173,171,2,10,0.9884393063583816,0.9447513812154696
2022,KHOUALKA,BIGARADIER,20132,IMG-00025-40.jpg,91,92,87,5,4,0.9456521739130436,0.956043956043956
2022,KHOUALKA,BIGARADIER,20132,IMG-00028-40.jpg,49,51,47,4,2,0.9215686274509804,0.9591836734693876
2022,KHOUALKA,BIGARADIER,20132,IMG-00035-40.jpg,103,110,103,7,0,0.9363636363636364,1.0
2022,KHOUALKA,BIGARADIER,20132,IMG-00039-40.jpg,119,126,119,7,0,0.9444444444444444,1.0
2022,KHOUALKA,BIGARADIER,20132,IMG-00046-40.jpg,156,157,155,2,1,0.9872611464968152,0.9935897435897436
2022,KHOUALKA,BIGARADIER,20132,IMG-00051-40.jpg,108,109,104,5,4,0.9541284403669724,0.9629629629629628
2022,KHOUALKA,BIGARADIER,20132,IMG-00055-40.jpg,67,65,64,1,3,0.9846153846153848,0.9552238805970148
2022,KHOUALKA,BIGARADIER,20132,IMG-00058-40.jpg,89,88,88,0,1,1.0,0.9887640449438202
2022,KHOUALKA,BIGARADIER,20132,IMG-00059-40.jpg,139,133,129,4,10,0.9699248120300752,0.9280575539568344
2022,KHOUALKA,BIGARADIER,20132,IMG-00060-40.jpg,57,56,56,0,1,1.0,0.9824561403508772
2022,KHOUALKA,BIGARADIER,20132,IMG-00064-40.jpg,117,117,115,2,2,0.9829059829059827,0.9829059829059827
2022,KHOUALKA,BIGARADIER,20132,IMG-00075-40.jpg,69,71,69,2,0,0.971830985915493,1.0
2022,ONAGRI,BIGARADIER,20139,IMG-00021-39.jpg,93,89,87,2,6,0.9775280898876404,0.935483870967742
2024,KHOUALKA,CITRUS VOLKAMERIANA,20205,IMG-12040.jpg,123,96,92,4,31,0.9583333333333334,0.7479674796747967
2024,KHOUALKA,CITRUS VOLKAMERIANA,20205,IMG-12058.jpg,116,107,106,1,10,0.9906542056074766,0.913793103448276
2024,KHOUALKA,CITRUS VOLKAMERIANA,20207,IMG-11892.jpg,94,68,66,2,28,0.9705882352941176,0.7021276595744681
2024,KHOUALKA,CITRUS VOLKAMERIANA,20207,IMG-11921.jpg,264,190,189,1,75,0.9947368421052633,0.7159090909090909
2024,KHOUALKA,CITRUS VOLKAMERIANA,20207,IMG-11927.jpg,195,136,135,1,60,0.9926470588235294,0.6923076923076923
2024,KHOUALKA,CITRUS VOLKAMERIANA,20207,IMG-11961.jpg,113,85,85,0,28,1.0,0.7522123893805309
2024,KHOUALKA,CITRUS VOLKAMERIANA,20207,IMG-11972.jpg,94,68,67,1,27,0.9852941176470588,0.7127659574468085
2024,KHOUALKA,CITRUS VOLKAMERIANA,20207,IMG-11981.jpg,81,52,52,0,29,1.0,0.6419753086419753
2022,SAOUDA,CITRUS VOLKAMERIANA,21020,IMG-00033-45.jpg,67,68,66,2,1,0.9705882352941176,0.9850746268656716
2022,SAOUDA,CITRUS VOLKAMERIANA,21020,IMG-00087-45.jpg,21,20,19,1,2,0.95,0.9047619047619048
2022,SAOUDA,CITRUS VOLKAMERIANA,21020,IMG-00138-45.jpg,40,41,40,1,0,0.975609756097561,1.0
2022,SAOUDA,CITRUS VOLKAMERIANA,21020,IMG-00145-45.jpg,37,39,37,2,0,0.9487179487179488,1.0
2022,SAOUDA,CITRUS VOLKAMERIANA,21020,IMG-00155-45.jpg,38,40,33,7,5,0.825,0.868421052631579
2022,SAOUDA,CITRUS VOLKAMERIANA,21030,IMG-00521-45.jpg,31,37,30,7,1,0.8108108108108109,0.967741935483871
2022,SAOUDA,CITRUS VOLKAMERIANA,21030,IMG-00524-45.jpg,71,78,69,9,2,0.8846153846153846,0.971830985915493
2022,SAOUDA,CITRUS VOLKAMERIANA,21030,IMG-00536-45.jpg,41,48,38,10,3,0.7916666666666666,0.926829268292683
2022,SAOUDA,CITRUS VOLKAMERIANA,21030,IMG-00537-45.jpg,52,52,50,2,2,0.9615384615384616,0.9615384615384616
2022,SAOUDA,CITRUS VOLKAMERIANA,22020,IMG-00053-45.jpg,39,44,38,6,1,0.8636363636363636,0.9743589743589745
2022,SAOUDA,CITRUS VOLKAMERIANA,22020,IMG-00059-45.jpg,46,49,46,3,0,0.9387755102040816,1.0
2022,SAOUDA,CITRUS VOLKAMERIANA,22020,IMG-00060-45.jpg,48,51,48,3,0,0.9411764705882352,1.0
2022,SAOUDA,CITRUS VOLKAMERIANA,22020,IMG-00062-45.jpg,50,55,50,5,0,0.9090909090909092,1.0
2022,SAOUDA,CITRUS VOLKAMERIANA,22030,IMG-00062-45.jpg,62,66,62,4,0,0.9393939393939394,1.0
2022,SAOUDA,CITRUS VOLKAMERIANA,22030,IMG-00063-45.jpg,83,84,79,5,4,0.9404761904761904,0.9518072289156626
2022,SAOUDA,CITRUS VOLKAMERIANA,22030,IMG-00065-45.jpg,58,61,58,3,0,0.9508196721311476,1.0
2022,SAOUDA,CITRUS VOLKAMERIANA,22030,IMG-00068-45.jpg,66,69,65,4,1,0.9420289855072465,0.9848484848484848
2022,SAOUDA,CITRUS VOLKAMERIANA,23020,IMG-00024-45.jpg,47,50,47,3,0,0.94,1.0
2022,SAOUDA,CITRUS VOLKAMERIANA,23020,IMG-00032-45.jpg,33,34,33,1,0,0.9705882352941176,1.0
2022,SAOUDA,CITRUS VOLKAMERIANA,23020,IMG-00074-45.jpg,28,31,28,3,0,0.9032258064516128,1.0
2022,SAOUDA,CITRUS VOLKAMERIANA,23020,IMG-00079-45.jpg,28,29,28,1,0,0.9655172413793104,1.0
2022,SAOUDA,CITRUS VOLKAMERIANA,23030,IMG-00014-45.jpg,25,27,25,2,0,0.925925925925926,1.0
2022,SAOUDA,CITRUS VOLKAMERIANA,23030,IMG-00034-45.jpg,43,44,41,3,2,0.9318181818181818,0.9534883720930232
2022,SAOUDA,CITRUS VOLKAMERIANA,23030,IMG-00069-45.jpg,28,30,27,3,1,0.9,0.9642857142857144
2022,SAOUDA,CITRUS VOLKAMERIANA,23030,IMG-00079-45.jpg,50,57,49,8,1,0.8596491228070176,0.98
2022,SAOUDA,CITRANGE CARRIZO,24010,IMG-00097-45.jpg,59,60,58,2,1,0.9666666666666668,0.9830508474576272
2022,SAOUDA,CITRANGE CARRIZO,24010,IMG-00101-45.jpg,27,30,27,3,0,0.9,1.0
2022,SAOUDA,CITRANGE CARRIZO,24010,IMG-00111-45.jpg,54,56,53,3,1,0.9464285714285714,0.9814814814814816
2022,SAOUDA,CITRANGE CARRIZO,24010,IMG-00112-45.jpg,40,42,38,4,2,0.9047619047619048,0.95
2022,SAOUDA,CITRANGE CARRIZO,25010,IMG-00006-45.jpg,55,58,54,4,1,0.9310344827586208,0.9818181818181818
2022,SAOUDA,CITRANGE CARRIZO,25010,IMG-00007-45.jpg,77,81,75,6,2,0.925925925925926,0.974025974025974
2022,SAOUDA,CITRANGE CARRIZO,25010,IMG-00010-45.jpg,53,53,52,1,1,0.981132075471698,0.981132075471698
2022,SAOUDA,CITRANGE CARRIZO,25010,IMG-00011-45.jpg,26,26,26,0,0,1.0,1.0
2022,SAOUDA,CITRANGE CARRIZO,26010,IMG-00008-45.jpg,39,39,39,0,0,1.0,1.0
2022,SAOUDA,CITRANGE CARRIZO,26010,IMG-00013-45.jpg,36,37,36,1,0,0.972972972972973,1.0
2022,SAOUDA,CITRANGE CARRIZO,26010,IMG-00018-45.jpg,43,46,43,3,0,0.9347826086956522,1.0
2022,SAOUDA,CITRANGE CARRIZO,26010,IMG-00020-45.jpg,44,44,43,1,1,0.9772727272727272,0.9772727272727272
2022,KHOUALKA,CITRANGE CARRIZO,30138,IMG-00002-40.jpg,39,42,39,3,0,0.9285714285714286,1.0
2022,KHOUALKA,CITRANGE CARRIZO,30138,IMG-00003-40.jpg,59,58,56,2,3,0.9655172413793104,0.9491525423728814
2022,KHOUALKA,CITRANGE CARRIZO,30138,IMG-00005-40.jpg,58,59,57,2,1,0.9661016949152542,0.9827586206896552
2022,KHOUALKA,CITRANGE CARRIZO,30138,IMG-00008-40.jpg,32,32,31,1,1,0.96875,0.96875
2022,KHOUALKA,CITRANGE CARRIZO,30138,IMG-00011-40.jpg,26,25,25,0,1,1.0,0.9615384615384616
2022,KHOUALKA,CITRANGE CARRIZO,30138,IMG-00019-40.jpg,2,0,0,0,2,0.0,0.0
2022,KHOUALKA,CITRANGE CARRIZO,30138,IMG-00037-40.jpg,30,30,29,1,1,0.9666666666666668,0.9666666666666668
2022,KHOUALKA,CITRANGE CARRIZO,30138,IMG-00040-40.jpg,41,40,40,0,1,1.0,0.975609756097561
2022,KHOUALKA,CITRANGE CARRIZO,30138,IMG-00043-40.jpg,28,31,27,4,1,0.8709677419354839,0.9642857142857144
2022,KHOUALKA,CITRANGE CARRIZO,30138,IMG-00044-40.jpg,99,99,98,1,1,0.98989898989899,0.98989898989899
2022,KHOUALKA,CITRANGE CARRIZO,30138,IMG-00048-40.jpg,37,36,33,3,4,0.9166666666666666,0.8918918918918919
2022,KHOUALKA,CITRANGE CARRIZO,30138,IMG-00057-40.jpg,73,75,72,3,1,0.96,0.9863013698630136
2022,KHOUALKA,CITRANGE CARRIZO,30138,IMG-00063-40.jpg,89,85,82,3,7,0.9647058823529412,0.9213483146067416
2022,ONAGRI,CITRUS VOLKAMERIANA,30145,IMG-00018-39.jpg,219,202,194,8,25,0.9603960396039604,0.8858447488584474
2022,ONAGRI,CITRUS VOLKAMERIANA,30145,IMG-00043-39.jpg,64,67,62,5,2,0.9253731343283582,0.96875
2022,ONAGRI,CITRUS VOLKAMERIANA,30146,IMG-00008-39.jpg,262,248,240,8,22,0.967741935483871,0.916030534351145
2022,ONAGRI,CITRUS VOLKAMERIANA,30146,IMG-00045-39.jpg,190,196,181,15,9,0.923469387755102,0.9526315789473684
2022,ONAGRI,CITRUS VOLKAMERIANA,30147,IMG-00002-39.jpg,269,259,249,10,20,0.9613899613899614,0.9256505576208178
2022,ONAGRI,CITRUS VOLKAMERIANA,30147,IMG-00008-39.jpg,172,166,160,6,12,0.963855421686747,0.9302325581395348
2022,ONAGRI,CITRUS VOLKAMERIANA,30148,IMG-00016-40.jpg,88,89,85,4,3,0.9550561797752808,0.9659090909090908
2022,ONAGRI,CITRUS VOLKAMERIANA,30148,IMG-00047-40.jpg,34,31,31,0,3,1.0,0.9117647058823528
2022,ONAGRI,CITRUS VOLKAMERIANA,30149,IMG-00018-39.jpg,151,140,138,2,13,0.9857142857142858,0.913907284768212
2022,ONAGRI,CITRUS VOLKAMERIANA,30149,IMG-00027-39.jpg,226,201,199,2,27,0.9900497512437813,0.8805309734513275
2022,ONAGRI,CITRUS VOLKAMERIANA,30151,IMG-00012-39.jpg,185,165,160,5,25,0.9696969696969696,0.8648648648648649
2022,ONAGRI,CITRUS VOLKAMERIANA,30151,IMG-00033-39.jpg,214,204,197,7,17,0.965686274509804,0.9205607476635514
2024,ONAGRI,CITRUS VOLKAMERIANA,30151,IMG-21881.jpg,73,50,49,1,24,0.98,0.6712328767123288
2024,ONAGRI,CITRUS VOLKAMERIANA,30151,IMG-21935.jpg,179,144,140,4,39,0.9722222222222222,0.7821229050279329
2024,ONAGRI,CITRUS VOLKAMERIANA,30151,IMG-21936.jpg,93,73,73,0,20,1.0,0.7849462365591398
2022,ONAGRI,CITRUS VOLKAMERIANA,30152,IMG-00016-39.jpg,39,38,36,2,3,0.9473684210526316,0.9230769230769232
2022,ONAGRI,CITRUS VOLKAMERIANA,30152,IMG-00019-39.jpg,139,118,113,5,26,0.9576271186440678,0.8129496402877698
2022,ONAGRI,CITRUS VOLKAMERIANA,30153,IMG-00001.jpg,157,135,130,5,27,0.9629629629629628,0.8280254777070064
2022,ONAGRI,CITRUS VOLKAMERIANA,30153,IMG-00007-39.jpg,127,120,115,5,12,0.9583333333333334,0.905511811023622
2022,ONAGRI,CITRUS VOLKAMERIANA,30153,IMG-00013-39.jpg,159,150,147,3,12,0.98,0.9245283018867924
2022,ONAGRI,CITRUS VOLKAMERIANA,30153,IMG-00040-39.jpg,153,137,131,6,22,0.9562043795620438,0.8562091503267973
2022,ONAGRI,CITRUS VOLKAMERIANA,30154,IMG-00017-39.jpg,160,158,152,6,8,0.9620253164556962,0.95
2022,ONAGRI,CITRUS VOLKAMERIANA,30154,IMG-00027-39.jpg,220,217,206,11,14,0.9493087557603688,0.9363636363636364
2022,ONAGRI,CITRUS VOLKAMERIANA,30154,IMG-00033-39.jpg,51,52,48,4,3,0.9230769230769232,0.9411764705882352
2022,ONAGRI,CITRUS VOLKAMERIANA,30154,IMG-00036-39.jpg,137,141,135,6,2,0.9574468085106383,0.9854014598540146
2022,ONAGRI,CITRUS VOLKAMERIANA,30154,IMG-00038-39.jpg,242,247,237,10,5,0.9595141700404858,0.9793388429752066
2022,ONAGRI,CITRUS VOLKAMERIANA,30154,IMG-00041-39.jpg,272,261,254,7,18,0.9731800766283524,0.9338235294117648
2022,ONAGRI,CITRUS VOLKAMERIANA,30154,IMG-00044-39.jpg,141,144,132,12,9,0.9166666666666666,0.9361702127659576
2022,ONAGRI,BIGARADIER,30155,IMG-00002-39.jpg,139,144,136,8,3,0.9444444444444444,0.9784172661870504
2022,ONAGRI,BIGARADIER,30155,IMG-00003-39.jpg,115,108,106,2,9,0.9814814814814816,0.9217391304347826
2022,ONAGRI,BIGARADIER,30155,IMG-00006-39.jpg,44,43,38,5,6,0.8837209302325582,0.8636363636363636
2022,ONAGRI,BIGARADIER,30155,IMG-00011-39.jpg,100,93,92,1,8,0.989247311827957,0.92
2022,ONAGRI,BIGARADIER,30155,IMG-00019-39.jpg,142,135,132,3,10,0.9777777777777776,0.9295774647887324
2022,ONAGRI,BIGARADIER,30155,IMG-00026-39.jpg,124,119,114,5,10,0.957983193277311,0.9193548387096774
2022,ONAGRI,BIGARADIER,30155,IMG-00032-39.jpg,81,73,69,4,12,0.9452054794520548,0.8518518518518519
2022,ONAGRI,BIGARADIER,30155,IMG-00039-39.jpg,19,19,17,2,2,0.8947368421052632,0.8947368421052632
2022,ONAGRI,BIGARADIER,30155,IMG-00043-39.jpg,130,134,125,9,5,0.9328358208955224,0.9615384615384616
2022,ONAGRI,CITRUS VOLKAMERIANA,30157,IMG-00003-39.jpg,227,218,217,1,10,0.9954128440366972,0.9559471365638766
2022,ONAGRI,CITRUS VOLKAMERIANA,30157,IMG-00012-39.jpg,283,282,269,13,14,0.953900709219858,0.950530035335689
2022,ONAGRI,CITRUS VOLKAMERIANA,30157,IMG-00032-39.jpg,64,68,62,6,2,0.9117647058823528,0.96875
2022,ONAGRI,CITRUS VOLKAMERIANA,30157,IMG-00035-39.jpg,159,152,145,7,14,0.9539473684210528,0.9119496855345912
2022,KHOUALKA,CITRUS VOLKAMERIANA,30235,IMG-00001.jpg,93,92,92,0,1,1.0,0.989247311827957
2022,KHOUALKA,CITRUS VOLKAMERIANA,30235,IMG-00003-40.jpg,37,40,37,3,0,0.925,1.0
2022,KHOUALKA,CITRUS VOLKAMERIANA,30235,IMG-00009-40.jpg,103,102,101,1,2,0.9901960784313726,0.9805825242718448
2022,KHOUALKA,CITRUS VOLKAMERIANA,30235,IMG-00013-40.jpg,90,93,89,4,1,0.956989247311828,0.9888888888888888
2022,KHOUALKA,CITRUS VOLKAMERIANA,30235,IMG-00026-40.jpg,122,128,121,7,1,0.9453125,0.9918032786885246
2022,KHOUALKA,CITRUS VOLKAMERIANA,30235,IMG-00047-40.jpg,47,51,45,6,2,0.8823529411764706,0.9574468085106383
2022,KHOUALKA,CITRUS VOLKAMERIANA,30235,IMG-00048-40.jpg,90,93,89,4,1,0.956989247311828,0.9888888888888888
2022,KHOUALKA,CITRUS VOLKAMERIANA,30235,IMG-00049-40.jpg,44,44,42,2,2,0.9545454545454546,0.9545454545454546
2022,KHOUALKA,CITRUS VOLKAMERIANA,30235,IMG-00050-40.jpg,84,85,81,4,3,0.9529411764705882,0.9642857142857144
2022,KHOUALKA,CITRUS VOLKAMERIANA,30235,IMG-00052-40.jpg,98,101,98,3,0,0.9702970297029704,1.0
2022,KHOUALKA,CITRUS VOLKAMERIANA,30235,IMG-00057-40.jpg,80,75,73,2,7,0.9733333333333334,0.9125
2022,KHOUALKA,CITRUS VOLKAMERIANA,30235,IMG-00064-40.jpg,38,35,34,1,4,0.9714285714285714,0.8947368421052632
2022,KHOUALKA,CITRUS VOLKAMERIANA,30235,IMG-00067-40.jpg,107,106,104,2,3,0.981132075471698,0.97196261682243
2022,KHOUALKA,CITRUS VOLKAMERIANA,30235,IMG-00069-40.jpg,34,37,32,5,2,0.8648648648648649,0.9411764705882352
2022,KHOUALKA,CITRUS VOLKAMERIANA,30235,IMG-00075-40.jpg,95,99,94,5,1,0.9494949494949496,0.9894736842105264
2022,KHOUALKA,BIGARADIER,40141,IMG-00006-40.jpg,7,6,6,0,1,1.0,0.8571428571428571
2022,KHOUALKA,BIGARADIER,40141,IMG-00007-40.jpg,20,14,14,0,6,1.0,0.7
2022,KHOUALKA,BIGARADIER,40141,IMG-00008-40.jpg,15,13,11,2,4,0.8461538461538461,0.7333333333333333
2022,ONAGRI,CITRANGE C35,40166,IMG-00009-39.jpg,38,39,37,2,1,0.9487179487179488,0.9736842105263158
2022,ONAGRI,CITRANGE C35,40166,IMG-00011-39.jpg,173,177,169,8,4,0.9548022598870056,0.976878612716763
2022,ONAGRI,CITRANGE C35,40166,IMG-00014-39.jpg,179,178,170,8,9,0.9550561797752808,0.9497206703910616
2022,ONAGRI,CITRANGE C35,40166,IMG-00015-39.jpg,122,122,118,4,4,0.9672131147540984,0.9672131147540984
2022,ONAGRI,CITRANGE C35,40166,IMG-00041-39.jpg,102,100,100,0,2,1.0,0.9803921568627452
2022,ONAGRI,CITRANGE C35,40167,IMG-00019-39.jpg,197,198,195,3,2,0.9848484848484848,0.9898477157360406
2022,ONAGRI,CITRANGE C35,40167,IMG-00030-39.jpg,126,123,122,1,4,0.991869918699187,0.9682539682539684
2022,ONAGRI,CITRANGE C35,40167,IMG-00039-39.jpg,217,207,203,4,14,0.9806763285024156,0.935483870967742
2022,ONAGRI,CITRANGE C35,40171,IMG-00008-39.jpg,109,100,98,2,11,0.98,0.8990825688073395
2022,ONAGRI,CITRANGE C35,40171,IMG-00037-39.jpg,94,88,85,3,9,0.9659090909090908,0.9042553191489362
2022,ONAGRI,CITRANGE C35,40171,IMG-00040-39.jpg,149,141,137,4,12,0.9716312056737588,0.9194630872483222
2022,ONAGRI,CITRANGE C35,40172,IMG-00012-39.jpg,89,80,79,1,10,0.9875,0.8876404494382022
2022,ONAGRI,CITRANGE C35,40172,IMG-00025-39.jpg,109,105,102,3,7,0.9714285714285714,0.9357798165137616
2022,ONAGRI,CITRANGE C35,40172,IMG-00027-39.jpg,103,93,91,2,12,0.978494623655914,0.883495145631068
2022,ONAGRI,CITRANGE C35,40173,IMG-00004-39.jpg,133,123,122,1,11,0.991869918699187,0.9172932330827068
2022,ONAGRI,CITRANGE C35,40173,IMG-00008-39.jpg,57,46,46,0,11,1.0,0.8070175438596491
2022,ONAGRI,CITRANGE C35,40173,IMG-00010-39.jpg,53,55,49,6,4,0.8909090909090909,0.9245283018867924
2022,ONAGRI,CITRANGE C35,40175,IMG-00005-39.jpg,95,82,81,1,14,0.9878048780487804,0.8526315789473684
2022,ONAGRI,CITRANGE C35,40175,IMG-00006-39.jpg,64,63,61,2,3,0.9682539682539684,0.953125
2022,ONAGRI,CITRANGE C35,40176,IMG-00004-39.jpg,79,78,71,7,8,0.9102564102564102,0.8987341772151899
2022,ONAGRI,CITRANGE C35,40176,IMG-00012-39.jpg,105,107,104,3,1,0.97196261682243,0.9904761904761904
2022,ONAGRI,CITRANGE C35,40176,IMG-00014-39.jpg,91,93,84,9,7,0.9032258064516128,0.9230769230769232
2022,ONAGRI,CITRUMELO SACCATON,40177,IMG-00012-39.jpg,89,91,84,7,5,0.9230769230769232,0.9438202247191012
2022,ONAGRI,CITRUMELO SACCATON,40177,IMG-00015-39.jpg,213,218,210,8,3,0.963302752293578,0.9859154929577464
2022,ONAGRI,CITRUMELO SACCATON,40177,IMG-00037-39.jpg,95,94,87,7,8,0.925531914893617,0.9157894736842104
2022,ONAGRI,CITRANGE C35,40178,IMG-00013-39.jpg,76,77,76,1,0,0.987012987012987,1.0
2022,ONAGRI,CITRANGE C35,40178,IMG-00027-39.jpg,56,59,56,3,0,0.9491525423728814,1.0
2022,ONAGRI,CITRANGE C35,40178,IMG-00031-39.jpg,30,30,30,0,0,1.0,1.0
2022,ONAGRI,CITRANGE C35,40178,IMG-00032-39.jpg,27,27,27,0,0,1.0,1.0
2022,ONAGRI,CITRANGE C35,40178,IMG-00033-39.jpg,34,36,33,3,1,0.9166666666666666,0.9705882352941176
2022,ONAGRI,CITRANGE C35,40179,IMG-00001.jpg,83,84,77,7,6,0.9166666666666666,0.927710843373494
2022,ONAGRI,CITRANGE C35,40179,IMG-00010-39.jpg,161,156,154,2,7,0.9871794871794872,0.9565217391304348
2022,ONAGRI,CITRANGE C35,40179,IMG-00011-39.jpg,102,100,100,0,2,1.0,0.9803921568627452
2022,ONAGRI,CITRANGE C35,40179,IMG-00018-39.jpg,9,9,8,1,1,0.8888888888888888,0.8888888888888888
2022,ONAGRI,CITRUMELO SACCATON,40182,IMG-00004-39.jpg,35,37,35,2,0,0.945945945945946,1.0
2022,ONAGRI,CITRUMELO SACCATON,40182,IMG-00010-39.jpg,52,51,49,2,3,0.9607843137254902,0.9423076923076924
2022,ONAGRI,CITRUMELO SACCATON,40182,IMG-00015-39.jpg,85,84,79,5,6,0.9404761904761904,0.9294117647058824
2022,ONAGRI,CITRUMELO SACCATON,40183,IMG-00005-39.jpg,68,68,67,1,1,0.9852941176470588,0.9852941176470588
2022,ONAGRI,CITRUMELO SACCATON,40183,IMG-00009-39.jpg,57,58,55,3,2,0.9482758620689656,0.9649122807017544
2022,ONAGRI,CITRUMELO SACCATON,40183,IMG-00010-39.jpg,48,46,43,3,5,0.9347826086956522,0.8958333333333334
2024,KHOUALKA,CITRUS VOLKAMERIANA,50152,IMG-17274.jpg,170,121,120,1,50,0.9917355371900828,0.7058823529411765
2024,KHOUALKA,CITRUS VOLKAMERIANA,50152,IMG-17306.jpg,105,86,86,0,19,1.0,0.819047619047619
2024,KHOUALKA,CITRUS VOLKAMERIANA,50152,IMG-17330.jpg,41,30,30,0,11,1.0,0.7317073170731707
2024,KHOUALKA,CITRUS VOLKAMERIANA,50152,IMG-17335.jpg,44,35,35,0,9,1.0,0.7954545454545454
2024,KHOUALKA,CITRUS VOLKAMERIANA,50152,IMG-17340.jpg,108,76,75,1,33,0.986842105263158,0.6944444444444444
2024,KHOUALKA,CITRUS VOLKAMERIANA,50152,IMG-17356.jpg,60,45,42,3,18,0.9333333333333332,0.7
2024,KHOUALKA,CITRUS VOLKAMERIANA,50152,IMG-17384.jpg,53,31,31,0,22,1.0,0.5849056603773585
2024,KHOUALKA,CITRUS VOLKAMERIANA,50154,IMG-17440.jpg,76,59,59,0,17,1.0,0.7763157894736842
2024,KHOUALKA,CITRUS VOLKAMERIANA,50154,IMG-17490.jpg,107,69,68,1,39,0.9855072463768116,0.6355140186915887
2024,KHOUALKA,CITRUS VOLKAMERIANA,50154,IMG-17543.jpg,100,69,69,0,31,1.0,0.69
2024,KHOUALKA,CITRUS VOLKAMERIANA,50154,IMG-17545.jpg,94,67,66,1,28,0.9850746268656716,0.7021276595744681
2024,KHOUALKA,CITRUS VOLKAMERIANA,50154,IMG-17562.jpg,129,106,105,1,24,0.9905660377358492,0.813953488372093
2024,KHOUALKA,CITRUS VOLKAMERIANA,50154,IMG-17576.jpg,121,100,99,1,22,0.99,0.8181818181818182
2024,KHOUALKA,CITRUS VOLKAMERIANA,50154,IMG-17585.jpg,171,128,127,1,44,0.9921875,0.7426900584795322
2024,KHOUALKA,CITRUS VOLKAMERIANA,50168,IMG-13980.jpg,174,127,126,1,48,0.9921259842519684,0.7241379310344828
2024,KHOUALKA,CITRUS VOLKAMERIANA,50168,IMG-15749.jpg,147,116,116,0,31,1.0,0.7891156462585034
2024,KHOUALKA,CITRUS VOLKAMERIANA,50168,IMG-15758.jpg,163,128,126,2,37,0.984375,0.7730061349693251
2024,KHOUALKA,CITRUS VOLKAMERIANA,50168,IMG-15981.jpg,210,156,156,0,54,1.0,0.7428571428571429
2024,KHOUALKA,CITRUS VOLKAMERIANA,50168,IMG-15983.jpg,120,87,87,0,33,1.0,0.725
2024,KHOUALKA,CITRUS VOLKAMERIANA,50176,IMG-16025.jpg,81,62,62,0,19,1.0,0.7654320987654321
2024,KHOUALKA,CITRUS VOLKAMERIANA,50176,IMG-16051.jpg,85,62,62,0,23,1.0,0.7294117647058823
2024,KHOUALKA,CITRUS VOLKAMERIANA,50176,IMG-16079.jpg,161,114,114,0,47,1.0,0.7080745341614907
2024,KHOUALKA,CITRUS VOLKAMERIANA,50176,IMG-16095.jpg,101,63,63,0,38,1.0,0.6237623762376238
2024,KHOUALKA,CITRUS VOLKAMERIANA,50176,IMG-16105.jpg,43,28,28,0,15,1.0,0.6511627906976745
2022,ONAGRI,CITRUMELO SACCATON,50193,IMG-00007-39.jpg,218,217,216,1,2,0.9953917050691244,0.9908256880733946
2022,ONAGRI,CITRUMELO SACCATON,50193,IMG-00016-39.jpg,64,65,60,5,4,0.9230769230769232,0.9375
2022,ONAGRI,CITRUMELO SACCATON,50193,IMG-00018-39.jpg,115,119,115,4,0,0.9663865546218487,1.0
2022,ONAGRI,CITRUMELO SACCATON,50193,IMG-00021-39.jpg,62,63,60,3,2,0.9523809523809524,0.967741935483871
2022,ONAGRI,CITRUMELO SACCATON,50193,IMG-00023-39.jpg,113,115,111,4,2,0.9652173913043478,0.9823008849557522
2022,ONAGRI,CITRUMELO SACCATON,50194,IMG-00032-39.jpg,162,165,159,6,3,0.9636363636363636,0.9814814814814816
2022,ONAGRI,CITRUMELO SACCATON,50194,IMG-00034-39.jpg,105,109,104,5,1,0.9541284403669724,0.9904761904761904
2022,ONAGRI,CITRUMELO SACCATON,50194,IMG-00036-39.jpg,161,172,152,20,9,0.8837209302325582,0.9440993788819876
2022,ONAGRI,CITRUMELO SACCATON,50194,IMG-00038-39.jpg,100,101,98,3,2,0.9702970297029704,0.98
2022,ONAGRI,CITRUMELO SACCATON,50194,IMG-00039-39.jpg,65,64,64,0,1,1.0,0.9846153846153848
2022,ONAGRI,CITRUMELO SACCATON,50194,IMG-00041-39.jpg,153,153,146,7,7,0.954248366013072,0.954248366013072
2022,ONAGRI,CITRUMELO SACCATON,50194,IMG-00051-39.jpg,137,135,130,5,7,0.9629629629629628,0.948905109489051
2022,ONAGRI,CITRUMELO SACCATON,50194,IMG-00054-39.jpg,111,108,103,5,8,0.9537037037037036,0.927927927927928
2022,ONAGRI,CITRUMELO SACCATON,51091,IMG-00015-39.jpg,85,88,84,4,1,0.9545454545454546,0.9882352941176472
2022,ONAGRI,CITRUMELO SACCATON,51091,IMG-00016-39.jpg,170,174,168,6,2,0.9655172413793104,0.9882352941176472
2022,ONAGRI,CITRUMELO SACCATON,51091,IMG-00018-39.jpg,185,197,183,14,2,0.9289340101522844,0.9891891891891892
2022,ONAGRI,CITRUMELO SACCATON,51091,IMG-00022-39.jpg,135,143,134,9,1,0.9370629370629372,0.9925925925925926
2022,ONAGRI,CITRUMELO SACCATON,51091,IMG-00023-39.jpg,140,137,136,1,4,0.9927007299270072,0.9714285714285714
2022,ONAGRI,CITRUMELO SACCATON,51091,IMG-00026-39.jpg,149,143,140,3,9,0.9790209790209792,0.9395973154362416
2022,ONAGRI,CITRUMELO SACCATON,51091,IMG-00044-39.jpg,168,173,165,8,3,0.953757225433526,0.9821428571428572
2022,ONAGRI,CITRUMELO SACCATON,51095,IMG-00004-39.jpg,201,205,194,11,7,0.946341463414634,0.965174129353234
2022,ONAGRI,CITRUMELO SACCATON,51095,IMG-00013-39.jpg,154,149,145,4,9,0.9731543624161074,0.9415584415584416
2022,ONAGRI,CITRUMELO SACCATON,51095,IMG-00014-39.jpg,140,140,134,6,6,0.9571428571428572,0.9571428571428572
2022,ONAGRI,CITRUMELO SACCATON,51095,IMG-00015-39.jpg,196,193,187,6,9,0.9689119170984456,0.9540816326530612
2022,ONAGRI,CITRUMELO SACCATON,51095,IMG-00024-39.jpg,234,235,230,5,4,0.9787234042553192,0.9829059829059827
2022,ONAGRI,CITRUMELO SACCATON,51095,IMG-00025-39.jpg,198,201,190,11,8,0.945273631840796,0.9595959595959596
2022,ONAGRI,CITRUMELO SACCATON,51096,IMG-00009-39.jpg,219,218,212,6,7,0.9724770642201837,0.9680365296803652
2022,ONAGRI,CITRUMELO SACCATON,51096,IMG-00011-39.jpg,145,152,139,13,6,0.9144736842105264,0.9586206896551724
2022,ONAGRI,CITRUMELO SACCATON,51096,IMG-00012-39.jpg,114,107,103,4,11,0.9626168224299064,0.9035087719298246
2022,ONAGRI,CITRUMELO SACCATON,51096,IMG-00055-39.jpg,217,208,197,11,20,0.9471153846153846,0.9078341013824884
2022,ONAGRI,MC PONSIRUCE TRIFOLIATA,51097,IMG-00025-39.jpg,121,125,117,8,4,0.936,0.9669421487603306
2022,ONAGRI,MC PONSIRUCE TRIFOLIATA,51097,IMG-00029-39.jpg,106,113,104,9,2,0.9203539823008848,0.981132075471698
2022,ONAGRI,MC PONSIRUCE TRIFOLIATA,51097,IMG-00044-39.jpg,182,185,177,8,5,0.9567567567567568,0.9725274725274724
2022,ONAGRI,MC PONSIRUCE TRIFOLIATA,51098,IMG-00003-39.jpg,65,72,63,9,2,0.875,0.9692307692307692
2022,ONAGRI,MC PONSIRUCE TRIFOLIATA,51098,IMG-00010-39.jpg,184,184,176,8,8,0.9565217391304348,0.9565217391304348
2022,ONAGRI,MC PONSIRUCE TRIFOLIATA,51098,IMG-00015-39.jpg,162,166,160,6,2,0.963855421686747,0.9876543209876544
2022,ONAGRI,MC PONSIRUCE TRIFOLIATA,51099,IMG-00012-39.jpg,133,139,128,11,5,0.920863309352518,0.962406015037594
2024,ONAGRI,MC PONSIRUCE TRIFOLIATA,51101,IMG-12118.jpg,177,132,131,1,46,0.9924242424242424,0.7401129943502824
2024,ONAGRI,MC PONSIRUCE TRIFOLIATA,51101,IMG-14223.jpg,153,109,109,0,44,1.0,0.7124183006535948
2024,ONAGRI,MC PONSIRUCE TRIFOLIATA,51101,IMG-14226.jpg,151,113,112,1,39,0.991150442477876,0.7417218543046358
2024,ONAGRI,MC PONSIRUCE TRIFOLIATA,51101,IMG-14255.jpg,189,149,149,0,40,1.0,0.7883597883597884
2024,ONAGRI,MC PONSIRUCE TRIFOLIATA,51101,IMG-14281.jpg,150,111,111,0,39,1.0,0.74
2022,ONAGRI,CITRUS VOLKAMERIANA,101020,IMG-00001.jpg,6,7,6,1,0,0.8571428571428571,1.0
2022,ONAGRI,CITRUS VOLKAMERIANA,101020,IMG-00004-44.jpg,53,53,51,2,2,0.9622641509433962,0.9622641509433962
2022,ONAGRI,CITRUS VOLKAMERIANA,101030,IMG-00003-44.jpg,29,28,28,0,1,1.0,0.9655172413793104
2022,ONAGRI,CITRUS VOLKAMERIANA,101030,IMG-00004-44.jpg,110,103,101,2,9,0.9805825242718448,0.9181818181818182
2022,ONAGRI,CITRUS VOLKAMERIANA,101030,IMG-00005-44.jpg,134,124,121,3,13,0.9758064516129032,0.9029850746268656
2022,ONAGRI,CITRUS VOLKAMERIANA,101030,IMG-00017-44.jpg,79,71,69,2,10,0.971830985915493,0.8734177215189873
2022,ONAGRI,CITRUS VOLKAMERIANA,101040,IMG-00005-44.jpg,172,154,154,0,18,1.0,0.8953488372093024
2022,ONAGRI,CITRUS VOLKAMERIANA,101040,IMG-00009-44.jpg,131,135,129,6,2,0.9555555555555556,0.9847328244274808
2022,ONAGRI,CITRUS VOLKAMERIANA,101040,IMG-00011-44.jpg,64,64,59,5,5,0.921875,0.921875
2022,ONAGRI,CITRUS VOLKAMERIANA,101040,IMG-00012-44.jpg,139,133,129,4,10,0.9699248120300752,0.9280575539568344
2022,ONAGRI,CITRUS VOLKAMERIANA,101050,IMG-00002-44.jpg,95,89,87,2,8,0.9775280898876404,0.9157894736842104
2022,ONAGRI,CITRUS VOLKAMERIANA,101050,IMG-00005-44.jpg,59,58,57,1,2,0.9827586206896552,0.9661016949152542
2022,ONAGRI,CITRUS VOLKAMERIANA,101050,IMG-00011-44.jpg,46,43,43,0,3,1.0,0.9347826086956522
2022,ONAGRI,CITRUS VOLKAMERIANA,101050,IMG-00024-44.jpg,40,41,40,1,0,0.975609756097561,1.0
2022,ONAGRI,CITRUS VOLKAMERIANA,101080,IMG-00005-44.jpg,42,40,38,2,4,0.95,0.9047619047619048
2022,ONAGRI,CITRUS VOLKAMERIANA,101080,IMG-00006-44.jpg,79,68,66,2,13,0.9705882352941176,0.8354430379746836
2022,ONAGRI,CITRUS VOLKAMERIANA,101080,IMG-00023-44.jpg,7,7,7,0,0,1.0,1.0
2022,ONAGRI,CITRUS VOLKAMERIANA,101080,IMG-00024-44.jpg,27,24,23,1,4,0.9583333333333334,0.8518518518518519
2022,ONAGRI,CITRUS VOLKAMERIANA,101090,IMG-00003-44.jpg,66,60,60,0,6,1.0,0.9090909090909092
2022,ONAGRI,CITRUS VOLKAMERIANA,101090,IMG-00006-44.jpg,41,36,36,0,5,1.0,0.8780487804878049
2022,ONAGRI,CITRUS VOLKAMERIANA,101090,IMG-00019-44.jpg,35,36,35,1,0,0.9722222222222222,1.0
2022,ONAGRI,CITRUS VOLKAMERIANA,101090,IMG-00020-44.jpg,42,42,40,2,2,0.9523809523809524,0.9523809523809524
2022,KHOUALKA,CITRANGE CARRIZO,102130,IMG-00001.jpg,5,3,3,0,2,1.0,0.6
2022,KHOUALKA,CITRANGE CARRIZO,102130,IMG-00004-43.jpg,24,16,16,0,8,1.0,0.6666666666666666
2022,KHOUALKA,CITRANGE CARRIZO,102130,IMG-00019-43.jpg,33,34,31,3,2,0.9117647058823528,0.9393939393939394
2022,KHOUALKA,CITRANGE CARRIZO,102130,IMG-00020-43.jpg,18,25,17,8,1,0.68,0.9444444444444444
2022,KHOUALKA,MACROPHYLLA,201180,IMG-00007-43.jpg,38,43,38,5,0,0.8837209302325582,1.0
2022,KHOUALKA,MACROPHYLLA,201180,IMG-00011-43.jpg,64,63,58,5,6,0.9206349206349206,0.90625
2022,KHOUALKA,MACROPHYLLA,201180,IMG-00019-43.jpg,64,63,60,3,4,0.9523809523809524,0.9375
2022,KHOUALKA,MACROPHYLLA,201180,IMG-00020-43.jpg,43,41,39,2,4,0.951219512195122,0.9069767441860463
2022,KHOUALKA,MACROPHYLLA,201190,IMG-00004-43.jpg,101,90,89,1,12,0.9888888888888888,0.8811881188118812
2022,KHOUALKA,MACROPHYLLA,201190,IMG-00010-43.jpg,90,83,80,3,10,0.963855421686747,0.8888888888888888
2022,KHOUALKA,MACROPHYLLA,201190,IMG-00011-43.jpg,134,121,117,4,17,0.9669421487603306,0.8731343283582089
2022,KHOUALKA,MACROPHYLLA,201190,IMG-00020-43.jpg,95,83,83,0,12,1.0,0.8736842105263158
2022,KHOUALKA,CITRUS VOLKAMERIANA,201210,IMG-00011-43.jpg,103,102,101,1,2,0.9901960784313726,0.9805825242718448
2022,KHOUALKA,CITRUS VOLKAMERIANA,201210,IMG-00012-43.jpg,42,39,39,0,3,1.0,0.9285714285714286
2022,KHOUALKA,CITRUS VOLKAMERIANA,201210,IMG-00015-43.jpg,77,71,71,0,6,1.0,0.922077922077922
2022,KHOUALKA,CITRUS VOLKAMERIANA,201210,IMG-00019-43.jpg,31,30,30,0,1,1.0,0.967741935483871
2022,KHOUALKA,BIGARADIER,201320,IMG-00006-43.jpg,87,74,71,3,16,0.9594594594594594,0.8160919540229885
2022,KHOUALKA,BIGARADIER,201320,IMG-00016-43.jpg,97,95,91,4,6,0.9578947368421052,0.9381443298969072
2022,KHOUALKA,BIGARADIER,201320,IMG-00017-43.jpg,49,45,44,1,5,0.9777777777777776,0.8979591836734694
2022,KHOUALKA,BIGARADIER,201320,IMG-00020-43.jpg,88,87,87,0,1,1.0,0.9886363636363636
2022,ONAGRI,BIGARADIER,201390,IMG-00008-44.jpg,62,61,58,3,4,0.9508196721311476,0.935483870967742
2022,ONAGRI,BIGARADIER,201390,IMG-00011-44.jpg,90,87,85,2,5,0.9770114942528736,0.9444444444444444
2022,ONAGRI,BIGARADIER,201390,IMG-00013-44.jpg,77,63,59,4,18,0.9365079365079364,0.7662337662337663
2022,ONAGRI,BIGARADIER,201390,IMG-00016-44.jpg,69,65,63,2,6,0.9692307692307692,0.9130434782608696
2022,KHOUALKA,CITRUS VOLKAMERIANA,202050,IMG-00006-43.jpg,89,87,86,1,3,0.9885057471264368,0.9662921348314608
2022,KHOUALKA,CITRUS VOLKAMERIANA,202050,IMG-00010-43.jpg,94,89,89,0,5,1.0,0.946808510638298
2022,KHOUALKA,CITRUS VOLKAMERIANA,202050,IMG-00011-43.jpg,151,149,145,4,6,0.9731543624161074,0.9602649006622516
2022,KHOUALKA,CITRUS VOLKAMERIANA,202050,IMG-00020-43.jpg,129,116,116,0,13,1.0,0.8992248062015504
2022,KHOUALKA,CITRUS VOLKAMERIANA,202070,IMG-00006-43.jpg,68,70,67,3,1,0.9571428571428572,0.9852941176470588
2022,KHOUALKA,CITRUS VOLKAMERIANA,202070,IMG-00009-43.jpg,120,116,115,1,5,0.9913793103448276,0.9583333333333334
2022,KHOUALKA,CITRUS VOLKAMERIANA,202070,IMG-00013-43.jpg,95,89,87,2,8,0.9775280898876404,0.9157894736842104
2022,KHOUALKA,CITRUS VOLKAMERIANA,202070,IMG-00019-43.jpg,57,56,55,1,2,0.9821428571428572,0.9649122807017544
2022,KHOUALKA,CITRUS VOLKAMERIANA,202080,IMG-00005-43.jpg,65,64,63,1,2,0.984375,0.9692307692307692
2022,KHOUALKA,CITRUS VOLKAMERIANA,202080,IMG-00008-43.jpg,31,33,31,2,0,0.9393939393939394,1.0
2022,KHOUALKA,CITRUS VOLKAMERIANA,202080,IMG-00015-43.jpg,220,216,210,6,10,0.9722222222222222,0.9545454545454546
2022,KHOUALKA,CITRUS VOLKAMERIANA,202080,IMG-00016-43.jpg,131,131,129,2,2,0.9847328244274808,0.9847328244274808
2022,KHOUALKA,CITRANGE CARRIZO,301380,IMG-00007-43.jpg,30,32,27,5,3,0.84375,0.9
2022,KHOUALKA,CITRANGE CARRIZO,301380,IMG-00011-43.jpg,53,55,53,2,0,0.9636363636363636,1.0
2022,KHOUALKA,CITRANGE CARRIZO,301380,IMG-00014-43.jpg,7,7,5,2,2,0.7142857142857143,0.7142857142857143
2022,KHOUALKA,CITRANGE CARRIZO,301380,IMG-00020-43.jpg,91,97,86,11,5,0.8865979381443299,0.945054945054945
2022,ONAGRI,CITRUS VOLKAMERIANA,301470,IMG-00003-44.jpg,148,147,145,2,3,0.9863945578231292,0.9797297297297296
2022,ONAGRI,CITRUS VOLKAMERIANA,301470,IMG-00004-44.jpg,163,159,155,4,8,0.9748427672955976,0.950920245398773
2022,ONAGRI,CITRUS VOLKAMERIANA,301470,IMG-00005-44.jpg,160,148,141,7,19,0.9527027027027029,0.88125
2022,ONAGRI,CITRUS VOLKAMERIANA,301480,IMG-00001.jpg,92,79,79,0,13,1.0,0.8586956521739131
2022,ONAGRI,CITRUS VOLKAMERIANA,301480,IMG-00003-43.jpg,26,24,24,0,2,1.0,0.9230769230769232
2022,ONAGRI,CITRUS VOLKAMERIANA,301480,IMG-00012-43.jpg,50,45,44,1,6,0.9777777777777776,0.88
2022,ONAGRI,CITRUS VOLKAMERIANA,301480,IMG-00014-43.jpg,77,67,67,0,10,1.0,0.8701298701298701
2022,ONAGRI,CITRUS VOLKAMERIANA,301490,IMG-00005-44.jpg,108,94,94,0,14,1.0,0.8703703703703703
2022,ONAGRI,CITRUS VOLKAMERIANA,301490,IMG-00009-44.jpg,185,180,171,9,14,0.95,0.9243243243243244
2022,ONAGRI,CITRUS VOLKAMERIANA,301490,IMG-00012-44.jpg,162,152,148,4,14,0.9736842105263158,0.9135802469135802
2022,ONAGRI,CITRUS VOLKAMERIANA,301490,IMG-00015-44.jpg,109,105,102,3,7,0.9714285714285714,0.9357798165137616
2022,ONAGRI,CITRUS VOLKAMERIANA,301510,IMG-00001.jpg,252,233,230,3,22,0.9871244635193132,0.9126984126984128
2022,ONAGRI,CITRUS VOLKAMERIANA,301510,IMG-00006-44.jpg,137,128,126,2,11,0.984375,0.9197080291970804
2022,ONAGRI,CITRUS VOLKAMERIANA,301510,IMG-00007-44.jpg,115,108,102,6,13,0.9444444444444444,0.8869565217391304
2022,ONAGRI,CITRUS VOLKAMERIANA,301510,IMG-00008-44.jpg,150,135,130,5,20,0.9629629629629628,0.8666666666666667
2022,ONAGRI,BIGARADIER,301550,IMG-00008-44.jpg,144,141,136,5,8,0.9645390070921984,0.9444444444444444
2022,ONAGRI,BIGARADIER,301550,IMG-00011-44.jpg,40,40,38,2,2,0.95,0.95
2022,ONAGRI,BIGARADIER,301550,IMG-00013-44.jpg,76,69,68,1,8,0.9855072463768116,0.8947368421052632
2022,ONAGRI,BIGARADIER,301550,IMG-00014-44.jpg,80,84,78,6,2,0.9285714285714286,0.975
2022,ONAGRI,CITRUS VOLKAMERIANA,301570,IMG-00004-44.jpg,158,150,148,2,10,0.9866666666666668,0.9367088607594936
2022,ONAGRI,CITRUS VOLKAMERIANA,301570,IMG-00007-44.jpg,152,141,135,6,17,0.9574468085106383,0.8881578947368421
2022,ONAGRI,CITRUS VOLKAMERIANA,301570,IMG-00008-44.jpg,103,96,91,5,12,0.9479166666666666,0.883495145631068
2022,ONAGRI,CITRUS VOLKAMERIANA,301570,IMG-00017-44.jpg,218,202,197,5,21,0.9752475247524752,0.9036697247706422
2022,KHOUALKA,CITRUS VOLKAMERIANA,302340,IMG-00004-43.jpg,106,87,87,0,19,1.0,0.8207547169811321
2022,KHOUALKA,CITRUS VOLKAMERIANA,302340,IMG-00005-43.jpg,105,88,87,1,18,0.9886363636363636,0.8285714285714286
2022,KHOUALKA,CITRUS VOLKAMERIANA,302340,IMG-00011-43.jpg,75,70,69,1,6,0.9857142857142858,0.92
2022,KHOUALKA,CITRUS VOLKAMERIANA,302340,IMG-00015-43.jpg,92,84,81,3,11,0.9642857142857144,0.8804347826086957
2022,KHOUALKA,CITRUS VOLKAMERIANA,302350,IMG-00008-43.jpg,33,32,32,0,1,1.0,0.9696969696969696
2022,KHOUALKA,CITRUS VOLKAMERIANA,302350,IMG-00013-43.jpg,80,78,74,4,6,0.9487179487179488,0.925
2022,KHOUALKA,CITRUS VOLKAMERIANA,302350,IMG-00014-43.jpg,76,74,70,4,6,0.945945945945946,0.9210526315789472
2022,KHOUALKA,CITRUS VOLKAMERIANA,302350,IMG-00018-43.jpg,44,46,44,2,0,0.9565217391304348,1.0
2022,KHOUALKA,CITRUS VOLKAMERIANA,302360,IMG-00005-43.jpg,97,93,93,0,4,1.0,0.9587628865979382
2022,KHOUALKA,CITRUS VOLKAMERIANA,302360,IMG-00006-43.jpg,118,111,111,0,7,1.0,0.940677966101695
2022,KHOUALKA,CITRUS VOLKAMERIANA,302360,IMG-00016-43.jpg,67,66,66,0,1,1.0,0.9850746268656716
2022,KHOUALKA,CITRUS VOLKAMERIANA,302360,IMG-00021-43.jpg,65,68,62,6,3,0.9117647058823528,0.953846153846154
2022,KHOUALKA,CITRUS VOLKAMERIANA,302510,IMG-00001.jpg,73,70,69,1,4,0.9857142857142858,0.9452054794520548
2022,KHOUALKA,CITRUS VOLKAMERIANA,302510,IMG-00002-43.jpg,44,44,44,0,0,1.0,1.0
2022,KHOUALKA,CITRUS VOLKAMERIANA,302510,IMG-00003-43.jpg,78,77,77,0,1,1.0,0.9871794871794872
2022,KHOUALKA,CITRUS VOLKAMERIANA,302510,IMG-00015-43.jpg,49,37,37,0,12,1.0,0.7551020408163265
2022,KHOUALKA,BIGARADIER,401410,IMG-00093-43.jpg,35,26,26,0,9,1.0,0.7428571428571429
2022,KHOUALKA,BIGARADIER,401410,IMG-00099-43.jpg,6,5,5,0,1,1.0,0.8333333333333334
2022,KHOUALKA,BIGARADIER,401410,IMG-00102-43.jpg,78,68,68,0,10,1.0,0.8717948717948718
2022,KHOUALKA,BIGARADIER,401410,IMG-00104-43.jpg,81,66,63,3,18,0.9545454545454546,0.7777777777777778
2022,ONAGRI,CITRANGE C35,401660,IMG-00001.jpg,56,59,53,6,3,0.8983050847457628,0.9464285714285714
2022,ONAGRI,CITRANGE C35,401660,IMG-00008-44.jpg,42,40,40,0,2,1.0,0.9523809523809524
2022,ONAGRI,CITRANGE C35,401660,IMG-00010-44.jpg,29,27,27,0,2,1.0,0.9310344827586208
2022,ONAGRI,CITRANGE C35,401660,IMG-00016-44.jpg,64,61,59,2,5,0.9672131147540984,0.921875
2022,ONAGRI,CITRANGE C35,401710,IMG-00003-44.jpg,51,43,43,0,8,1.0,0.8431372549019608
2022,ONAGRI,CITRANGE C35,401710,IMG-00012-44.jpg,19,18,18,0,1,1.0,0.9473684210526316
2022,ONAGRI,CITRANGE C35,401710,IMG-00013-44.jpg,33,29,29,0,4,1.0,0.8787878787878788
2022,ONAGRI,CITRANGE C35,401710,IMG-00019-44.jpg,76,73,73,0,3,1.0,0.9605263157894736
2022,ONAGRI,CITRANGE C35,401720,IMG-00007-44.jpg,93,95,93,2,0,0.9789473684210528,1.0
2022,ONAGRI,CITRANGE C35,401720,IMG-00008-44.jpg,38,39,35,4,3,0.8974358974358975,0.9210526315789472
2022,ONAGRI,CITRANGE C35,401720,IMG-00010-44.jpg,50,47,46,1,4,0.9787234042553192,0.92
2022,ONAGRI,CITRANGE C35,401720,IMG-00017-44.jpg,68,64,62,2,6,0.96875,0.9117647058823528
2022,ONAGRI,CITRANGE C35,401730,IMG-00001.jpg,19,20,19,1,0,0.95,1.0
2022,ONAGRI,CITRANGE C35,401730,IMG-00010-44.jpg,50,49,49,0,1,1.0,0.98
2022,ONAGRI,CITRANGE C35,401730,IMG-00013-44.jpg,75,68,68,0,7,1.0,0.9066666666666666
2022,ONAGRI,CITRANGE C35,401730,IMG-00016-44.jpg,36,34,33,1,3,0.9705882352941176,0.9166666666666666
2022,ONAGRI,CITRANGE C35,401750,IMG-00005-44.jpg,88,75,73,2,15,0.9733333333333334,0.8295454545454546
2022,ONAGRI,CITRANGE C35,401750,IMG-00009-44.jpg,127,107,105,2,22,0.9813084112149532,0.8267716535433071
2022,ONAGRI,CITRANGE C35,401750,IMG-00016-44.jpg,107,92,88,4,19,0.9565217391304348,0.822429906542056
2022,ONAGRI,CITRANGE C35,401750,IMG-00024-44.jpg,50,46,44,2,6,0.9565217391304348,0.88
2022,ONAGRI,CITRUMELO SACCATON,401770,IMG-00003-44.jpg,24,23,22,1,2,0.9565217391304348,0.9166666666666666
2022,ONAGRI,CITRUMELO SACCATON,401770,IMG-00008-44.jpg,72,72,70,2,2,0.9722222222222222,0.9722222222222222
2022,ONAGRI,CITRUMELO SACCATON,401770,IMG-00009-44.jpg,14,14,13,1,1,0.9285714285714286,0.9285714285714286
2022,ONAGRI,CITRUMELO SACCATON,401770,IMG-00017-44.jpg,20,17,17,0,3,1.0,0.85
2022,KHOUALKA,BIGARADIER,402440,IMG-00005-43.jpg,17,12,12,0,5,1.0,0.7058823529411765
2022,KHOUALKA,BIGARADIER,402440,IMG-00012-43.jpg,46,43,42,1,4,0.9767441860465116,0.9130434782608696
2022,KHOUALKA,BIGARADIER,402440,IMG-00014-43.jpg,11,9,9,0,2,1.0,0.8181818181818182
2022,KHOUALKA,BIGARADIER,402440,IMG-00015-43.jpg,22,13,13,0,9,1.0,0.5909090909090909
2022,KHOUALKA,BIGARADIER,402590,IMG-00007-43.jpg,104,90,89,1,15,0.9888888888888888,0.8557692307692307
2022,KHOUALKA,BIGARADIER,402590,IMG-00012-43.jpg,45,44,42,2,3,0.9545454545454546,0.9333333333333332
2022,KHOUALKA,BIGARADIER,402590,IMG-00015-43.jpg,58,53,52,1,6,0.981132075471698,0.896551724137931
2022,KHOUALKA,BIGARADIER,402590,IMG-00019-43.jpg,64,64,63,1,1,0.984375,0.984375
2022,KHOUALKA,CITRUS VOLKAMERIANA,501520,IMG-00004-43.jpg,39,34,34,0,5,1.0,0.8717948717948718
2022,KHOUALKA,CITRUS VOLKAMERIANA,501520,IMG-00007-43.jpg,43,39,39,0,4,1.0,0.9069767441860463
2022,KHOUALKA,CITRUS VOLKAMERIANA,501520,IMG-00015-43.jpg,18,9,9,0,9,1.0,0.5
2022,KHOUALKA,CITRUS VOLKAMERIANA,501520,IMG-00020-43.jpg,48,45,45,0,3,1.0,0.9375
2022,KHOUALKA,CITRUS VOLKAMERIANA,501540,IMG-00006-43.jpg,38,36,36,0,2,1.0,0.9473684210526316
2022,KHOUALKA,CITRUS VOLKAMERIANA,501540,IMG-00012-43.jpg,102,105,96,9,6,0.9142857142857144,0.9411764705882352
2022,KHOUALKA,CITRUS VOLKAMERIANA,501540,IMG-00017-43.jpg,138,130,126,4,12,0.9692307692307692,0.9130434782608696
2022,KHOUALKA,CITRUS VOLKAMERIANA,501540,IMG-00018-43.jpg,51,48,45,3,6,0.9375,0.8823529411764706
2022,KHOUALKA,CITRUS VOLKAMERIANA,501660,IMG-00006-43.jpg,60,61,60,1,0,0.9836065573770492,1.0
2022,KHOUALKA,CITRUS VOLKAMERIANA,501660,IMG-00016-43.jpg,63,60,57,3,6,0.95,0.9047619047619048
2022,KHOUALKA,CITRUS VOLKAMERIANA,501660,IMG-00018-43.jpg,112,95,89,6,23,0.936842105263158,0.7946428571428571
2022,KHOUALKA,CITRUS VOLKAMERIANA,501660,IMG-00021-43.jpg,90,91,89,2,1,0.978021978021978,0.9888888888888888
2022,KHOUALKA,CITRUS VOLKAMERIANA,501680,IMG-00005-43.jpg,179,170,169,1,10,0.9941176470588236,0.9441340782122905
2022,KHOUALKA,CITRUS VOLKAMERIANA,501680,IMG-00011-43.jpg,101,84,84,0,17,1.0,0.8316831683168316
2022,KHOUALKA,CITRUS VOLKAMERIANA,501680,IMG-00012-43.jpg,76,70,69,1,7,0.9857142857142858,0.9078947368421052
2022,KHOUALKA,CITRUS VOLKAMERIANA,501680,IMG-00016-43.jpg,113,97,94,3,19,0.9690721649484536,0.831858407079646
2022,KHOUALKA,CITRUS VOLKAMERIANA,501690,IMG-00032-43.jpg,34,32,31,1,3,0.96875,0.9117647058823528
2022,KHOUALKA,CITRUS VOLKAMERIANA,501690,IMG-00039-43.jpg,186,174,173,1,13,0.9942528735632185,0.9301075268817204
2022,KHOUALKA,CITRUS VOLKAMERIANA,501690,IMG-00047-43.jpg,103,84,84,0,19,1.0,0.8155339805825242
2022,KHOUALKA,CITRUS VOLKAMERIANA,501690,IMG-00049-43.jpg,166,157,155,2,11,0.9872611464968152,0.933734939759036
2022,KHOUALKA,CITRUS VOLKAMERIANA,501760,IMG-00001.jpg,94,77,76,1,18,0.987012987012987,0.8085106382978723
2022,KHOUALKA,CITRUS VOLKAMERIANA,501760,IMG-00034-43.jpg,45,34,34,0,11,1.0,0.7555555555555555
2022,KHOUALKA,CITRUS VOLKAMERIANA,501760,IMG-00036-43.jpg,40,34,33,1,7,0.9705882352941176,0.825
2022,KHOUALKA,CITRUS VOLKAMERIANA,501760,IMG-00051-43.jpg,92,82,80,2,12,0.975609756097561,0.8695652173913043
2022,ONAGRI,CITRUMELO SACCATON,510910,IMG-00004-44.jpg,73,72,69,3,4,0.9583333333333334,0.9452054794520548
2022,ONAGRI,CITRUMELO SACCATON,510910,IMG-00008-44.jpg,152,137,137,0,15,1.0,0.9013157894736842
2022,ONAGRI,CITRUMELO SACCATON,510910,IMG-00010-44.jpg,107,99,95,4,12,0.9595959595959596,0.8878504672897196
2022,ONAGRI,CITRUMELO SACCATON,510910,IMG-00011-44.jpg,92,87,85,2,7,0.9770114942528736,0.9239130434782608
2022,ONAGRI,CITRUMELO SACCATON,510950,IMG-00006-44.jpg,70,64,64,0,6,1.0,0.9142857142857144
2022,ONAGRI,CITRUMELO SACCATON,510950,IMG-00008-44.jpg,75,70,67,3,8,0.9571428571428572,0.8933333333333333
2022,ONAGRI,CITRUMELO SACCATON,510950,IMG-00009-44.jpg,85,77,76,1,9,0.987012987012987,0.8941176470588236
2022,ONAGRI,CITRUMELO SACCATON,510950,IMG-00011-44.jpg,135,125,125,0,10,1.0,0.925925925925926
2022,ONAGRI,MC PONSIRUCE TRIFOLIATA,510980,IMG-00014-44.jpg,67,64,63,1,4,0.984375,0.9402985074626866
2022,ONAGRI,MC PONSIRUCE TRIFOLIATA,510980,IMG-00015-44.jpg,51,49,49,0,2,1.0,0.9607843137254902
2022,ONAGRI,MC PONSIRUCE TRIFOLIATA,510980,IMG-00016-44.jpg,99,87,84,3,15,0.9655172413793104,0.8484848484848485
2022,ONAGRI,MC PONSIRUCE TRIFOLIATA,510980,IMG-00019-44.jpg,102,95,92,3,10,0.968421052631579,0.9019607843137256
2022,ONAGRI,MC PONSIRUCE TRIFOLIATA,510990,IMG-00006-44.jpg,135,127,126,1,9,0.9921259842519684,0.9333333333333332
2022,ONAGRI,MC PONSIRUCE TRIFOLIATA,510990,IMG-00008-44.jpg,110,108,104,4,6,0.9629629629629628,0.9454545454545454
2022,ONAGRI,MC PONSIRUCE TRIFOLIATA,510990,IMG-00009-44.jpg,85,78,77,1,8,0.9871794871794872,0.9058823529411764
2022,ONAGRI,MC PONSIRUCE TRIFOLIATA,510990,IMG-00024-44.jpg,65,61,61,0,4,1.0,0.9384615384615383
2022,ONAGRI,MC PONSIRUCE TRIFOLIATA,511030,IMG-00007-44.jpg,100,95,94,1,6,0.9894736842105264,0.94
2022,ONAGRI,MC PONSIRUCE TRIFOLIATA,511030,IMG-00016-44.jpg,63,58,57,1,6,0.9827586206896552,0.9047619047619048
2022,ONAGRI,MC PONSIRUCE TRIFOLIATA,511030,IMG-00022-44.jpg,98,96,94,2,4,0.9791666666666666,0.9591836734693876
2022,ONAGRI,MC PONSIRUCE TRIFOLIATA,511030,IMG-00027-44.jpg,82,82,81,1,1,0.9878048780487804,0.9878048780487804
2022,ONAGRI,MS PONSIRUCE TRIFOLIATA,511040,IMG-00004-44.jpg,77,71,71,0,6,1.0,0.922077922077922
2022,ONAGRI,MS PONSIRUCE TRIFOLIATA,511040,IMG-00014-44.jpg,48,42,40,2,8,0.9523809523809524,0.8333333333333334
2022,ONAGRI,MS PONSIRUCE TRIFOLIATA,511040,IMG-00016-44.jpg,71,70,69,1,2,0.9857142857142858,0.971830985915493
2022,ONAGRI,MS PONSIRUCE TRIFOLIATA,511040,IMG-00025-44.jpg,56,56,54,2,2,0.9642857142857144,0.9642857142857144
2022,ONAGRI,FUZHU,511050,IMG-00004-44.jpg,109,104,100,4,9,0.9615384615384616,0.9174311926605504
2022,ONAGRI,FUZHU,511050,IMG-00006-44.jpg,142,121,118,3,24,0.975206611570248,0.8309859154929577
2022,ONAGRI,FUZHU,511050,IMG-00011-44.jpg,172,158,158,0,14,1.0,0.9186046511627908
2022,ONAGRI,FUZHU,511050,IMG-00022-44.jpg,194,185,185,0,9,1.0,0.9536082474226804
2022,ONAGRI,MS PONSIRUCE TRIFOLIATA,511060,IMG-00007-44.jpg,115,115,112,3,3,0.9739130434782608,0.9739130434782608
2022,ONAGRI,MS PONSIRUCE TRIFOLIATA,511060,IMG-00016-44.jpg,102,94,92,2,10,0.9787234042553192,0.9019607843137256
2022,ONAGRI,MS PONSIRUCE TRIFOLIATA,511060,IMG-00017-44.jpg,59,56,56,0,3,1.0,0.9491525423728814
2022,ONAGRI,MS PONSIRUCE TRIFOLIATA,511060,IMG-00019-44.jpg,108,96,94,2,14,0.9791666666666666,0.8703703703703703
2022,ONAGRI,FUZHU,511070,IMG-00006-44.jpg,82,78,75,3,7,0.9615384615384616,0.9146341463414634
2022,ONAGRI,FUZHU,511070,IMG-00016-44.jpg,96,89,84,5,12,0.9438202247191012,0.875
2022,ONAGRI,FUZHU,511070,IMG-00018-44.jpg,93,86,86,0,7,1.0,0.9247311827956988
2022,ONAGRI,FUZHU,511070,IMG-00019-44.jpg,142,133,130,3,12,0.9774436090225564,0.9154929577464788
