compagnie,Domaine,Porte-greffe,parcelle,Filename,True_count,detect_count,TP,FP,FN,Precision,Recall
2022,SAOUDA,BIGARADIER,10010,IMG-00011-45.jpg,28,38,28,10,0,0.7368421052631579,1.0
2022,SAOUDA,BIGARADIER,10010,IMG-00012-45.jpg,27,34,26,8,1,0.7647058823529411,0.9629629629629628
2022,SAOUDA,BIGARADIER,10010,IMG-00014-45.jpg,50,61,48,13,2,0.7868852459016393,0.96
2022,SAOUDA,BIGARADIER,10010,IMG-00018-45.jpg,30,34,29,5,1,0.8529411764705882,0.9666666666666668
2022,SAOUDA,BIGARADIER,10010,IMG-00020-45.jpg,31,44,31,13,0,0.7045454545454546,1.0
2024,SAOUDA,BIGARADIER,10010,IMG-23410.jpg,85,58,57,1,28,0.9827586206896552,0.6705882352941176
2024,SAOUDA,BIGARADIER,10010,IMG-23417.jpg,86,62,62,0,24,1.0,0.7209302325581395
2024,SAOUDA,BIGARADIER,10010,IMG-23430.jpg,74,58,58,0,16,1.0,0.7837837837837838
2024,SAOUDA,BIGARADIER,10010,IMG-23647.jpg,95,77,77,0,18,1.0,0.8105263157894737
2024,SAOUDA,BIGARADIER,10010,IMG-23672.jpg,47,24,23,1,24,0.9583333333333334,0.4893617021276596
2024,SAOUDA,BIGARADIER,10010,IMG-23707.jpg,30,25,25,0,5,1.0,0.8333333333333334
2024,SAOUDA,BIGARADIER,10010,IMG-23709.jpg,31,24,24,0,7,1.0,0.7741935483870968
2024,SAOUDA,BIGARADIER,10010,IMG-23711.jpg,79,51,50,1,29,0.9803921568627452,0.6329113924050633
2022,SAOUDA,MACROPHYLLA,10030,IMG-00158-45.jpg,101,139,101,38,0,0.7266187050359713,1.0
2022,SAOUDA,MACROPHYLLA,10030,IMG-00159-45.jpg,155,190,151,39,4,0.7947368421052632,0.9741935483870968
2022,SAOUDA,MACROPHYLLA,10030,IMG-00162-45.jpg,119,144,118,26,1,0.8194444444444444,0.9915966386554622
2022,SAOUDA,MACROPHYLLA,10030,IMG-00169-45.jpg,72,99,72,27,0,0.7272727272727273,1.0
2022,SAOUDA,MACROPHYLLA,10031,IMG-00002-45.jpg,46,55,45,10,1,0.8181818181818182,0.9782608695652174
2022,SAOUDA,MACROPHYLLA,10031,IMG-00084-45.jpg,41,53,41,12,0,0.7735849056603774,1.0
2022,SAOUDA,MACROPHYLLA,10031,IMG-00450-45.jpg,27,43,26,17,1,0.6046511627906976,0.9629629629629628
2022,SAOUDA,MACROPHYLLA,10031,IMG-00451-45.jpg,34,47,33,14,1,0.7021276595744681,0.9705882352941176
2022,SAOUDA,MACROPHYLLA,10031,IMG-00464-45.jpg,33,42,32,10,1,0.7619047619047619,0.9696969696969696
2022,ONAGRI,CITRUS VOLKAMERIANA,10101,IMG-00003-39.jpg,120,116,113,3,7,0.9741379310344828,0.9416666666666668
2022,ONAGRI,CITRUS VOLKAMERIANA,10101,IMG-00010-39.jpg,85,82,76,6,9,0.926829268292683,0.8941176470588236
2024,ONAGRI,CITRUS VOLKAMERIANA,10101,IMG-10523.jpg,288,226,225,1,63,0.995575221238938,0.78125
2024,ONAGRI,CITRUS VOLKAMERIANA,10101,IMG-10545.jpg,98,79,79,0,19,1.0,0.8061224489795918
2024,ONAGRI,CITRUS VOLKAMERIANA,10101,IMG-10558.jpg,143,102,98,4,45,0.9607843137254902,0.6853146853146853
2022,ONAGRI,CITRUS VOLKAMERIANA,10102,IMG-00003-39.jpg,48,41,41,0,7,1.0,0.8541666666666666
2024,ONAGRI,CITRUS VOLKAMERIANA,10102,IMG-10637.jpg,140,115,114,1,26,0.991304347826087,0.8142857142857143
2024,ONAGRI,CITRUS VOLKAMERIANA,10102,IMG-10658.jpg,163,130,127,3,36,0.9769230769230768,0.7791411042944786
2022,ONAGRI,CITRUS VOLKAMERIANA,10103,IMG-00003-39.jpg,215,194,188,6,27,0.9690721649484536,0.8744186046511628
2022,ONAGRI,CITRUS VOLKAMERIANA,10103,IMG-00008-39.jpg,195,185,175,10,20,0.945945945945946,0.8974358974358975
2024,ONAGRI,CITRUS VOLKAMERIANA,10103,IMG-10614.jpg,134,111,110,1,24,0.990990990990991,0.8208955223880597
2024,ONAGRI,CITRUS VOLKAMERIANA,10103,IMG-10630.jpg,213,173,171,2,42,0.9884393063583816,0.8028169014084507
2024,ONAGRI,CITRUS VOLKAMERIANA,10103,IMG-10631.jpg,134,101,100,1,34,0.99009900990099,0.746268656716418
2022,ONAGRI,CITRUS VOLKAMERIANA,10104,IMG-00004-39.jpg,65,62,58,4,7,0.935483870967742,0.8923076923076924
2022,ONAGRI,CITRUS VOLKAMERIANA,10104,IMG-00008-39.jpg,69,64,55,9,14,0.859375,0.7971014492753623
2024,ONAGRI,CITRUS VOLKAMERIANA,10104,IMG-11267.jpg,22,12,12,0,10,1.0,0.5454545454545454
2024,ONAGRI,CITRUS VOLKAMERIANA,10104,IMG-11327.jpg,128,96,93,3,35,0.96875,0.7265625
2024,ONAGRI,CITRUS VOLKAMERIANA,10104,IMG-11347.jpg,118,88,88,0,30,1.0,0.7457627118644068
2024,ONAGRI,CITRUS VOLKAMERIANA,10104,IMG-11366.jpg,351,248,244,4,107,0.9838709677419356,0.6951566951566952
2024,ONAGRI,CITRUS VOLKAMERIANA,10104,IMG-11386.jpg,99,73,73,0,26,1.0,0.7373737373737373
2022,ONAGRI,CITRUS VOLKAMERIANA,10105,IMG-00004-39.jpg,17,16,14,2,3,0.875,0.8235294117647058
2022,ONAGRI,CITRUS VOLKAMERIANA,10105,IMG-00005-39.jpg,68,72,65,7,3,0.9027777777777778,0.9558823529411764
2022,ONAGRI,CITRUS VOLKAMERIANA,10108,IMG-00003-39.jpg,61,58,55,3,6,0.9482758620689656,0.9016393442622952
2022,ONAGRI,CITRUS VOLKAMERIANA,10108,IMG-00007-39.jpg,69,62,60,2,9,0.967741935483871,0.8695652173913043
2022,ONAGRI,CITRUS VOLKAMERIANA,10109,IMG-00003-39.jpg,4,4,4,0,0,1.0,1.0
2022,ONAGRI,CITRUS VOLKAMERIANA,10109,IMG-00008-39.jpg,105,104,101,3,4,0.971153846153846,0.961904761904762
2022,KHOUALKA,CITRANGE CARRIZO,10213,IMG-00001.jpg,77,87,73,14,4,0.8390804597701149,0.948051948051948
2022,KHOUALKA,CITRANGE CARRIZO,10213,IMG-00005-40.jpg,73,82,71,11,2,0.8658536585365854,0.9726027397260274
2022,KHOUALKA,CITRANGE CARRIZO,10213,IMG-00009-40.jpg,14,19,14,5,0,0.7368421052631579,1.0
2022,KHOUALKA,CITRANGE CARRIZO,10213,IMG-00014-40.jpg,21,25,19,6,2,0.76,0.9047619047619048
2022,KHOUALKA,CITRANGE CARRIZO,10213,IMG-00028-40.jpg,47,49,46,3,1,0.9387755102040816,0.9787234042553192
2022,KHOUALKA,CITRANGE CARRIZO,10213,IMG-00034-40.jpg,48,50,47,3,1,0.94,0.9791666666666666
2022,KHOUALKA,CITRANGE CARRIZO,10213,IMG-00035-40.jpg,37,38,35,3,2,0.9210526315789472,0.945945945945946
2022,KHOUALKA,CITRANGE CARRIZO,10213,IMG-00036-40.jpg,47,56,47,9,0,0.8392857142857143,1.0
2022,KHOUALKA,CITRANGE CARRIZO,10213,IMG-00042-40.jpg,22,26,22,4,0,0.8461538461538461,1.0
2022,KHOUALKA,CITRANGE CARRIZO,10213,IMG-00047-40.jpg,70,74,68,6,2,0.918918918918919,0.9714285714285714
2022,KHOUALKA,CITRANGE CARRIZO,10213,IMG-00054-40.jpg,33,37,33,4,0,0.8918918918918919,1.0
2022,KHOUALKA,CITRANGE CARRIZO,10213,IMG-00055-40.jpg,93,93,89,4,4,0.956989247311828,0.956989247311828
2022,KHOUALKA,CITRANGE CARRIZO,10213,IMG-00061-40.jpg,113,128,110,18,3,0.859375,0.9734513274336284
2022,KHOUALKA,CITRANGE CARRIZO,10213,IMG-00066-40.jpg,48,45,38,7,10,0.8444444444444444,0.7916666666666666
2022,OUARGHA,MACROPHYLLA,11010,IMG-00001.jpg,40,40,39,1,1,0.975,0.975
2022,OUARGHA,MACROPHYLLA,11010,IMG-00015-41.jpg,24,27,22,5,2,0.8148148148148148,0.9166666666666666
2022,OUARGHA,MACROPHYLLA,11010,IMG-00019-41.jpg,20,40,20,20,0,0.5,1.0
2022,OUARGHA,MACROPHYLLA,11010,IMG-00024-41.jpg,21,24,21,3,0,0.875,1.0
2022,OUARGHA,MACROPHYLLA,11020,IMG-00017-41.jpg,51,60,51,9,0,0.85,1.0
2022,OUARGHA,MACROPHYLLA,11020,IMG-00018-41.jpg,13,13,12,1,1,0.9230769230769232,0.9230769230769232
2022,OUARGHA,CITRANGE CARRIZO,13010,IMG-00067-41.jpg,55,75,54,21,1,0.72,0.9818181818181818
2022,OUARGHA,CITRANGE CARRIZO,13010,IMG-00086-41.jpg,49,62,49,13,0,0.7903225806451613,1.0
2022,OUARGHA,CITRANGE CARRIZO,13010,IMG-00194-41.jpg,33,39,33,6,0,0.8461538461538461,1.0
2022,OUARGHA,CITRANGE CARRIZO,13020,IMG-00023-41.jpg,31,38,31,7,0,0.8157894736842105,1.0
2022,OUARGHA,CITRANGE CARRIZO,13020,IMG-00024-41.jpg,18,27,18,9,0,0.6666666666666666,1.0
2022,OUARGHA,CITRANGE CARRIZO,13020,IMG-00039-41.jpg,4,10,4,6,0,0.4,1.0
2022,OUARGHA,CITRANGE CARRIZO,13020,IMG-00040-41.jpg,6,14,6,8,0,0.4285714285714285,1.0
2022,OUARGHA,CITRUS VOLKAMERIANA,13030,IMG-00009-41.jpg,18,26,18,8,0,0.6923076923076923,1.0
2022,OUARGHA,CITRUS VOLKAMERIANA,13030,IMG-00013-41.jpg,46,70,46,24,0,0.6571428571428571,1.0
2022,OUARGHA,CITRUS VOLKAMERIANA,13030,IMG-00027-41.jpg,12,28,11,17,1,0.3928571428571428,0.9166666666666666
2022,OUARGHA,CITRUS VOLKAMERIANA,13030,IMG-00029-41.jpg,18,31,18,13,0,0.5806451612903226,1.0
2022,OUARGHA,CITRUS VOLKAMERIANA,13030,IMG-00036-41.jpg,16,38,16,22,0,0.4210526315789473,1.0
2022,OUARGHA,CITRUS VOLKAMERIANA,14010,IMG-00008-41.jpg,40,47,39,8,1,0.8297872340425532,0.975
2022,OUARGHA,CITRUS VOLKAMERIANA,14010,IMG-00010-41.jpg,49,54,47,7,2,0.8703703703703703,0.9591836734693876
2022,OUARGHA,CITRUS VOLKAMERIANA,14010,IMG-00011-41.jpg,47,60,46,14,1,0.7666666666666667,0.9787234042553192
2022,OUARGHA,CITRUS VOLKAMERIANA,14010,IMG-00018-41.jpg,44,61,44,17,0,0.7213114754098361,1.0
2022,KHOUALKA,MACROPHYLLA,20118,IMG-00007-40.jpg,44,46,44,2,0,0.9565217391304348,1.0
2022,KHOUALKA,MACROPHYLLA,20118,IMG-00008-40.jpg,115,130,114,16,1,0.8769230769230769,0.991304347826087
2022,KHOUALKA,MACROPHYLLA,20118,IMG-00022-40.jpg,113,113,106,7,7,0.9380530973451328,0.9380530973451328
2022,KHOUALKA,MACROPHYLLA,20118,IMG-00033-40.jpg,58,62,56,6,2,0.9032258064516128,0.9655172413793104
2022,KHOUALKA,MACROPHYLLA,20118,IMG-00037-40.jpg,29,31,28,3,1,0.9032258064516128,0.9655172413793104
2022,KHOUALKA,MACROPHYLLA,20118,IMG-00042-40.jpg,137,144,132,12,5,0.9166666666666666,0.9635036496350364
2022,KHOUALKA,MACROPHYLLA,20118,IMG-00046-40.jpg,45,54,44,10,1,0.8148148148148148,0.9777777777777776
2022,KHOUALKA,MACROPHYLLA,20118,IMG-00050-40.jpg,48,48,45,3,3,0.9375,0.9375
2022,KHOUALKA,MACROPHYLLA,20118,IMG-00055-40.jpg,52,59,51,8,1,0.864406779661017,0.9807692307692308
2022,KHOUALKA,MACROPHYLLA,20118,IMG-00061-40.jpg,120,130,112,18,8,0.8615384615384616,0.9333333333333332
2022,KHOUALKA,MACROPHYLLA,20118,IMG-00062-40.jpg,63,70,62,8,1,0.8857142857142857,0.984126984126984
2022,KHOUALKA,MACROPHYLLA,20118,IMG-00063-40.jpg,47,50,43,7,4,0.86,0.9148936170212766
2022,KHOUALKA,MACROPHYLLA,20118,IMG-00066-40.jpg,84,93,84,9,0,0.9032258064516128,1.0
2024,KHOUALKA,MACROPHYLLA,20118,IMG-12691.jpg,22,14,14,0,8,1.0,0.6363636363636364
2024,KHOUALKA,MACROPHYLLA,20118,IMG-12729.jpg,56,43,43,0,13,1.0,0.7678571428571429
2024,KHOUALKA,MACROPHYLLA,20118,IMG-12735.jpg,88,70,69,1,19,0.9857142857142858,0.7840909090909091
2024,KHOUALKA,MACROPHYLLA,20118,IMG-12748.jpg,107,81,81,0,26,1.0,0.7570093457943925
2024,KHOUALKA,MACROPHYLLA,20118,IMG-12764.jpg,111,92,91,1,20,0.9891304347826086,0.8198198198198198
2024,KHOUALKA,MACROPHYLLA,20118,IMG-12808.jpg,113,78,77,1,36,0.9871794871794872,0.6814159292035398
2024,KHOUALKA,MACROPHYLLA,20118,IMG-12851.jpg,24,12,12,0,12,1.0,0.5
2022,KHOUALKA,MACROPHYLLA,20119,IMG-00005-40.jpg,106,117,104,13,2,0.8888888888888888,0.981132075471698
2022,KHOUALKA,MACROPHYLLA,20119,IMG-00008-40.jpg,142,156,136,20,6,0.8717948717948718,0.9577464788732394
2022,KHOUALKA,MACROPHYLLA,20119,IMG-00014-40.jpg,132,139,131,8,1,0.9424460431654677,0.9924242424242424
2022,KHOUALKA,BIGARADIER,20132,IMG-00004-40.jpg,181,185,178,7,3,0.9621621621621622,0.9834254143646408
2022,KHOUALKA,BIGARADIER,20132,IMG-00025-40.jpg,91,105,90,15,1,0.8571428571428571,0.989010989010989
2022,KHOUALKA,BIGARADIER,20132,IMG-00028-40.jpg,49,57,49,8,0,0.8596491228070176,1.0
2022,KHOUALKA,BIGARADIER,20132,IMG-00035-40.jpg,103,119,103,16,0,0.865546218487395,1.0
2022,KHOUALKA,BIGARADIER,20132,IMG-00039-40.jpg,119,125,115,10,4,0.92,0.9663865546218487
2022,KHOUALKA,BIGARADIER,20132,IMG-00046-40.jpg,156,168,151,17,5,0.8988095238095238,0.967948717948718
2022,KHOUALKA,BIGARADIER,20132,IMG-00051-40.jpg,108,112,104,8,4,0.9285714285714286,0.9629629629629628
2022,KHOUALKA,BIGARADIER,20132,IMG-00055-40.jpg,67,66,62,4,5,0.9393939393939394,0.9253731343283582
2022,KHOUALKA,BIGARADIER,20132,IMG-00058-40.jpg,89,90,85,5,4,0.9444444444444444,0.9550561797752808
2022,KHOUALKA,BIGARADIER,20132,IMG-00059-40.jpg,139,142,135,7,4,0.9507042253521126,0.9712230215827338
2022,KHOUALKA,BIGARADIER,20132,IMG-00060-40.jpg,57,55,50,5,7,0.9090909090909092,0.8771929824561403
2022,KHOUALKA,BIGARADIER,20132,IMG-00064-40.jpg,117,126,114,12,3,0.9047619047619048,0.9743589743589745
2022,KHOUALKA,BIGARADIER,20132,IMG-00075-40.jpg,69,75,69,6,0,0.92,1.0
2022,ONAGRI,BIGARADIER,20139,IMG-00021-39.jpg,93,92,87,5,6,0.9456521739130436,0.935483870967742
2024,KHOUALKA,CITRUS VOLKAMERIANA,20205,IMG-12040.jpg,123,87,85,2,38,0.9770114942528736,0.6910569105691057
2024,KHOUALKA,CITRUS VOLKAMERIANA,20205,IMG-12058.jpg,116,105,104,1,12,0.9904761904761904,0.896551724137931
2022,SAOUDA,CITRUS VOLKAMERIANA,21020,IMG-00033-45.jpg,67,86,66,20,1,0.7674418604651163,0.9850746268656716
2022,SAOUDA,CITRUS VOLKAMERIANA,21020,IMG-00087-45.jpg,21,24,17,7,4,0.7083333333333334,0.8095238095238095
2022,SAOUDA,CITRUS VOLKAMERIANA,21020,IMG-00138-45.jpg,40,44,39,5,1,0.8863636363636364,0.975
2022,SAOUDA,CITRUS VOLKAMERIANA,21020,IMG-00145-45.jpg,37,43,37,6,0,0.8604651162790697,1.0
2022,SAOUDA,CITRUS VOLKAMERIANA,21020,IMG-00155-45.jpg,38,53,38,15,0,0.7169811320754716,1.0
2022,SAOUDA,CITRUS VOLKAMERIANA,21030,IMG-00521-45.jpg,31,42,31,11,0,0.7380952380952381,1.0
2022,SAOUDA,CITRUS VOLKAMERIANA,21030,IMG-00524-45.jpg,71,91,70,21,1,0.7692307692307693,0.9859154929577464
2022,SAOUDA,CITRUS VOLKAMERIANA,21030,IMG-00536-45.jpg,41,63,40,23,1,0.6349206349206349,0.975609756097561
2022,SAOUDA,CITRUS VOLKAMERIANA,21030,IMG-00537-45.jpg,52,65,47,18,5,0.7230769230769231,0.903846153846154
2022,SAOUDA,CITRUS VOLKAMERIANA,22020,IMG-00053-45.jpg,39,56,39,17,0,0.6964285714285714,1.0
2022,SAOUDA,CITRUS VOLKAMERIANA,22020,IMG-00059-45.jpg,46,56,45,11,1,0.8035714285714286,0.9782608695652174
2022,SAOUDA,CITRUS VOLKAMERIANA,22020,IMG-00060-45.jpg,48,56,47,9,1,0.8392857142857143,0.9791666666666666
2022,SAOUDA,CITRUS VOLKAMERIANA,22020,IMG-00062-45.jpg,50,72,50,22,0,0.6944444444444444,1.0
2022,SAOUDA,CITRUS VOLKAMERIANA,22030,IMG-00062-45.jpg,62,71,62,9,0,0.8732394366197183,1.0
2022,SAOUDA,CITRUS VOLKAMERIANA,22030,IMG-00063-45.jpg,83,103,82,21,1,0.7961165048543689,0.9879518072289156
2022,SAOUDA,CITRUS VOLKAMERIANA,22030,IMG-00065-45.jpg,58,66,57,9,1,0.8636363636363636,0.9827586206896552
2022,SAOUDA,CITRUS VOLKAMERIANA,22030,IMG-00068-45.jpg,66,81,65,16,1,0.8024691358024691,0.9848484848484848
2022,SAOUDA,CITRUS VOLKAMERIANA,23020,IMG-00024-45.jpg,47,61,46,15,1,0.7540983606557377,0.9787234042553192
2022,SAOUDA,CITRUS VOLKAMERIANA,23020,IMG-00032-45.jpg,33,38,33,5,0,0.868421052631579,1.0
2022,SAOUDA,CITRUS VOLKAMERIANA,23020,IMG-00074-45.jpg,28,34,27,7,1,0.7941176470588235,0.9642857142857144
2022,SAOUDA,CITRUS VOLKAMERIANA,23020,IMG-00079-45.jpg,28,41,28,13,0,0.6829268292682927,1.0
2022,SAOUDA,CITRUS VOLKAMERIANA,23030,IMG-00014-45.jpg,25,37,24,13,1,0.6486486486486487,0.96
2022,SAOUDA,CITRUS VOLKAMERIANA,23030,IMG-00034-45.jpg,43,60,41,19,2,0.6833333333333333,0.9534883720930232
2022,SAOUDA,CITRUS VOLKAMERIANA,23030,IMG-00069-45.jpg,28,53,28,25,0,0.5283018867924528,1.0
2022,SAOUDA,CITRUS VOLKAMERIANA,23030,IMG-00079-45.jpg,50,74,49,25,1,0.6621621621621622,0.98
2022,SAOUDA,CITRANGE CARRIZO,24010,IMG-00097-45.jpg,59,72,56,16,3,0.7777777777777778,0.9491525423728814
2022,SAOUDA,CITRANGE CARRIZO,24010,IMG-00101-45.jpg,27,35,27,8,0,0.7714285714285715,1.0
2022,SAOUDA,CITRANGE CARRIZO,24010,IMG-00111-45.jpg,54,60,53,7,1,0.8833333333333333,0.9814814814814816
2022,SAOUDA,CITRANGE CARRIZO,24010,IMG-00112-45.jpg,40,53,40,13,0,0.7547169811320755,1.0
2022,SAOUDA,CITRANGE CARRIZO,25010,IMG-00006-45.jpg,55,71,55,16,0,0.7746478873239436,1.0
2022,SAOUDA,CITRANGE CARRIZO,25010,IMG-00007-45.jpg,77,97,77,20,0,0.7938144329896907,1.0
2022,SAOUDA,CITRANGE CARRIZO,25010,IMG-00010-45.jpg,53,70,53,17,0,0.7571428571428571,1.0
2022,SAOUDA,CITRANGE CARRIZO,25010,IMG-00011-45.jpg,26,30,26,4,0,0.8666666666666667,1.0
2022,SAOUDA,CITRANGE CARRIZO,26010,IMG-00008-45.jpg,39,43,39,4,0,0.9069767441860463,1.0
2022,SAOUDA,CITRANGE CARRIZO,26010,IMG-00013-45.jpg,36,47,36,11,0,0.7659574468085106,1.0
2022,SAOUDA,CITRANGE CARRIZO,26010,IMG-00018-45.jpg,43,55,43,12,0,0.7818181818181819,1.0
2022,SAOUDA,CITRANGE CARRIZO,26010,IMG-00020-45.jpg,44,50,44,6,0,0.88,1.0
2022,KHOUALKA,CITRANGE CARRIZO,30138,IMG-00002-40.jpg,39,44,37,7,2,0.8409090909090909,0.9487179487179488
2022,KHOUALKA,CITRANGE CARRIZO,30138,IMG-00003-40.jpg,59,64,56,8,3,0.875,0.9491525423728814
2022,KHOUALKA,CITRANGE CARRIZO,30138,IMG-00005-40.jpg,58,65,57,8,1,0.8769230769230769,0.9827586206896552
2022,KHOUALKA,CITRANGE CARRIZO,30138,IMG-00008-40.jpg,32,35,31,4,1,0.8857142857142857,0.96875
2022,KHOUALKA,CITRANGE CARRIZO,30138,IMG-00011-40.jpg,26,30,25,5,1,0.8333333333333334,0.9615384615384616
2022,KHOUALKA,CITRANGE CARRIZO,30138,IMG-00019-40.jpg,2,1,1,0,1,1.0,0.5
2022,KHOUALKA,CITRANGE CARRIZO,30138,IMG-00037-40.jpg,30,34,29,5,1,0.8529411764705882,0.9666666666666668
2022,KHOUALKA,CITRANGE CARRIZO,30138,IMG-00040-40.jpg,41,42,41,1,0,0.9761904761904762,1.0
2022,KHOUALKA,CITRANGE CARRIZO,30138,IMG-00043-40.jpg,28,34,26,8,2,0.7647058823529411,0.9285714285714286
2022,KHOUALKA,CITRANGE CARRIZO,30138,IMG-00044-40.jpg,99,102,97,5,2,0.9509803921568628,0.9797979797979798
2022,KHOUALKA,CITRANGE CARRIZO,30138,IMG-00048-40.jpg,37,41,34,7,3,0.8292682926829268,0.918918918918919
2022,KHOUALKA,CITRANGE CARRIZO,30138,IMG-00057-40.jpg,73,73,69,4,4,0.9452054794520548,0.9452054794520548
2022,KHOUALKA,CITRANGE CARRIZO,30138,IMG-00063-40.jpg,89,84,82,2,7,0.9761904761904762,0.9213483146067416
2022,ONAGRI,CITRUS VOLKAMERIANA,30145,IMG-00018-39.jpg,219,204,196,8,23,0.9607843137254902,0.8949771689497716
2022,ONAGRI,CITRUS VOLKAMERIANA,30145,IMG-00043-39.jpg,64,64,60,4,4,0.9375,0.9375
2022,ONAGRI,CITRUS VOLKAMERIANA,30146,IMG-00008-39.jpg,262,263,247,16,15,0.9391634980988594,0.9427480916030534
2022,ONAGRI,CITRUS VOLKAMERIANA,30146,IMG-00045-39.jpg,190,193,181,12,9,0.9378238341968912,0.9526315789473684
2022,ONAGRI,CITRUS VOLKAMERIANA,30147,IMG-00002-39.jpg,269,266,246,20,23,0.924812030075188,0.9144981412639404
2022,ONAGRI,CITRUS VOLKAMERIANA,30147,IMG-00008-39.jpg,172,174,162,12,10,0.9310344827586208,0.9418604651162792
2022,ONAGRI,CITRUS VOLKAMERIANA,30148,IMG-00016-40.jpg,88,88,83,5,5,0.9431818181818182,0.9431818181818182
2022,ONAGRI,CITRUS VOLKAMERIANA,30148,IMG-00047-40.jpg,34,32,32,0,2,1.0,0.9411764705882352
2022,ONAGRI,CITRUS VOLKAMERIANA,30149,IMG-00018-39.jpg,151,139,137,2,14,0.9856115107913668,0.9072847682119204
2022,ONAGRI,CITRUS VOLKAMERIANA,30149,IMG-00027-39.jpg,226,202,201,1,25,0.995049504950495,0.8893805309734514
2022,ONAGRI,CITRUS VOLKAMERIANA,30151,IMG-00012-39.jpg,185,167,163,4,22,0.9760479041916168,0.8810810810810811
2022,ONAGRI,CITRUS VOLKAMERIANA,30151,IMG-00033-39.jpg,214,205,193,12,21,0.9414634146341464,0.9018691588785048
2024,ONAGRI,CITRUS VOLKAMERIANA,30151,IMG-21881.jpg,73,53,53,0,20,1.0,0.726027397260274
2024,ONAGRI,CITRUS VOLKAMERIANA,30151,IMG-21935.jpg,179,147,146,1,33,0.9931972789115646,0.8156424581005587
2024,ONAGRI,CITRUS VOLKAMERIANA,30151,IMG-21936.jpg,93,72,72,0,21,1.0,0.7741935483870968
2022,ONAGRI,CITRUS VOLKAMERIANA,30152,IMG-00016-39.jpg,39,39,37,2,2,0.9487179487179488,0.9487179487179488
2022,ONAGRI,CITRUS VOLKAMERIANA,30152,IMG-00019-39.jpg,139,129,122,7,17,0.9457364341085271,0.8776978417266187
2022,ONAGRI,CITRUS VOLKAMERIANA,30153,IMG-00001.jpg,157,148,143,5,14,0.9662162162162162,0.910828025477707
2022,ONAGRI,CITRUS VOLKAMERIANA,30153,IMG-00007-39.jpg,127,116,113,3,14,0.9741379310344828,0.889763779527559
2022,ONAGRI,CITRUS VOLKAMERIANA,30153,IMG-00013-39.jpg,159,146,142,4,17,0.9726027397260274,0.8930817610062893
2022,ONAGRI,CITRUS VOLKAMERIANA,30153,IMG-00040-39.jpg,153,148,143,5,10,0.9662162162162162,0.934640522875817
2022,ONAGRI,CITRUS VOLKAMERIANA,30154,IMG-00017-39.jpg,160,156,151,5,9,0.967948717948718,0.94375
2022,ONAGRI,CITRUS VOLKAMERIANA,30154,IMG-00027-39.jpg,220,215,213,2,7,0.9906976744186048,0.968181818181818
2022,ONAGRI,CITRUS VOLKAMERIANA,30154,IMG-00033-39.jpg,51,50,49,1,2,0.98,0.9607843137254902
2022,ONAGRI,CITRUS VOLKAMERIANA,30154,IMG-00036-39.jpg,137,145,133,12,4,0.9172413793103448,0.9708029197080292
2022,ONAGRI,CITRUS VOLKAMERIANA,30154,IMG-00038-39.jpg,242,241,232,9,10,0.9626556016597512,0.9586776859504132
2022,ONAGRI,CITRUS VOLKAMERIANA,30154,IMG-00041-39.jpg,272,262,252,10,20,0.9618320610687024,0.9264705882352942
2022,ONAGRI,CITRUS VOLKAMERIANA,30154,IMG-00044-39.jpg,141,147,136,11,5,0.9251700680272108,0.9645390070921984
2022,ONAGRI,BIGARADIER,30155,IMG-00002-39.jpg,139,145,136,9,3,0.9379310344827586,0.9784172661870504
2022,ONAGRI,BIGARADIER,30155,IMG-00003-39.jpg,115,113,108,5,7,0.9557522123893806,0.9391304347826088
2022,ONAGRI,BIGARADIER,30155,IMG-00006-39.jpg,44,45,41,4,3,0.9111111111111112,0.9318181818181818
2022,ONAGRI,BIGARADIER,30155,IMG-00011-39.jpg,100,92,90,2,10,0.9782608695652174,0.9
2022,ONAGRI,BIGARADIER,30155,IMG-00019-39.jpg,142,130,126,4,16,0.9692307692307692,0.8873239436619719
2022,ONAGRI,BIGARADIER,30155,IMG-00026-39.jpg,124,119,115,4,9,0.9663865546218487,0.9274193548387096
2022,ONAGRI,BIGARADIER,30155,IMG-00032-39.jpg,81,82,78,4,3,0.951219512195122,0.9629629629629628
2022,ONAGRI,BIGARADIER,30155,IMG-00039-39.jpg,19,18,17,1,2,0.9444444444444444,0.8947368421052632
2022,ONAGRI,BIGARADIER,30155,IMG-00043-39.jpg,130,139,127,12,3,0.9136690647482014,0.9769230769230768
2022,ONAGRI,CITRUS VOLKAMERIANA,30157,IMG-00003-39.jpg,227,225,215,10,12,0.9555555555555556,0.947136563876652
2022,ONAGRI,CITRUS VOLKAMERIANA,30157,IMG-00012-39.jpg,283,282,269,13,14,0.953900709219858,0.950530035335689
2022,ONAGRI,CITRUS VOLKAMERIANA,30157,IMG-00032-39.jpg,64,71,61,10,3,0.8591549295774648,0.953125
2022,ONAGRI,CITRUS VOLKAMERIANA,30157,IMG-00035-39.jpg,159,155,149,6,10,0.9612903225806452,0.9371069182389936
2022,KHOUALKA,CITRUS VOLKAMERIANA,30235,IMG-00001.jpg,93,98,92,6,1,0.9387755102040816,0.989247311827957
2022,KHOUALKA,CITRUS VOLKAMERIANA,30235,IMG-00003-40.jpg,37,41,37,4,0,0.902439024390244,1.0
2022,KHOUALKA,CITRUS VOLKAMERIANA,30235,IMG-00009-40.jpg,103,111,102,9,1,0.918918918918919,0.9902912621359224
2022,KHOUALKA,CITRUS VOLKAMERIANA,30235,IMG-00013-40.jpg,90,104,90,14,0,0.8653846153846154,1.0
2022,KHOUALKA,CITRUS VOLKAMERIANA,30235,IMG-00026-40.jpg,122,131,119,12,3,0.9083969465648856,0.9754098360655736
2022,KHOUALKA,CITRUS VOLKAMERIANA,30235,IMG-00047-40.jpg,47,52,45,7,2,0.8653846153846154,0.9574468085106383
2022,KHOUALKA,CITRUS VOLKAMERIANA,30235,IMG-00048-40.jpg,90,104,87,17,3,0.8365384615384616,0.9666666666666668
2022,KHOUALKA,CITRUS VOLKAMERIANA,30235,IMG-00049-40.jpg,44,52,41,11,3,0.7884615384615384,0.9318181818181818
2022,KHOUALKA,CITRUS VOLKAMERIANA,30235,IMG-00050-40.jpg,84,93,79,14,5,0.8494623655913979,0.9404761904761904
2022,KHOUALKA,CITRUS VOLKAMERIANA,30235,IMG-00052-40.jpg,98,111,97,14,1,0.8738738738738738,0.9897959183673468
2022,KHOUALKA,CITRUS VOLKAMERIANA,30235,IMG-00057-40.jpg,80,85,76,9,4,0.8941176470588236,0.95
2022,KHOUALKA,CITRUS VOLKAMERIANA,30235,IMG-00064-40.jpg,38,38,33,5,5,0.868421052631579,0.868421052631579
2022,KHOUALKA,CITRUS VOLKAMERIANA,30235,IMG-00067-40.jpg,107,106,99,7,8,0.9339622641509434,0.9252336448598132
2022,KHOUALKA,CITRUS VOLKAMERIANA,30235,IMG-00069-40.jpg,34,36,32,4,2,0.8888888888888888,0.9411764705882352
2022,KHOUALKA,CITRUS VOLKAMERIANA,30235,IMG-00075-40.jpg,95,101,90,11,5,0.8910891089108911,0.9473684210526316
2022,KHOUALKA,BIGARADIER,40141,IMG-00006-40.jpg,7,9,6,3,1,0.6666666666666666,0.8571428571428571
2022,KHOUALKA,BIGARADIER,40141,IMG-00007-40.jpg,20,16,11,5,9,0.6875,0.55
2022,KHOUALKA,BIGARADIER,40141,IMG-00008-40.jpg,15,14,12,2,3,0.8571428571428571,0.8
2022,ONAGRI,CITRANGE C35,40166,IMG-00009-39.jpg,38,37,35,2,3,0.945945945945946,0.9210526315789472
2022,ONAGRI,CITRANGE C35,40166,IMG-00011-39.jpg,173,182,167,15,6,0.9175824175824177,0.9653179190751444
2022,ONAGRI,CITRANGE C35,40166,IMG-00014-39.jpg,179,178,174,4,5,0.9775280898876404,0.9720670391061452
2022,ONAGRI,CITRANGE C35,40166,IMG-00015-39.jpg,122,125,115,10,7,0.92,0.9426229508196722
2022,ONAGRI,CITRANGE C35,40166,IMG-00041-39.jpg,102,101,99,2,3,0.9801980198019802,0.9705882352941176
2022,ONAGRI,CITRANGE C35,40167,IMG-00019-39.jpg,197,193,190,3,7,0.9844559585492229,0.964467005076142
2022,ONAGRI,CITRANGE C35,40167,IMG-00030-39.jpg,126,124,123,1,3,0.9919354838709676,0.9761904761904762
2022,ONAGRI,CITRANGE C35,40167,IMG-00039-39.jpg,217,216,204,12,13,0.9444444444444444,0.9400921658986175
2022,ONAGRI,CITRANGE C35,40171,IMG-00008-39.jpg,109,108,105,3,4,0.9722222222222222,0.963302752293578
2022,ONAGRI,CITRANGE C35,40171,IMG-00037-39.jpg,94,92,87,5,7,0.9456521739130436,0.925531914893617
2022,ONAGRI,CITRANGE C35,40171,IMG-00040-39.jpg,149,147,138,9,11,0.9387755102040816,0.9261744966442952
2022,ONAGRI,CITRANGE C35,40172,IMG-00012-39.jpg,89,83,81,2,8,0.9759036144578314,0.9101123595505618
2022,ONAGRI,CITRANGE C35,40172,IMG-00025-39.jpg,109,104,101,3,8,0.971153846153846,0.926605504587156
2022,ONAGRI,CITRANGE C35,40172,IMG-00027-39.jpg,103,95,91,4,12,0.9578947368421052,0.883495145631068
2022,ONAGRI,CITRANGE C35,40173,IMG-00004-39.jpg,133,122,121,1,12,0.9918032786885246,0.9097744360902256
2022,ONAGRI,CITRANGE C35,40173,IMG-00008-39.jpg,57,48,47,1,10,0.9791666666666666,0.8245614035087719
2022,ONAGRI,CITRANGE C35,40173,IMG-00010-39.jpg,53,62,53,9,0,0.8548387096774194,1.0
2022,ONAGRI,CITRANGE C35,40175,IMG-00005-39.jpg,95,86,82,4,13,0.9534883720930232,0.8631578947368421
2022,ONAGRI,CITRANGE C35,40175,IMG-00006-39.jpg,64,67,62,5,2,0.9253731343283582,0.96875
2022,ONAGRI,CITRANGE C35,40176,IMG-00004-39.jpg,79,86,74,12,5,0.8604651162790697,0.9367088607594936
2022,ONAGRI,CITRANGE C35,40176,IMG-00012-39.jpg,105,113,102,11,3,0.9026548672566372,0.9714285714285714
2022,ONAGRI,CITRANGE C35,40176,IMG-00014-39.jpg,91,98,86,12,5,0.8775510204081632,0.945054945054945
2022,ONAGRI,CITRUMELO SACCATON,40177,IMG-00012-39.jpg,89,101,86,15,3,0.8514851485148515,0.9662921348314608
2022,ONAGRI,CITRUMELO SACCATON,40177,IMG-00015-39.jpg,213,222,208,14,5,0.9369369369369368,0.976525821596244
2022,ONAGRI,CITRUMELO SACCATON,40177,IMG-00037-39.jpg,95,99,92,7,3,0.9292929292929292,0.968421052631579
2022,ONAGRI,CITRANGE C35,40178,IMG-00013-39.jpg,76,80,76,4,0,0.95,1.0
2022,ONAGRI,CITRANGE C35,40178,IMG-00027-39.jpg,56,56,55,1,1,0.9821428571428572,0.9821428571428572
2022,ONAGRI,CITRANGE C35,40178,IMG-00031-39.jpg,30,33,30,3,0,0.9090909090909092,1.0
2022,ONAGRI,CITRANGE C35,40178,IMG-00032-39.jpg,27,30,27,3,0,0.9,1.0
2022,ONAGRI,CITRANGE C35,40178,IMG-00033-39.jpg,34,35,33,2,1,0.9428571428571428,0.9705882352941176
2022,ONAGRI,CITRANGE C35,40179,IMG-00001.jpg,83,87,80,7,3,0.9195402298850576,0.963855421686747
2022,ONAGRI,CITRANGE C35,40179,IMG-00010-39.jpg,161,165,153,12,8,0.9272727272727272,0.9503105590062112
2022,ONAGRI,CITRANGE C35,40179,IMG-00011-39.jpg,102,107,98,9,4,0.9158878504672896,0.9607843137254902
2022,ONAGRI,CITRANGE C35,40179,IMG-00018-39.jpg,9,10,8,2,1,0.8,0.8888888888888888
2022,ONAGRI,CITRUMELO SACCATON,40182,IMG-00004-39.jpg,35,39,35,4,0,0.8974358974358975,1.0
2022,ONAGRI,CITRUMELO SACCATON,40182,IMG-00010-39.jpg,52,53,49,4,3,0.9245283018867924,0.9423076923076924
2022,ONAGRI,CITRUMELO SACCATON,40182,IMG-00015-39.jpg,85,90,81,9,4,0.9,0.9529411764705882
2022,ONAGRI,CITRUMELO SACCATON,40183,IMG-00005-39.jpg,68,69,67,2,1,0.9710144927536232,0.9852941176470588
2022,ONAGRI,CITRUMELO SACCATON,40183,IMG-00009-39.jpg,57,61,56,5,1,0.918032786885246,0.9824561403508772
2022,ONAGRI,CITRUMELO SACCATON,40183,IMG-00010-39.jpg,48,51,47,4,1,0.9215686274509804,0.9791666666666666
2024,KHOUALKA,CITRUS VOLKAMERIANA,50152,IMG-17274.jpg,170,131,129,2,41,0.9847328244274808,0.7588235294117647
2024,KHOUALKA,CITRUS VOLKAMERIANA,50152,IMG-17306.jpg,105,88,87,1,18,0.9886363636363636,0.8285714285714286
2024,KHOUALKA,CITRUS VOLKAMERIANA,50152,IMG-17330.jpg,41,31,31,0,10,1.0,0.7560975609756098
2024,KHOUALKA,CITRUS VOLKAMERIANA,50152,IMG-17335.jpg,44,34,34,0,10,1.0,0.7727272727272727
2024,KHOUALKA,CITRUS VOLKAMERIANA,50152,IMG-17340.jpg,108,76,75,1,33,0.986842105263158,0.6944444444444444
2024,KHOUALKA,CITRUS VOLKAMERIANA,50152,IMG-17356.jpg,60,45,42,3,18,0.9333333333333332,0.7
2024,KHOUALKA,CITRUS VOLKAMERIANA,50152,IMG-17384.jpg,53,36,36,0,17,1.0,0.6792452830188679
2024,KHOUALKA,CITRUS VOLKAMERIANA,50154,IMG-17440.jpg,76,64,64,0,12,1.0,0.8421052631578947
2024,KHOUALKA,CITRUS VOLKAMERIANA,50154,IMG-17490.jpg,107,78,78,0,29,1.0,0.7289719626168224
2024,KHOUALKA,CITRUS VOLKAMERIANA,50154,IMG-17543.jpg,100,70,70,0,30,1.0,0.7
2024,KHOUALKA,CITRUS VOLKAMERIANA,50154,IMG-17545.jpg,94,73,72,1,22,0.9863013698630136,0.7659574468085106
2024,KHOUALKA,CITRUS VOLKAMERIANA,50154,IMG-17562.jpg,129,107,107,0,22,1.0,0.8294573643410853
2024,KHOUALKA,CITRUS VOLKAMERIANA,50154,IMG-17576.jpg,121,99,98,1,23,0.98989898989899,0.8099173553719008
2024,KHOUALKA,CITRUS VOLKAMERIANA,50154,IMG-17585.jpg,171,136,133,3,38,0.9779411764705882,0.7777777777777778
2024,KHOUALKA,CITRUS VOLKAMERIANA,50168,IMG-13980.jpg,174,130,130,0,44,1.0,0.7471264367816092
2024,KHOUALKA,CITRUS VOLKAMERIANA,50168,IMG-15749.jpg,147,116,116,0,31,1.0,0.7891156462585034
2024,KHOUALKA,CITRUS VOLKAMERIANA,50168,IMG-15758.jpg,163,129,128,1,35,0.992248062015504,0.7852760736196319
2024,KHOUALKA,CITRUS VOLKAMERIANA,50168,IMG-15981.jpg,210,161,159,2,51,0.9875776397515528,0.7571428571428571
2024,KHOUALKA,CITRUS VOLKAMERIANA,50168,IMG-15983.jpg,120,84,84,0,36,1.0,0.7
2024,KHOUALKA,CITRUS VOLKAMERIANA,50176,IMG-16025.jpg,81,64,64,0,17,1.0,0.7901234567901234
2024,KHOUALKA,CITRUS VOLKAMERIANA,50176,IMG-16051.jpg,85,61,61,0,24,1.0,0.7176470588235294
2024,KHOUALKA,CITRUS VOLKAMERIANA,50176,IMG-16079.jpg,161,121,120,1,41,0.9917355371900828,0.7453416149068323
2024,KHOUALKA,CITRUS VOLKAMERIANA,50176,IMG-16095.jpg,101,67,67,0,34,1.0,0.6633663366336634
2024,KHOUALKA,CITRUS VOLKAMERIANA,50176,IMG-16105.jpg,43,31,31,0,12,1.0,0.7209302325581395
2022,ONAGRI,CITRUMELO SACCATON,50193,IMG-00007-39.jpg,218,237,218,19,0,0.919831223628692,1.0
2022,ONAGRI,CITRUMELO SACCATON,50193,IMG-00016-39.jpg,64,73,61,12,3,0.8356164383561644,0.953125
2022,ONAGRI,CITRUMELO SACCATON,50193,IMG-00018-39.jpg,115,122,113,9,2,0.9262295081967212,0.982608695652174
2022,ONAGRI,CITRUMELO SACCATON,50193,IMG-00021-39.jpg,62,62,59,3,3,0.9516129032258064,0.9516129032258064
2022,ONAGRI,CITRUMELO SACCATON,50193,IMG-00023-39.jpg,113,125,112,13,1,0.896,0.991150442477876
2022,ONAGRI,CITRUMELO SACCATON,50194,IMG-00032-39.jpg,162,169,154,15,8,0.9112426035502958,0.9506172839506172
2022,ONAGRI,CITRUMELO SACCATON,50194,IMG-00034-39.jpg,105,115,104,11,1,0.9043478260869564,0.9904761904761904
2022,ONAGRI,CITRUMELO SACCATON,50194,IMG-00036-39.jpg,161,190,153,37,8,0.8052631578947368,0.9503105590062112
2022,ONAGRI,CITRUMELO SACCATON,50194,IMG-00038-39.jpg,100,116,97,19,3,0.8362068965517241,0.97
2022,ONAGRI,CITRUMELO SACCATON,50194,IMG-00039-39.jpg,65,67,63,4,2,0.9402985074626866,0.9692307692307692
2022,ONAGRI,CITRUMELO SACCATON,50194,IMG-00041-39.jpg,153,159,148,11,5,0.9308176100628932,0.9673202614379084
2022,ONAGRI,CITRUMELO SACCATON,50194,IMG-00051-39.jpg,137,144,133,11,4,0.9236111111111112,0.9708029197080292
2022,ONAGRI,CITRUMELO SACCATON,50194,IMG-00054-39.jpg,111,111,105,6,6,0.945945945945946,0.945945945945946
2022,ONAGRI,CITRUMELO SACCATON,51091,IMG-00015-39.jpg,85,95,83,12,2,0.8736842105263158,0.976470588235294
2022,ONAGRI,CITRUMELO SACCATON,51091,IMG-00016-39.jpg,170,182,169,13,1,0.9285714285714286,0.9941176470588236
2022,ONAGRI,CITRUMELO SACCATON,51091,IMG-00018-39.jpg,185,209,183,26,2,0.8755980861244019,0.9891891891891892
2022,ONAGRI,CITRUMELO SACCATON,51091,IMG-00022-39.jpg,135,155,133,22,2,0.8580645161290322,0.9851851851851852
2022,ONAGRI,CITRUMELO SACCATON,51091,IMG-00023-39.jpg,140,145,134,11,6,0.9241379310344828,0.9571428571428572
2022,ONAGRI,CITRUMELO SACCATON,51091,IMG-00026-39.jpg,149,150,141,9,8,0.94,0.9463087248322148
2022,ONAGRI,CITRUMELO SACCATON,51091,IMG-00044-39.jpg,168,183,167,16,1,0.912568306010929,0.9940476190476192
2022,ONAGRI,CITRUMELO SACCATON,51095,IMG-00004-39.jpg,201,225,199,26,2,0.8844444444444445,0.9900497512437813
2022,ONAGRI,CITRUMELO SACCATON,51095,IMG-00013-39.jpg,154,157,146,11,8,0.929936305732484,0.948051948051948
2022,ONAGRI,CITRUMELO SACCATON,51095,IMG-00014-39.jpg,140,150,134,16,6,0.8933333333333333,0.9571428571428572
2022,ONAGRI,CITRUMELO SACCATON,51095,IMG-00015-39.jpg,196,204,194,10,2,0.9509803921568628,0.9897959183673468
2022,ONAGRI,CITRUMELO SACCATON,51095,IMG-00024-39.jpg,234,240,224,16,10,0.9333333333333332,0.9572649572649572
2022,ONAGRI,CITRUMELO SACCATON,51095,IMG-00025-39.jpg,198,212,194,18,4,0.9150943396226416,0.9797979797979798
2022,ONAGRI,CITRUMELO SACCATON,51096,IMG-00009-39.jpg,219,227,212,15,7,0.933920704845815,0.9680365296803652
2022,ONAGRI,CITRUMELO SACCATON,51096,IMG-00011-39.jpg,145,161,141,20,4,0.8757763975155279,0.9724137931034482
2022,ONAGRI,CITRUMELO SACCATON,51096,IMG-00012-39.jpg,114,118,109,9,5,0.923728813559322,0.956140350877193
2022,ONAGRI,CITRUMELO SACCATON,51096,IMG-00055-39.jpg,217,216,206,10,11,0.9537037037037036,0.9493087557603688
2022,ONAGRI,MC PONSIRUCE TRIFOLIATA,51097,IMG-00025-39.jpg,121,132,114,18,7,0.8636363636363636,0.9421487603305784
2022,ONAGRI,MC PONSIRUCE TRIFOLIATA,51097,IMG-00029-39.jpg,106,119,104,15,2,0.8739495798319328,0.981132075471698
2022,ONAGRI,MC PONSIRUCE TRIFOLIATA,51097,IMG-00044-39.jpg,182,194,178,16,4,0.9175257731958762,0.978021978021978
2022,ONAGRI,MC PONSIRUCE TRIFOLIATA,51098,IMG-00003-39.jpg,65,70,61,9,4,0.8714285714285714,0.9384615384615383
2022,ONAGRI,MC PONSIRUCE TRIFOLIATA,51098,IMG-00010-39.jpg,184,190,179,11,5,0.9421052631578948,0.9728260869565216
2022,ONAGRI,MC PONSIRUCE TRIFOLIATA,51098,IMG-00015-39.jpg,162,173,162,11,0,0.9364161849710982,1.0
2022,ONAGRI,MC PONSIRUCE TRIFOLIATA,51099,IMG-00012-39.jpg,133,147,131,16,2,0.891156462585034,0.9849624060150376
2024,ONAGRI,MC PONSIRUCE TRIFOLIATA,51101,IMG-12118.jpg,177,127,126,1,51,0.9921259842519684,0.711864406779661
2024,ONAGRI,MC PONSIRUCE TRIFOLIATA,51101,IMG-14223.jpg,153,122,122,0,31,1.0,0.7973856209150327
2024,ONAGRI,MC PONSIRUCE TRIFOLIATA,51101,IMG-14226.jpg,151,135,133,2,18,0.9851851851851852,0.8807947019867549
2024,ONAGRI,MC PONSIRUCE TRIFOLIATA,51101,IMG-14255.jpg,189,164,160,4,29,0.975609756097561,0.8465608465608465
2024,ONAGRI,MC PONSIRUCE TRIFOLIATA,51101,IMG-14281.jpg,150,129,126,3,24,0.9767441860465116,0.84
2022,ONAGRI,CITRUS VOLKAMERIANA,101020,IMG-00001.jpg,6,7,6,1,0,0.8571428571428571,1.0
2022,ONAGRI,CITRUS VOLKAMERIANA,101020,IMG-00004-44.jpg,53,51,49,2,4,0.9607843137254902,0.9245283018867924
2022,ONAGRI,CITRUS VOLKAMERIANA,101030,IMG-00003-44.jpg,29,29,26,3,3,0.896551724137931,0.896551724137931
2022,ONAGRI,CITRUS VOLKAMERIANA,101030,IMG-00004-44.jpg,110,106,103,3,7,0.9716981132075472,0.9363636363636364
2022,ONAGRI,CITRUS VOLKAMERIANA,101030,IMG-00005-44.jpg,134,130,125,5,9,0.9615384615384616,0.9328358208955224
2022,ONAGRI,CITRUS VOLKAMERIANA,101030,IMG-00017-44.jpg,79,74,71,3,8,0.9594594594594594,0.8987341772151899
2022,ONAGRI,CITRUS VOLKAMERIANA,101040,IMG-00005-44.jpg,172,159,157,2,15,0.9874213836477987,0.9127906976744186
2022,ONAGRI,CITRUS VOLKAMERIANA,101040,IMG-00009-44.jpg,131,139,128,11,3,0.920863309352518,0.9770992366412212
2022,ONAGRI,CITRUS VOLKAMERIANA,101040,IMG-00011-44.jpg,64,65,63,2,1,0.9692307692307692,0.984375
2022,ONAGRI,CITRUS VOLKAMERIANA,101040,IMG-00012-44.jpg,139,134,128,6,11,0.9552238805970148,0.920863309352518
2022,ONAGRI,CITRUS VOLKAMERIANA,101050,IMG-00002-44.jpg,95,95,90,5,5,0.9473684210526316,0.9473684210526316
2022,ONAGRI,CITRUS VOLKAMERIANA,101050,IMG-00005-44.jpg,59,55,55,0,4,1.0,0.9322033898305084
2022,ONAGRI,CITRUS VOLKAMERIANA,101050,IMG-00011-44.jpg,46,46,45,1,1,0.9782608695652174,0.9782608695652174
2022,ONAGRI,CITRUS VOLKAMERIANA,101050,IMG-00024-44.jpg,40,42,40,2,0,0.9523809523809524,1.0
2022,ONAGRI,CITRUS VOLKAMERIANA,101080,IMG-00005-44.jpg,42,41,39,2,3,0.951219512195122,0.9285714285714286
2022,ONAGRI,CITRUS VOLKAMERIANA,101080,IMG-00006-44.jpg,79,72,69,3,10,0.9583333333333334,0.8734177215189873
2022,ONAGRI,CITRUS VOLKAMERIANA,101080,IMG-00023-44.jpg,7,7,7,0,0,1.0,1.0
2022,ONAGRI,CITRUS VOLKAMERIANA,101080,IMG-00024-44.jpg,27,25,24,1,3,0.96,0.8888888888888888
2022,ONAGRI,CITRUS VOLKAMERIANA,101090,IMG-00003-44.jpg,66,66,64,2,2,0.9696969696969696,0.9696969696969696
2022,ONAGRI,CITRUS VOLKAMERIANA,101090,IMG-00006-44.jpg,41,38,37,1,4,0.9736842105263158,0.902439024390244
2022,ONAGRI,CITRUS VOLKAMERIANA,101090,IMG-00019-44.jpg,35,37,34,3,1,0.918918918918919,0.9714285714285714
2022,ONAGRI,CITRUS VOLKAMERIANA,101090,IMG-00020-44.jpg,42,40,39,1,3,0.975,0.9285714285714286
2022,KHOUALKA,CITRANGE CARRIZO,102130,IMG-00001.jpg,5,4,3,1,2,0.75,0.6
2022,KHOUALKA,CITRANGE CARRIZO,102130,IMG-00004-43.jpg,24,17,17,0,7,1.0,0.7083333333333334
2022,KHOUALKA,CITRANGE CARRIZO,102130,IMG-00019-43.jpg,33,27,27,0,6,1.0,0.8181818181818182
2022,KHOUALKA,CITRANGE CARRIZO,102130,IMG-00020-43.jpg,18,23,16,7,2,0.6956521739130435,0.8888888888888888
2022,KHOUALKA,MACROPHYLLA,201180,IMG-00007-43.jpg,38,45,38,7,0,0.8444444444444444,1.0
2022,KHOUALKA,MACROPHYLLA,201180,IMG-00011-43.jpg,64,63,60,3,4,0.9523809523809524,0.9375
2022,KHOUALKA,MACROPHYLLA,201180,IMG-00019-43.jpg,64,60,59,1,5,0.9833333333333332,0.921875
2022,KHOUALKA,MACROPHYLLA,201180,IMG-00020-43.jpg,43,43,37,6,6,0.8604651162790697,0.8604651162790697
2022,KHOUALKA,MACROPHYLLA,201190,IMG-00004-43.jpg,101,76,75,1,26,0.986842105263158,0.7425742574257426
2022,KHOUALKA,MACROPHYLLA,201190,IMG-00010-43.jpg,90,65,65,0,25,1.0,0.7222222222222222
2022,KHOUALKA,MACROPHYLLA,201190,IMG-00011-43.jpg,134,101,101,0,33,1.0,0.753731343283582
2022,KHOUALKA,MACROPHYLLA,201190,IMG-00020-43.jpg,95,69,66,3,29,0.9565217391304348,0.6947368421052632
2022,KHOUALKA,CITRUS VOLKAMERIANA,201210,IMG-00011-43.jpg,103,101,99,2,4,0.9801980198019802,0.9611650485436892
2022,KHOUALKA,CITRUS VOLKAMERIANA,201210,IMG-00012-43.jpg,42,41,41,0,1,1.0,0.9761904761904762
2022,KHOUALKA,CITRUS VOLKAMERIANA,201210,IMG-00015-43.jpg,77,73,72,1,5,0.9863013698630136,0.935064935064935
2022,KHOUALKA,CITRUS VOLKAMERIANA,201210,IMG-00019-43.jpg,31,30,30,0,1,1.0,0.967741935483871
2022,KHOUALKA,BIGARADIER,201320,IMG-00006-43.jpg,87,80,78,2,9,0.975,0.896551724137931
2022,KHOUALKA,BIGARADIER,201320,IMG-00016-43.jpg,97,95,90,5,7,0.9473684210526316,0.9278350515463918
2022,KHOUALKA,BIGARADIER,201320,IMG-00017-43.jpg,49,47,43,4,6,0.9148936170212766,0.8775510204081632
2022,KHOUALKA,BIGARADIER,201320,IMG-00020-43.jpg,88,85,84,1,4,0.9882352941176472,0.9545454545454546
2022,ONAGRI,BIGARADIER,201390,IMG-00008-44.jpg,62,53,52,1,10,0.981132075471698,0.8387096774193549
2022,ONAGRI,BIGARADIER,201390,IMG-00011-44.jpg,90,79,74,5,16,0.9367088607594936,0.8222222222222222
2022,ONAGRI,BIGARADIER,201390,IMG-00013-44.jpg,77,44,42,2,35,0.9545454545454546,0.5454545454545454
2022,ONAGRI,BIGARADIER,201390,IMG-00016-44.jpg,69,54,53,1,16,0.9814814814814816,0.7681159420289855
2022,KHOUALKA,CITRUS VOLKAMERIANA,202050,IMG-00006-43.jpg,89,89,87,2,2,0.9775280898876404,0.9775280898876404
2022,KHOUALKA,CITRUS VOLKAMERIANA,202050,IMG-00010-43.jpg,94,88,88,0,6,1.0,0.9361702127659576
2022,KHOUALKA,CITRUS VOLKAMERIANA,202050,IMG-00011-43.jpg,151,150,146,4,5,0.9733333333333334,0.9668874172185432
2022,KHOUALKA,CITRUS VOLKAMERIANA,202050,IMG-00020-43.jpg,129,125,123,2,6,0.984,0.9534883720930232
2022,KHOUALKA,CITRUS VOLKAMERIANA,202070,IMG-00006-43.jpg,68,68,67,1,1,0.9852941176470588,0.9852941176470588
2022,KHOUALKA,CITRUS VOLKAMERIANA,202070,IMG-00009-43.jpg,120,124,118,6,2,0.9516129032258064,0.9833333333333332
2022,KHOUALKA,CITRUS VOLKAMERIANA,202070,IMG-00013-43.jpg,95,90,89,1,6,0.9888888888888888,0.936842105263158
2022,KHOUALKA,CITRUS VOLKAMERIANA,202070,IMG-00019-43.jpg,57,59,56,3,1,0.9491525423728814,0.9824561403508772
2022,KHOUALKA,CITRUS VOLKAMERIANA,202080,IMG-00005-43.jpg,65,66,64,2,1,0.9696969696969696,0.9846153846153848
2022,KHOUALKA,CITRUS VOLKAMERIANA,202080,IMG-00008-43.jpg,31,30,30,0,1,1.0,0.967741935483871
2022,KHOUALKA,CITRUS VOLKAMERIANA,202080,IMG-00015-43.jpg,220,218,211,7,9,0.9678899082568808,0.9590909090909092
2022,KHOUALKA,CITRUS VOLKAMERIANA,202080,IMG-00016-43.jpg,131,132,129,3,2,0.9772727272727272,0.9847328244274808
2022,KHOUALKA,CITRANGE CARRIZO,301380,IMG-00007-43.jpg,30,31,29,2,1,0.935483870967742,0.9666666666666668
2022,KHOUALKA,CITRANGE CARRIZO,301380,IMG-00011-43.jpg,53,55,53,2,0,0.9636363636363636,1.0
2022,KHOUALKA,CITRANGE CARRIZO,301380,IMG-00014-43.jpg,7,7,6,1,1,0.8571428571428571,0.8571428571428571
2022,KHOUALKA,CITRANGE CARRIZO,301380,IMG-00020-43.jpg,91,98,89,9,2,0.9081632653061223,0.978021978021978
2022,ONAGRI,CITRUS VOLKAMERIANA,301470,IMG-00003-44.jpg,148,145,139,6,9,0.9586206896551724,0.9391891891891893
2022,ONAGRI,CITRUS VOLKAMERIANA,301470,IMG-00004-44.jpg,163,143,137,6,26,0.958041958041958,0.8404907975460123
2022,ONAGRI,CITRUS VOLKAMERIANA,301470,IMG-00005-44.jpg,160,135,131,4,29,0.9703703703703704,0.81875
2022,ONAGRI,CITRUS VOLKAMERIANA,301480,IMG-00001.jpg,92,69,68,1,24,0.9855072463768116,0.7391304347826086
2022,ONAGRI,CITRUS VOLKAMERIANA,301480,IMG-00003-43.jpg,26,20,20,0,6,1.0,0.7692307692307693
2022,ONAGRI,CITRUS VOLKAMERIANA,301480,IMG-00012-43.jpg,50,43,39,4,11,0.9069767441860463,0.78
2022,ONAGRI,CITRUS VOLKAMERIANA,301480,IMG-00014-43.jpg,77,64,64,0,13,1.0,0.8311688311688312
2022,ONAGRI,CITRUS VOLKAMERIANA,301490,IMG-00005-44.jpg,108,82,82,0,26,1.0,0.7592592592592593
2022,ONAGRI,CITRUS VOLKAMERIANA,301490,IMG-00009-44.jpg,185,158,151,7,34,0.9556962025316456,0.8162162162162162
2022,ONAGRI,CITRUS VOLKAMERIANA,301490,IMG-00012-44.jpg,162,148,144,4,18,0.972972972972973,0.8888888888888888
2022,ONAGRI,CITRUS VOLKAMERIANA,301490,IMG-00015-44.jpg,109,98,95,3,14,0.9693877551020408,0.8715596330275229
2022,ONAGRI,CITRUS VOLKAMERIANA,301510,IMG-00001.jpg,252,213,209,4,43,0.9812206572769951,0.8293650793650794
2022,ONAGRI,CITRUS VOLKAMERIANA,301510,IMG-00006-44.jpg,137,128,123,5,14,0.9609375,0.8978102189781022
2022,ONAGRI,CITRUS VOLKAMERIANA,301510,IMG-00007-44.jpg,115,106,98,8,17,0.9245283018867924,0.8521739130434782
2022,ONAGRI,CITRUS VOLKAMERIANA,301510,IMG-00008-44.jpg,150,115,110,5,40,0.9565217391304348,0.7333333333333333
2022,ONAGRI,BIGARADIER,301550,IMG-00008-44.jpg,144,123,121,2,23,0.983739837398374,0.8402777777777778
2022,ONAGRI,BIGARADIER,301550,IMG-00011-44.jpg,40,33,32,1,8,0.9696969696969696,0.8
2022,ONAGRI,BIGARADIER,301550,IMG-00013-44.jpg,76,56,54,2,22,0.9642857142857144,0.7105263157894737
2022,ONAGRI,BIGARADIER,301550,IMG-00014-44.jpg,80,77,69,8,11,0.8961038961038961,0.8625
2022,ONAGRI,CITRUS VOLKAMERIANA,301570,IMG-00004-44.jpg,158,150,144,6,14,0.96,0.9113924050632912
2022,ONAGRI,CITRUS VOLKAMERIANA,301570,IMG-00007-44.jpg,152,137,133,4,19,0.9708029197080292,0.875
2022,ONAGRI,CITRUS VOLKAMERIANA,301570,IMG-00008-44.jpg,103,87,82,5,21,0.942528735632184,0.7961165048543689
2022,ONAGRI,CITRUS VOLKAMERIANA,301570,IMG-00017-44.jpg,218,195,189,6,29,0.9692307692307692,0.8669724770642202
2022,KHOUALKA,CITRUS VOLKAMERIANA,302340,IMG-00004-43.jpg,106,85,85,0,21,1.0,0.8018867924528302
2022,KHOUALKA,CITRUS VOLKAMERIANA,302340,IMG-00005-43.jpg,105,83,82,1,23,0.9879518072289156,0.780952380952381
2022,KHOUALKA,CITRUS VOLKAMERIANA,302340,IMG-00011-43.jpg,75,59,59,0,16,1.0,0.7866666666666666
2022,KHOUALKA,CITRUS VOLKAMERIANA,302340,IMG-00015-43.jpg,92,79,76,3,16,0.9620253164556962,0.8260869565217391
2022,KHOUALKA,CITRUS VOLKAMERIANA,302350,IMG-00008-43.jpg,33,36,33,3,0,0.9166666666666666,1.0
2022,KHOUALKA,CITRUS VOLKAMERIANA,302350,IMG-00013-43.jpg,80,80,74,6,6,0.925,0.925
2022,KHOUALKA,CITRUS VOLKAMERIANA,302350,IMG-00014-43.jpg,76,71,66,5,10,0.9295774647887324,0.868421052631579
2022,KHOUALKA,CITRUS VOLKAMERIANA,302350,IMG-00018-43.jpg,44,43,41,2,3,0.9534883720930232,0.9318181818181818
2022,KHOUALKA,CITRUS VOLKAMERIANA,302360,IMG-00005-43.jpg,97,83,83,0,14,1.0,0.8556701030927835
2022,KHOUALKA,CITRUS VOLKAMERIANA,302360,IMG-00006-43.jpg,118,100,99,1,19,0.99,0.8389830508474576
2022,KHOUALKA,CITRUS VOLKAMERIANA,302360,IMG-00016-43.jpg,67,57,57,0,10,1.0,0.8507462686567164
2022,KHOUALKA,CITRUS VOLKAMERIANA,302360,IMG-00021-43.jpg,65,63,61,2,4,0.9682539682539684,0.9384615384615383
2022,KHOUALKA,CITRUS VOLKAMERIANA,302510,IMG-00001.jpg,73,51,51,0,22,1.0,0.6986301369863014
2022,KHOUALKA,CITRUS VOLKAMERIANA,302510,IMG-00002-43.jpg,44,33,32,1,12,0.9696969696969696,0.7272727272727273
2022,KHOUALKA,CITRUS VOLKAMERIANA,302510,IMG-00003-43.jpg,78,70,70,0,8,1.0,0.8974358974358975
2022,KHOUALKA,CITRUS VOLKAMERIANA,302510,IMG-00015-43.jpg,49,33,33,0,16,1.0,0.673469387755102
2022,KHOUALKA,BIGARADIER,401410,IMG-00093-43.jpg,35,20,20,0,15,1.0,0.5714285714285714
2022,KHOUALKA,BIGARADIER,401410,IMG-00099-43.jpg,6,3,3,0,3,1.0,0.5
2022,KHOUALKA,BIGARADIER,401410,IMG-00102-43.jpg,78,61,59,2,19,0.9672131147540984,0.7564102564102564
2022,KHOUALKA,BIGARADIER,401410,IMG-00104-43.jpg,81,66,63,3,18,0.9545454545454546,0.7777777777777778
2022,ONAGRI,CITRANGE C35,401660,IMG-00001.jpg,56,49,47,2,9,0.9591836734693876,0.8392857142857143
2022,ONAGRI,CITRANGE C35,401660,IMG-00008-44.jpg,42,34,34,0,8,1.0,0.8095238095238095
2022,ONAGRI,CITRANGE C35,401660,IMG-00010-44.jpg,29,21,21,0,8,1.0,0.7241379310344828
2022,ONAGRI,CITRANGE C35,401660,IMG-00016-44.jpg,64,51,50,1,14,0.9803921568627452,0.78125
2022,ONAGRI,CITRANGE C35,401710,IMG-00003-44.jpg,51,40,39,1,12,0.975,0.7647058823529411
2022,ONAGRI,CITRANGE C35,401710,IMG-00012-44.jpg,19,18,18,0,1,1.0,0.9473684210526316
2022,ONAGRI,CITRANGE C35,401710,IMG-00013-44.jpg,33,28,27,1,6,0.9642857142857144,0.8181818181818182
2022,ONAGRI,CITRANGE C35,401710,IMG-00019-44.jpg,76,72,70,2,6,0.9722222222222222,0.9210526315789472
2022,ONAGRI,CITRANGE C35,401720,IMG-00007-44.jpg,93,91,91,0,2,1.0,0.978494623655914
2022,ONAGRI,CITRANGE C35,401720,IMG-00008-44.jpg,38,32,32,0,6,1.0,0.8421052631578947
2022,ONAGRI,CITRANGE C35,401720,IMG-00010-44.jpg,50,35,35,0,15,1.0,0.7
2022,ONAGRI,CITRANGE C35,401720,IMG-00017-44.jpg,68,55,55,0,13,1.0,0.8088235294117647
2022,ONAGRI,CITRANGE C35,401730,IMG-00001.jpg,19,17,17,0,2,1.0,0.8947368421052632
2022,ONAGRI,CITRANGE C35,401730,IMG-00010-44.jpg,50,47,47,0,3,1.0,0.94
2022,ONAGRI,CITRANGE C35,401730,IMG-00013-44.jpg,75,63,63,0,12,1.0,0.84
2022,ONAGRI,CITRANGE C35,401730,IMG-00016-44.jpg,36,30,30,0,6,1.0,0.8333333333333334
2022,ONAGRI,CITRANGE C35,401750,IMG-00005-44.jpg,88,57,56,1,32,0.9824561403508772,0.6363636363636364
2022,ONAGRI,CITRANGE C35,401750,IMG-00009-44.jpg,127,97,96,1,31,0.9896907216494846,0.7559055118110236
2022,ONAGRI,CITRANGE C35,401750,IMG-00016-44.jpg,107,77,77,0,30,1.0,0.719626168224299
2022,ONAGRI,CITRANGE C35,401750,IMG-00024-44.jpg,50,34,33,1,17,0.9705882352941176,0.66
2022,ONAGRI,CITRUMELO SACCATON,401770,IMG-00003-44.jpg,24,19,19,0,5,1.0,0.7916666666666666
2022,ONAGRI,CITRUMELO SACCATON,401770,IMG-00008-44.jpg,72,61,61,0,11,1.0,0.8472222222222222
2022,ONAGRI,CITRUMELO SACCATON,401770,IMG-00009-44.jpg,14,11,11,0,3,1.0,0.7857142857142857
2022,ONAGRI,CITRUMELO SACCATON,401770,IMG-00017-44.jpg,20,15,15,0,5,1.0,0.75
2022,KHOUALKA,BIGARADIER,402440,IMG-00005-43.jpg,17,10,9,1,8,0.9,0.5294117647058824
2022,KHOUALKA,BIGARADIER,402440,IMG-00012-43.jpg,46,33,33,0,13,1.0,0.717391304347826
2022,KHOUALKA,BIGARADIER,402440,IMG-00014-43.jpg,11,7,6,1,5,0.8571428571428571,0.5454545454545454
2022,KHOUALKA,BIGARADIER,402440,IMG-00015-43.jpg,22,9,9,0,13,1.0,0.4090909090909091
2022,KHOUALKA,BIGARADIER,402590,IMG-00007-43.jpg,104,74,73,1,31,0.9864864864864864,0.7019230769230769
2022,KHOUALKA,BIGARADIER,402590,IMG-00012-43.jpg,45,38,37,1,8,0.9736842105263158,0.8222222222222222
2022,KHOUALKA,BIGARADIER,402590,IMG-00015-43.jpg,58,48,47,1,11,0.9791666666666666,0.8103448275862069
2022,KHOUALKA,BIGARADIER,402590,IMG-00019-43.jpg,64,55,55,0,9,1.0,0.859375
2022,KHOUALKA,CITRUS VOLKAMERIANA,501520,IMG-00004-43.jpg,39,35,34,1,5,0.9714285714285714,0.8717948717948718
2022,KHOUALKA,CITRUS VOLKAMERIANA,501520,IMG-00007-43.jpg,43,35,35,0,8,1.0,0.813953488372093
2022,KHOUALKA,CITRUS VOLKAMERIANA,501520,IMG-00015-43.jpg,18,10,10,0,8,1.0,0.5555555555555556
2022,KHOUALKA,CITRUS VOLKAMERIANA,501520,IMG-00020-43.jpg,48,43,43,0,5,1.0,0.8958333333333334
2022,KHOUALKA,CITRUS VOLKAMERIANA,501540,IMG-00006-43.jpg,38,31,31,0,7,1.0,0.8157894736842105
2022,KHOUALKA,CITRUS VOLKAMERIANA,501540,IMG-00012-43.jpg,102,94,93,1,9,0.9893617021276596,0.9117647058823528
2022,KHOUALKA,CITRUS VOLKAMERIANA,501540,IMG-00017-43.jpg,138,119,119,0,19,1.0,0.8623188405797102
2022,KHOUALKA,CITRUS VOLKAMERIANA,501540,IMG-00018-43.jpg,51,44,43,1,8,0.9772727272727272,0.8431372549019608
2022,KHOUALKA,CITRUS VOLKAMERIANA,501660,IMG-00006-43.jpg,60,51,49,2,11,0.9607843137254902,0.8166666666666667
2022,KHOUALKA,CITRUS VOLKAMERIANA,501660,IMG-00016-43.jpg,63,49,49,0,14,1.0,0.7777777777777778
2022,KHOUALKA,CITRUS VOLKAMERIANA,501660,IMG-00018-43.jpg,112,84,84,0,28,1.0,0.75
2022,KHOUALKA,CITRUS VOLKAMERIANA,501660,IMG-00021-43.jpg,90,85,83,2,7,0.976470588235294,0.9222222222222224
2022,KHOUALKA,CITRUS VOLKAMERIANA,501680,IMG-00005-43.jpg,179,147,146,1,33,0.9931972789115646,0.8156424581005587
2022,KHOUALKA,CITRUS VOLKAMERIANA,501680,IMG-00011-43.jpg,101,78,78,0,23,1.0,0.7722772277227723
2022,KHOUALKA,CITRUS VOLKAMERIANA,501680,IMG-00012-43.jpg,76,51,50,1,26,0.9803921568627452,0.6578947368421053
2022,KHOUALKA,CITRUS VOLKAMERIANA,501680,IMG-00016-43.jpg,113,92,91,1,22,0.9891304347826086,0.8053097345132744
2022,KHOUALKA,CITRUS VOLKAMERIANA,501690,IMG-00032-43.jpg,34,22,22,0,12,1.0,0.6470588235294118
2022,KHOUALKA,CITRUS VOLKAMERIANA,501690,IMG-00039-43.jpg,186,141,139,2,47,0.9858156028368794,0.7473118279569892
2022,KHOUALKA,CITRUS VOLKAMERIANA,501690,IMG-00047-43.jpg,103,79,78,1,25,0.9873417721518988,0.7572815533980582
2022,KHOUALKA,CITRUS VOLKAMERIANA,501690,IMG-00049-43.jpg,166,145,141,4,25,0.9724137931034482,0.8493975903614458
2022,KHOUALKA,CITRUS VOLKAMERIANA,501760,IMG-00001.jpg,94,45,44,1,50,0.9777777777777776,0.4680851063829787
2022,KHOUALKA,CITRUS VOLKAMERIANA,501760,IMG-00034-43.jpg,45,19,19,0,26,1.0,0.4222222222222222
2022,KHOUALKA,CITRUS VOLKAMERIANA,501760,IMG-00036-43.jpg,40,25,23,2,17,0.92,0.575
2022,KHOUALKA,CITRUS VOLKAMERIANA,501760,IMG-00051-43.jpg,92,56,56,0,36,1.0,0.6086956521739131
2022,ONAGRI,CITRUMELO SACCATON,510910,IMG-00004-44.jpg,73,63,63,0,10,1.0,0.863013698630137
2022,ONAGRI,CITRUMELO SACCATON,510910,IMG-00008-44.jpg,152,108,108,0,44,1.0,0.7105263157894737
2022,ONAGRI,CITRUMELO SACCATON,510910,IMG-00010-44.jpg,107,86,85,1,22,0.9883720930232558,0.794392523364486
2022,ONAGRI,CITRUMELO SACCATON,510910,IMG-00011-44.jpg,92,75,75,0,17,1.0,0.8152173913043478
2022,ONAGRI,CITRUMELO SACCATON,510950,IMG-00006-44.jpg,70,60,60,0,10,1.0,0.8571428571428571
2022,ONAGRI,CITRUMELO SACCATON,510950,IMG-00008-44.jpg,75,56,56,0,19,1.0,0.7466666666666667
2022,ONAGRI,CITRUMELO SACCATON,510950,IMG-00009-44.jpg,85,67,66,1,19,0.9850746268656716,0.7764705882352941
2022,ONAGRI,CITRUMELO SACCATON,510950,IMG-00011-44.jpg,135,109,109,0,26,1.0,0.8074074074074075
2022,ONAGRI,MC PONSIRUCE TRIFOLIATA,510980,IMG-00014-44.jpg,67,54,52,2,15,0.9629629629629628,0.7761194029850746
2022,ONAGRI,MC PONSIRUCE TRIFOLIATA,510980,IMG-00015-44.jpg,51,44,43,1,8,0.9772727272727272,0.8431372549019608
2022,ONAGRI,MC PONSIRUCE TRIFOLIATA,510980,IMG-00016-44.jpg,99,79,79,0,20,1.0,0.797979797979798
2022,ONAGRI,MC PONSIRUCE TRIFOLIATA,510980,IMG-00019-44.jpg,102,82,79,3,23,0.9634146341463414,0.7745098039215687
2022,ONAGRI,MC PONSIRUCE TRIFOLIATA,510990,IMG-00006-44.jpg,135,106,106,0,29,1.0,0.7851851851851852
2022,ONAGRI,MC PONSIRUCE TRIFOLIATA,510990,IMG-00008-44.jpg,110,98,98,0,12,1.0,0.8909090909090909
2022,ONAGRI,MC PONSIRUCE TRIFOLIATA,510990,IMG-00009-44.jpg,85,74,74,0,11,1.0,0.8705882352941177
2022,ONAGRI,MC PONSIRUCE TRIFOLIATA,510990,IMG-00024-44.jpg,65,53,53,0,12,1.0,0.8153846153846154
2022,ONAGRI,MC PONSIRUCE TRIFOLIATA,511030,IMG-00007-44.jpg,100,85,83,2,17,0.976470588235294,0.83
2022,ONAGRI,MC PONSIRUCE TRIFOLIATA,511030,IMG-00016-44.jpg,63,54,53,1,10,0.9814814814814816,0.8412698412698413
2022,ONAGRI,MC PONSIRUCE TRIFOLIATA,511030,IMG-00022-44.jpg,98,86,84,2,14,0.9767441860465116,0.8571428571428571
2022,ONAGRI,MC PONSIRUCE TRIFOLIATA,511030,IMG-00027-44.jpg,82,73,72,1,10,0.9863013698630136,0.8780487804878049
2022,ONAGRI,MS PONSIRUCE TRIFOLIATA,511040,IMG-00004-44.jpg,77,62,62,0,15,1.0,0.8051948051948052
2022,ONAGRI,MS PONSIRUCE TRIFOLIATA,511040,IMG-00014-44.jpg,48,36,35,1,13,0.9722222222222222,0.7291666666666666
2022,ONAGRI,MS PONSIRUCE TRIFOLIATA,511040,IMG-00016-44.jpg,71,58,57,1,14,0.9827586206896552,0.8028169014084507
2022,ONAGRI,MS PONSIRUCE TRIFOLIATA,511040,IMG-00025-44.jpg,56,39,39,0,17,1.0,0.6964285714285714
2022,ONAGRI,FUZHU,511050,IMG-00004-44.jpg,109,86,82,4,27,0.9534883720930232,0.7522935779816514
2022,ONAGRI,FUZHU,511050,IMG-00006-44.jpg,142,103,103,0,39,1.0,0.7253521126760564
2022,ONAGRI,FUZHU,511050,IMG-00011-44.jpg,172,143,143,0,29,1.0,0.8313953488372093
2022,ONAGRI,FUZHU,511050,IMG-00022-44.jpg,194,153,152,1,42,0.9934640522875816,0.7835051546391752
2022,ONAGRI,MS PONSIRUCE TRIFOLIATA,511060,IMG-00007-44.jpg,115,100,98,2,17,0.98,0.8521739130434782
2022,ONAGRI,MS PONSIRUCE TRIFOLIATA,511060,IMG-00016-44.jpg,102,80,78,2,24,0.975,0.7647058823529411
2022,ONAGRI,MS PONSIRUCE TRIFOLIATA,511060,IMG-00017-44.jpg,59,42,42,0,17,1.0,0.711864406779661
2022,ONAGRI,MS PONSIRUCE TRIFOLIATA,511060,IMG-00019-44.jpg,108,86,85,1,23,0.9883720930232558,0.7870370370370371
2022,ONAGRI,FUZHU,511070,IMG-00006-44.jpg,82,76,74,2,8,0.9736842105263158,0.902439024390244
2022,ONAGRI,FUZHU,511070,IMG-00016-44.jpg,96,77,76,1,20,0.987012987012987,0.7916666666666666
2022,ONAGRI,FUZHU,511070,IMG-00018-44.jpg,93,75,74,1,19,0.9866666666666668,0.7956989247311828
2022,ONAGRI,FUZHU,511070,IMG-00019-44.jpg,142,120,118,2,24,0.9833333333333332,0.8309859154929577
