compagnie,Domaine,Porte-greffe,parcelle,Filename,True_count,detect_count,TP,FP,FN,Precision,Recall
2022,SAOUDA,BIGARADIER,10010,IMG-00011-45.jpg,28,28,28,0,0,1.0,1.0
2022,SAOUDA,BIGARADIER,10010,IMG-00012-45.jpg,27,26,26,0,1,1.0,0.9629629629629628
2022,SAOUDA,BIGARADIER,10010,IMG-00014-45.jpg,50,51,49,2,1,0.9607843137254902,0.98
2022,SAOUDA,BIGARADIER,10010,IMG-00018-45.jpg,30,29,29,0,1,1.0,0.9666666666666668
2022,SAOUDA,BIGARADIER,10010,IMG-00020-45.jpg,31,31,29,2,2,0.935483870967742,0.935483870967742
2024,SAOUDA,BIGARADIER,10010,IMG-23410.jpg,85,71,71,0,14,1.0,0.8352941176470589
2024,SAOUDA,BIGARADIER,10010,IMG-23417.jpg,86,68,68,0,18,1.0,0.7906976744186046
2024,SAOUDA,BIGARADIER,10010,IMG-23430.jpg,74,67,67,0,7,1.0,0.9054054054054054
2024,SAOUDA,BIGARADIER,10010,IMG-23647.jpg,95,85,83,2,12,0.976470588235294,0.8736842105263158
2024,SAOUDA,BIGARADIER,10010,IMG-23672.jpg,47,41,41,0,6,1.0,0.8723404255319149
2024,SAOUDA,BIGARADIER,10010,IMG-23707.jpg,30,29,28,1,2,0.9655172413793104,0.9333333333333332
2024,SAOUDA,BIGARADIER,10010,IMG-23709.jpg,31,26,26,0,5,1.0,0.8387096774193549
2024,SAOUDA,BIGARADIER,10010,IMG-23711.jpg,79,69,64,5,15,0.927536231884058,0.810126582278481
2022,SAOUDA,MACROPHYLLA,10030,IMG-00158-45.jpg,101,102,92,10,9,0.9019607843137256,0.9108910891089108
2022,SAOUDA,MACROPHYLLA,10030,IMG-00159-45.jpg,155,160,148,12,7,0.925,0.9548387096774194
2022,SAOUDA,MACROPHYLLA,10030,IMG-00162-45.jpg,119,119,115,4,4,0.9663865546218487,0.9663865546218487
2022,SAOUDA,MACROPHYLLA,10030,IMG-00169-45.jpg,72,72,70,2,2,0.9722222222222222,0.9722222222222222
2022,SAOUDA,MACROPHYLLA,10031,IMG-00002-45.jpg,46,44,40,4,6,0.9090909090909092,0.8695652173913043
2022,SAOUDA,MACROPHYLLA,10031,IMG-00084-45.jpg,41,42,39,3,2,0.9285714285714286,0.951219512195122
2022,SAOUDA,MACROPHYLLA,10031,IMG-00450-45.jpg,27,27,26,1,1,0.9629629629629628,0.9629629629629628
2022,SAOUDA,MACROPHYLLA,10031,IMG-00451-45.jpg,34,32,31,1,3,0.96875,0.9117647058823528
2022,SAOUDA,MACROPHYLLA,10031,IMG-00464-45.jpg,33,32,31,1,2,0.96875,0.9393939393939394
2022,ONAGRI,CITRUS VOLKAMERIANA,10101,IMG-00003-39.jpg,120,115,111,4,9,0.9652173913043478,0.925
2022,ONAGRI,CITRUS VOLKAMERIANA,10101,IMG-00010-39.jpg,85,76,69,7,16,0.9078947368421052,0.8117647058823529
2024,ONAGRI,CITRUS VOLKAMERIANA,10101,IMG-10523.jpg,288,259,255,4,33,0.9845559845559846,0.8854166666666666
2024,ONAGRI,CITRUS VOLKAMERIANA,10101,IMG-10545.jpg,98,96,96,0,2,1.0,0.979591836734694
2024,ONAGRI,CITRUS VOLKAMERIANA,10101,IMG-10558.jpg,143,138,135,3,8,0.9782608695652174,0.944055944055944
2022,ONAGRI,CITRUS VOLKAMERIANA,10102,IMG-00003-39.jpg,48,38,36,2,12,0.9473684210526316,0.75
2024,ONAGRI,CITRUS VOLKAMERIANA,10102,IMG-10637.jpg,140,138,135,3,5,0.9782608695652174,0.9642857142857144
2024,ONAGRI,CITRUS VOLKAMERIANA,10102,IMG-10658.jpg,163,156,152,4,11,0.9743589743589745,0.9325153374233128
2022,ONAGRI,CITRUS VOLKAMERIANA,10103,IMG-00003-39.jpg,215,191,186,5,29,0.9738219895287958,0.8651162790697674
2022,ONAGRI,CITRUS VOLKAMERIANA,10103,IMG-00008-39.jpg,195,186,176,10,19,0.946236559139785,0.9025641025641026
2024,ONAGRI,CITRUS VOLKAMERIANA,10103,IMG-10614.jpg,134,132,125,7,9,0.946969696969697,0.9328358208955224
2024,ONAGRI,CITRUS VOLKAMERIANA,10103,IMG-10630.jpg,213,205,202,3,11,0.9853658536585366,0.9483568075117372
2024,ONAGRI,CITRUS VOLKAMERIANA,10103,IMG-10631.jpg,134,123,123,0,11,1.0,0.917910447761194
2022,ONAGRI,CITRUS VOLKAMERIANA,10104,IMG-00004-39.jpg,65,60,57,3,8,0.95,0.8769230769230769
2022,ONAGRI,CITRUS VOLKAMERIANA,10104,IMG-00008-39.jpg,69,58,55,3,14,0.9482758620689656,0.7971014492753623
2024,ONAGRI,CITRUS VOLKAMERIANA,10104,IMG-11267.jpg,22,21,20,1,2,0.9523809523809524,0.9090909090909092
2024,ONAGRI,CITRUS VOLKAMERIANA,10104,IMG-11327.jpg,128,126,123,3,5,0.9761904761904762,0.9609375
2024,ONAGRI,CITRUS VOLKAMERIANA,10104,IMG-11347.jpg,118,113,111,2,7,0.9823008849557522,0.940677966101695
2024,ONAGRI,CITRUS VOLKAMERIANA,10104,IMG-11366.jpg,351,300,293,7,58,0.9766666666666668,0.8347578347578347
2024,ONAGRI,CITRUS VOLKAMERIANA,10104,IMG-11386.jpg,99,91,88,3,11,0.967032967032967,0.8888888888888888
2022,ONAGRI,CITRUS VOLKAMERIANA,10105,IMG-00004-39.jpg,17,18,15,3,2,0.8333333333333334,0.8823529411764706
2022,ONAGRI,CITRUS VOLKAMERIANA,10105,IMG-00005-39.jpg,68,71,65,6,3,0.9154929577464788,0.9558823529411764
2022,ONAGRI,CITRUS VOLKAMERIANA,10108,IMG-00003-39.jpg,61,54,54,0,7,1.0,0.8852459016393442
2022,ONAGRI,CITRUS VOLKAMERIANA,10108,IMG-00007-39.jpg,69,54,53,1,16,0.9814814814814816,0.7681159420289855
2022,ONAGRI,CITRUS VOLKAMERIANA,10109,IMG-00003-39.jpg,4,4,4,0,0,1.0,1.0
2022,ONAGRI,CITRUS VOLKAMERIANA,10109,IMG-00008-39.jpg,105,99,95,4,10,0.9595959595959596,0.9047619047619048
2022,KHOUALKA,CITRANGE CARRIZO,10213,IMG-00001.jpg,77,76,74,2,3,0.9736842105263158,0.961038961038961
2022,KHOUALKA,CITRANGE CARRIZO,10213,IMG-00005-40.jpg,73,72,70,2,3,0.9722222222222222,0.958904109589041
2022,KHOUALKA,CITRANGE CARRIZO,10213,IMG-00009-40.jpg,14,15,14,1,0,0.9333333333333332,1.0
2022,KHOUALKA,CITRANGE CARRIZO,10213,IMG-00014-40.jpg,21,19,18,1,3,0.9473684210526316,0.8571428571428571
2022,KHOUALKA,CITRANGE CARRIZO,10213,IMG-00028-40.jpg,47,47,46,1,1,0.9787234042553192,0.9787234042553192
2022,KHOUALKA,CITRANGE CARRIZO,10213,IMG-00034-40.jpg,48,48,48,0,0,1.0,1.0
2022,KHOUALKA,CITRANGE CARRIZO,10213,IMG-00035-40.jpg,37,37,36,1,1,0.972972972972973,0.972972972972973
2022,KHOUALKA,CITRANGE CARRIZO,10213,IMG-00036-40.jpg,47,50,46,4,1,0.92,0.9787234042553192
2022,KHOUALKA,CITRANGE CARRIZO,10213,IMG-00042-40.jpg,22,22,21,1,1,0.9545454545454546,0.9545454545454546
2022,KHOUALKA,CITRANGE CARRIZO,10213,IMG-00047-40.jpg,70,68,68,0,2,1.0,0.9714285714285714
2022,KHOUALKA,CITRANGE CARRIZO,10213,IMG-00054-40.jpg,33,33,32,1,1,0.9696969696969696,0.9696969696969696
2022,KHOUALKA,CITRANGE CARRIZO,10213,IMG-00055-40.jpg,93,91,91,0,2,1.0,0.978494623655914
2022,KHOUALKA,CITRANGE CARRIZO,10213,IMG-00061-40.jpg,113,114,110,4,3,0.9649122807017544,0.9734513274336284
2022,KHOUALKA,CITRANGE CARRIZO,10213,IMG-00066-40.jpg,48,48,46,2,2,0.9583333333333334,0.9583333333333334
2024,KHOUALKA,CITRANGE CARRIZO,10213,IMG-12628.jpg,119,100,100,0,19,1.0,0.8403361344537815
2024,KHOUALKA,CITRANGE CARRIZO,10213,IMG-12774.jpg,118,97,97,0,21,1.0,0.8220338983050848
2024,KHOUALKA,CITRANGE CARRIZO,10213,IMG-12780.jpg,44,38,38,0,6,1.0,0.8636363636363636
2024,KHOUALKA,CITRANGE CARRIZO,10213,IMG-12791.jpg,166,124,124,0,42,1.0,0.7469879518072289
2024,KHOUALKA,CITRANGE CARRIZO,10213,IMG-12834.jpg,57,44,43,1,14,0.9772727272727272,0.7543859649122807
2024,KHOUALKA,CITRANGE CARRIZO,10213,IMG-12945.jpg,130,103,103,0,27,1.0,0.7923076923076923
2022,OUARGHA,MACROPHYLLA,11010,IMG-00001.jpg,40,38,38,0,2,1.0,0.95
2022,OUARGHA,MACROPHYLLA,11010,IMG-00015-41.jpg,24,23,23,0,1,1.0,0.9583333333333334
2022,OUARGHA,MACROPHYLLA,11010,IMG-00019-41.jpg,20,23,19,4,1,0.8260869565217391,0.95
2022,OUARGHA,MACROPHYLLA,11010,IMG-00024-41.jpg,21,22,21,1,0,0.9545454545454546,1.0
2022,OUARGHA,MACROPHYLLA,11020,IMG-00017-41.jpg,51,53,51,2,0,0.9622641509433962,1.0
2022,OUARGHA,MACROPHYLLA,11020,IMG-00018-41.jpg,13,12,12,0,1,1.0,0.9230769230769232
2022,OUARGHA,CITRANGE CARRIZO,13010,IMG-00067-41.jpg,55,54,54,0,1,1.0,0.9818181818181818
2022,OUARGHA,CITRANGE CARRIZO,13010,IMG-00086-41.jpg,49,51,49,2,0,0.9607843137254902,1.0
2022,OUARGHA,CITRANGE CARRIZO,13010,IMG-00194-41.jpg,33,33,32,1,1,0.9696969696969696,0.9696969696969696
2022,OUARGHA,CITRANGE CARRIZO,13020,IMG-00023-41.jpg,31,30,29,1,2,0.9666666666666668,0.935483870967742
2022,OUARGHA,CITRANGE CARRIZO,13020,IMG-00024-41.jpg,18,18,18,0,0,1.0,1.0
2022,OUARGHA,CITRANGE CARRIZO,13020,IMG-00039-41.jpg,4,4,4,0,0,1.0,1.0
2022,OUARGHA,CITRANGE CARRIZO,13020,IMG-00040-41.jpg,6,5,5,0,1,1.0,0.8333333333333334
2022,OUARGHA,CITRUS VOLKAMERIANA,13030,IMG-00009-41.jpg,18,18,18,0,0,1.0,1.0
2022,OUARGHA,CITRUS VOLKAMERIANA,13030,IMG-00013-41.jpg,46,44,44,0,2,1.0,0.9565217391304348
2022,OUARGHA,CITRUS VOLKAMERIANA,13030,IMG-00027-41.jpg,12,12,11,1,1,0.9166666666666666,0.9166666666666666
2022,OUARGHA,CITRUS VOLKAMERIANA,13030,IMG-00029-41.jpg,18,18,18,0,0,1.0,1.0
2022,OUARGHA,CITRUS VOLKAMERIANA,13030,IMG-00036-41.jpg,16,16,14,2,2,0.875,0.875
2022,OUARGHA,CITRUS VOLKAMERIANA,14010,IMG-00008-41.jpg,40,41,37,4,3,0.902439024390244,0.925
2022,OUARGHA,CITRUS VOLKAMERIANA,14010,IMG-00010-41.jpg,49,49,48,1,1,0.979591836734694,0.979591836734694
2022,OUARGHA,CITRUS VOLKAMERIANA,14010,IMG-00011-41.jpg,47,47,46,1,1,0.9787234042553192,0.9787234042553192
2022,OUARGHA,CITRUS VOLKAMERIANA,14010,IMG-00018-41.jpg,44,44,42,2,2,0.9545454545454546,0.9545454545454546
2022,KHOUALKA,MACROPHYLLA,20118,IMG-00007-40.jpg,44,44,43,1,1,0.9772727272727272,0.9772727272727272
2022,KHOUALKA,MACROPHYLLA,20118,IMG-00008-40.jpg,115,116,114,2,1,0.9827586206896552,0.991304347826087
2022,KHOUALKA,MACROPHYLLA,20118,IMG-00022-40.jpg,113,112,112,0,1,1.0,0.991150442477876
2022,KHOUALKA,MACROPHYLLA,20118,IMG-00033-40.jpg,58,63,57,6,1,0.9047619047619048,0.9827586206896552
2022,KHOUALKA,MACROPHYLLA,20118,IMG-00037-40.jpg,29,29,28,1,1,0.9655172413793104,0.9655172413793104
2022,KHOUALKA,MACROPHYLLA,20118,IMG-00042-40.jpg,137,136,133,3,4,0.9779411764705882,0.9708029197080292
2022,KHOUALKA,MACROPHYLLA,20118,IMG-00046-40.jpg,45,47,44,3,1,0.9361702127659576,0.9777777777777776
2022,KHOUALKA,MACROPHYLLA,20118,IMG-00050-40.jpg,48,47,47,0,1,1.0,0.9791666666666666
2022,KHOUALKA,MACROPHYLLA,20118,IMG-00055-40.jpg,52,51,49,2,3,0.9607843137254902,0.9423076923076924
2022,KHOUALKA,MACROPHYLLA,20118,IMG-00061-40.jpg,120,123,116,7,4,0.943089430894309,0.9666666666666668
2022,KHOUALKA,MACROPHYLLA,20118,IMG-00062-40.jpg,63,65,57,8,6,0.8769230769230769,0.9047619047619048
2022,KHOUALKA,MACROPHYLLA,20118,IMG-00063-40.jpg,47,50,46,4,1,0.92,0.9787234042553192
2022,KHOUALKA,MACROPHYLLA,20118,IMG-00066-40.jpg,84,86,83,3,1,0.9651162790697676,0.988095238095238
2024,KHOUALKA,MACROPHYLLA,20118,IMG-12691.jpg,22,15,14,1,8,0.9333333333333332,0.6363636363636364
2024,KHOUALKA,MACROPHYLLA,20118,IMG-12729.jpg,56,47,46,1,10,0.9787234042553192,0.8214285714285714
2024,KHOUALKA,MACROPHYLLA,20118,IMG-12735.jpg,88,69,67,2,21,0.9710144927536232,0.7613636363636364
2024,KHOUALKA,MACROPHYLLA,20118,IMG-12748.jpg,107,96,91,5,16,0.9479166666666666,0.8504672897196262
2024,KHOUALKA,MACROPHYLLA,20118,IMG-12764.jpg,111,97,96,1,15,0.9896907216494846,0.8648648648648649
2024,KHOUALKA,MACROPHYLLA,20118,IMG-12808.jpg,113,98,93,5,20,0.9489795918367347,0.8230088495575221
2024,KHOUALKA,MACROPHYLLA,20118,IMG-12851.jpg,24,18,16,2,8,0.8888888888888888,0.6666666666666666
2022,KHOUALKA,MACROPHYLLA,20119,IMG-00005-40.jpg,106,105,100,5,6,0.9523809523809524,0.9433962264150944
2022,KHOUALKA,MACROPHYLLA,20119,IMG-00008-40.jpg,142,142,134,8,8,0.943661971830986,0.943661971830986
2022,KHOUALKA,MACROPHYLLA,20119,IMG-00014-40.jpg,132,132,124,8,8,0.9393939393939394,0.9393939393939394
2022,KHOUALKA,BIGARADIER,20132,IMG-00004-40.jpg,181,174,171,3,10,0.9827586206896552,0.9447513812154696
2022,KHOUALKA,BIGARADIER,20132,IMG-00025-40.jpg,91,93,87,6,4,0.935483870967742,0.956043956043956
2022,KHOUALKA,BIGARADIER,20132,IMG-00028-40.jpg,49,49,48,1,1,0.979591836734694,0.979591836734694
2022,KHOUALKA,BIGARADIER,20132,IMG-00035-40.jpg,103,107,103,4,0,0.9626168224299064,1.0
2022,KHOUALKA,BIGARADIER,20132,IMG-00039-40.jpg,119,125,117,8,2,0.936,0.9831932773109244
2022,KHOUALKA,BIGARADIER,20132,IMG-00046-40.jpg,156,155,152,3,4,0.9806451612903224,0.9743589743589745
2022,KHOUALKA,BIGARADIER,20132,IMG-00051-40.jpg,108,109,105,4,3,0.963302752293578,0.9722222222222222
2022,KHOUALKA,BIGARADIER,20132,IMG-00055-40.jpg,67,64,64,0,3,1.0,0.9552238805970148
2022,KHOUALKA,BIGARADIER,20132,IMG-00058-40.jpg,89,89,88,1,1,0.9887640449438202,0.9887640449438202
2022,KHOUALKA,BIGARADIER,20132,IMG-00059-40.jpg,139,134,130,4,9,0.9701492537313432,0.935251798561151
2022,KHOUALKA,BIGARADIER,20132,IMG-00060-40.jpg,57,53,52,1,5,0.981132075471698,0.912280701754386
2022,KHOUALKA,BIGARADIER,20132,IMG-00064-40.jpg,117,114,112,2,5,0.9824561403508772,0.9572649572649572
2022,KHOUALKA,BIGARADIER,20132,IMG-00075-40.jpg,69,72,69,3,0,0.9583333333333334,1.0
2022,ONAGRI,BIGARADIER,20139,IMG-00021-39.jpg,93,88,88,0,5,1.0,0.946236559139785
2024,KHOUALKA,CITRUS VOLKAMERIANA,20205,IMG-12040.jpg,123,93,89,4,34,0.956989247311828,0.7235772357723578
2024,KHOUALKA,CITRUS VOLKAMERIANA,20205,IMG-12058.jpg,116,105,105,0,11,1.0,0.9051724137931034
2024,KHOUALKA,CITRUS VOLKAMERIANA,20207,IMG-11892.jpg,94,69,67,2,27,0.9710144927536232,0.7127659574468085
2024,KHOUALKA,CITRUS VOLKAMERIANA,20207,IMG-11921.jpg,264,187,186,1,78,0.9946524064171124,0.7045454545454546
2024,KHOUALKA,CITRUS VOLKAMERIANA,20207,IMG-11927.jpg,195,128,128,0,67,1.0,0.6564102564102564
2024,KHOUALKA,CITRUS VOLKAMERIANA,20207,IMG-11961.jpg,113,85,85,0,28,1.0,0.7522123893805309
2024,KHOUALKA,CITRUS VOLKAMERIANA,20207,IMG-11972.jpg,94,65,63,2,31,0.9692307692307692,0.6702127659574468
2024,KHOUALKA,CITRUS VOLKAMERIANA,20207,IMG-11981.jpg,81,55,55,0,26,1.0,0.6790123456790124
2022,SAOUDA,CITRUS VOLKAMERIANA,21020,IMG-00033-45.jpg,67,68,65,3,2,0.9558823529411764,0.9701492537313432
2022,SAOUDA,CITRUS VOLKAMERIANA,21020,IMG-00087-45.jpg,21,19,19,0,2,1.0,0.9047619047619048
2022,SAOUDA,CITRUS VOLKAMERIANA,21020,IMG-00138-45.jpg,40,41,40,1,0,0.975609756097561,1.0
2022,SAOUDA,CITRUS VOLKAMERIANA,21020,IMG-00145-45.jpg,37,39,37,2,0,0.9487179487179488,1.0
2022,SAOUDA,CITRUS VOLKAMERIANA,21020,IMG-00155-45.jpg,38,42,35,7,3,0.8333333333333334,0.9210526315789472
2022,SAOUDA,CITRUS VOLKAMERIANA,21030,IMG-00521-45.jpg,31,36,30,6,1,0.8333333333333334,0.967741935483871
2022,SAOUDA,CITRUS VOLKAMERIANA,21030,IMG-00524-45.jpg,71,76,68,8,3,0.8947368421052632,0.9577464788732394
2022,SAOUDA,CITRUS VOLKAMERIANA,21030,IMG-00536-45.jpg,41,45,39,6,2,0.8666666666666667,0.951219512195122
2022,SAOUDA,CITRUS VOLKAMERIANA,21030,IMG-00537-45.jpg,52,51,46,5,6,0.9019607843137256,0.8846153846153846
2022,SAOUDA,CITRUS VOLKAMERIANA,22020,IMG-00053-45.jpg,39,42,39,3,0,0.9285714285714286,1.0
2022,SAOUDA,CITRUS VOLKAMERIANA,22020,IMG-00059-45.jpg,46,46,44,2,2,0.9565217391304348,0.9565217391304348
2022,SAOUDA,CITRUS VOLKAMERIANA,22020,IMG-00060-45.jpg,48,51,47,4,1,0.9215686274509804,0.9791666666666666
2022,SAOUDA,CITRUS VOLKAMERIANA,22020,IMG-00062-45.jpg,50,52,50,2,0,0.9615384615384616,1.0
2022,SAOUDA,CITRUS VOLKAMERIANA,22030,IMG-00062-45.jpg,62,64,61,3,1,0.953125,0.9838709677419356
2022,SAOUDA,CITRUS VOLKAMERIANA,22030,IMG-00063-45.jpg,83,80,79,1,4,0.9875,0.9518072289156626
2022,SAOUDA,CITRUS VOLKAMERIANA,22030,IMG-00065-45.jpg,58,57,56,1,2,0.9824561403508772,0.9655172413793104
2022,SAOUDA,CITRUS VOLKAMERIANA,22030,IMG-00068-45.jpg,66,68,65,3,1,0.9558823529411764,0.9848484848484848
2022,SAOUDA,CITRUS VOLKAMERIANA,23020,IMG-00024-45.jpg,47,46,45,1,2,0.9782608695652174,0.9574468085106383
2022,SAOUDA,CITRUS VOLKAMERIANA,23020,IMG-00032-45.jpg,33,34,33,1,0,0.9705882352941176,1.0
2022,SAOUDA,CITRUS VOLKAMERIANA,23020,IMG-00074-45.jpg,28,31,27,4,1,0.8709677419354839,0.9642857142857144
2022,SAOUDA,CITRUS VOLKAMERIANA,23020,IMG-00079-45.jpg,28,30,28,2,0,0.9333333333333332,1.0
2022,SAOUDA,CITRUS VOLKAMERIANA,23030,IMG-00014-45.jpg,25,26,25,1,0,0.9615384615384616,1.0
2022,SAOUDA,CITRUS VOLKAMERIANA,23030,IMG-00034-45.jpg,43,43,42,1,1,0.9767441860465116,0.9767441860465116
2022,SAOUDA,CITRUS VOLKAMERIANA,23030,IMG-00069-45.jpg,28,31,27,4,1,0.8709677419354839,0.9642857142857144
2022,SAOUDA,CITRUS VOLKAMERIANA,23030,IMG-00079-45.jpg,50,53,49,4,1,0.9245283018867924,0.98
2022,SAOUDA,CITRANGE CARRIZO,24010,IMG-00097-45.jpg,59,60,56,4,3,0.9333333333333332,0.9491525423728814
2022,SAOUDA,CITRANGE CARRIZO,24010,IMG-00101-45.jpg,27,31,27,4,0,0.8709677419354839,1.0
2022,SAOUDA,CITRANGE CARRIZO,24010,IMG-00111-45.jpg,54,55,53,2,1,0.9636363636363636,0.9814814814814816
2022,SAOUDA,CITRANGE CARRIZO,24010,IMG-00112-45.jpg,40,43,39,4,1,0.9069767441860463,0.975
2022,SAOUDA,CITRANGE CARRIZO,25010,IMG-00006-45.jpg,55,53,51,2,4,0.9622641509433962,0.9272727272727272
2022,SAOUDA,CITRANGE CARRIZO,25010,IMG-00007-45.jpg,77,78,76,2,1,0.9743589743589745,0.987012987012987
2022,SAOUDA,CITRANGE CARRIZO,25010,IMG-00010-45.jpg,53,53,52,1,1,0.981132075471698,0.981132075471698
2022,SAOUDA,CITRANGE CARRIZO,25010,IMG-00011-45.jpg,26,26,26,0,0,1.0,1.0
2022,SAOUDA,CITRANGE CARRIZO,26010,IMG-00008-45.jpg,39,38,38,0,1,1.0,0.9743589743589745
2022,SAOUDA,CITRANGE CARRIZO,26010,IMG-00013-45.jpg,36,37,36,1,0,0.972972972972973,1.0
2022,SAOUDA,CITRANGE CARRIZO,26010,IMG-00018-45.jpg,43,45,43,2,0,0.9555555555555556,1.0
2022,SAOUDA,CITRANGE CARRIZO,26010,IMG-00020-45.jpg,44,43,41,2,3,0.9534883720930232,0.9318181818181818
2022,KHOUALKA,CITRANGE CARRIZO,30138,IMG-00002-40.jpg,39,40,39,1,0,0.975,1.0
2022,KHOUALKA,CITRANGE CARRIZO,30138,IMG-00003-40.jpg,59,59,56,3,3,0.9491525423728814,0.9491525423728814
2022,KHOUALKA,CITRANGE CARRIZO,30138,IMG-00005-40.jpg,58,64,58,6,0,0.90625,1.0
2022,KHOUALKA,CITRANGE CARRIZO,30138,IMG-00008-40.jpg,32,32,31,1,1,0.96875,0.96875
2022,KHOUALKA,CITRANGE CARRIZO,30138,IMG-00011-40.jpg,26,25,25,0,1,1.0,0.9615384615384616
2022,KHOUALKA,CITRANGE CARRIZO,30138,IMG-00019-40.jpg,2,2,2,0,0,1.0,1.0
2022,KHOUALKA,CITRANGE CARRIZO,30138,IMG-00037-40.jpg,30,31,29,2,1,0.935483870967742,0.9666666666666668
2022,KHOUALKA,CITRANGE CARRIZO,30138,IMG-00040-40.jpg,41,41,41,0,0,1.0,1.0
2022,KHOUALKA,CITRANGE CARRIZO,30138,IMG-00043-40.jpg,28,31,28,3,0,0.9032258064516128,1.0
2022,KHOUALKA,CITRANGE CARRIZO,30138,IMG-00044-40.jpg,99,101,99,2,0,0.9801980198019802,1.0
2022,KHOUALKA,CITRANGE CARRIZO,30138,IMG-00048-40.jpg,37,37,33,4,4,0.8918918918918919,0.8918918918918919
2022,KHOUALKA,CITRANGE CARRIZO,30138,IMG-00057-40.jpg,73,77,71,6,2,0.922077922077922,0.9726027397260274
2022,KHOUALKA,CITRANGE CARRIZO,30138,IMG-00063-40.jpg,89,85,84,1,5,0.9882352941176472,0.9438202247191012
2022,ONAGRI,CITRUS VOLKAMERIANA,30145,IMG-00018-39.jpg,219,198,191,7,28,0.9646464646464646,0.8721461187214612
2022,ONAGRI,CITRUS VOLKAMERIANA,30145,IMG-00043-39.jpg,64,61,60,1,4,0.9836065573770492,0.9375
2022,ONAGRI,CITRUS VOLKAMERIANA,30146,IMG-00008-39.jpg,262,251,242,9,20,0.9641434262948207,0.9236641221374046
2022,ONAGRI,CITRUS VOLKAMERIANA,30146,IMG-00045-39.jpg,190,186,178,8,12,0.956989247311828,0.936842105263158
2022,ONAGRI,CITRUS VOLKAMERIANA,30147,IMG-00002-39.jpg,269,260,253,7,16,0.9730769230769232,0.9405204460966544
2022,ONAGRI,CITRUS VOLKAMERIANA,30147,IMG-00008-39.jpg,172,163,159,4,13,0.9754601226993864,0.9244186046511628
2022,ONAGRI,CITRUS VOLKAMERIANA,30148,IMG-00016-40.jpg,88,88,84,4,4,0.9545454545454546,0.9545454545454546
2022,ONAGRI,CITRUS VOLKAMERIANA,30148,IMG-00047-40.jpg,34,30,30,0,4,1.0,0.8823529411764706
2022,ONAGRI,CITRUS VOLKAMERIANA,30149,IMG-00018-39.jpg,151,138,136,2,15,0.9855072463768116,0.9006622516556292
2022,ONAGRI,CITRUS VOLKAMERIANA,30149,IMG-00027-39.jpg,226,205,202,3,24,0.9853658536585366,0.8938053097345132
2022,ONAGRI,CITRUS VOLKAMERIANA,30151,IMG-00012-39.jpg,185,162,156,6,29,0.9629629629629628,0.8432432432432433
2022,ONAGRI,CITRUS VOLKAMERIANA,30151,IMG-00033-39.jpg,214,201,196,5,18,0.9751243781094528,0.9158878504672896
2024,ONAGRI,CITRUS VOLKAMERIANA,30151,IMG-21881.jpg,73,65,61,4,12,0.9384615384615383,0.8356164383561644
2024,ONAGRI,CITRUS VOLKAMERIANA,30151,IMG-21935.jpg,179,145,142,3,37,0.9793103448275862,0.7932960893854749
2024,ONAGRI,CITRUS VOLKAMERIANA,30151,IMG-21936.jpg,93,72,72,0,21,1.0,0.7741935483870968
2022,ONAGRI,CITRUS VOLKAMERIANA,30152,IMG-00016-39.jpg,39,38,37,1,2,0.9736842105263158,0.9487179487179488
2022,ONAGRI,CITRUS VOLKAMERIANA,30152,IMG-00019-39.jpg,139,127,119,8,20,0.937007874015748,0.8561151079136691
2022,ONAGRI,CITRUS VOLKAMERIANA,30153,IMG-00001.jpg,157,132,127,5,30,0.9621212121212122,0.8089171974522293
2022,ONAGRI,CITRUS VOLKAMERIANA,30153,IMG-00007-39.jpg,127,115,112,3,15,0.9739130434782608,0.8818897637795275
2022,ONAGRI,CITRUS VOLKAMERIANA,30153,IMG-00013-39.jpg,159,148,144,4,15,0.972972972972973,0.9056603773584906
2022,ONAGRI,CITRUS VOLKAMERIANA,30153,IMG-00040-39.jpg,153,134,131,3,22,0.9776119402985076,0.8562091503267973
2022,ONAGRI,CITRUS VOLKAMERIANA,30154,IMG-00017-39.jpg,160,157,153,4,7,0.9745222929936306,0.95625
2022,ONAGRI,CITRUS VOLKAMERIANA,30154,IMG-00027-39.jpg,220,211,205,6,15,0.971563981042654,0.9318181818181818
2022,ONAGRI,CITRUS VOLKAMERIANA,30154,IMG-00033-39.jpg,51,52,49,3,2,0.9423076923076924,0.9607843137254902
2022,ONAGRI,CITRUS VOLKAMERIANA,30154,IMG-00036-39.jpg,137,138,134,4,3,0.9710144927536232,0.978102189781022
2022,ONAGRI,CITRUS VOLKAMERIANA,30154,IMG-00038-39.jpg,242,252,240,12,2,0.9523809523809524,0.9917355371900828
2022,ONAGRI,CITRUS VOLKAMERIANA,30154,IMG-00041-39.jpg,272,267,257,10,15,0.9625468164794008,0.9448529411764706
2022,ONAGRI,CITRUS VOLKAMERIANA,30154,IMG-00044-39.jpg,141,143,129,14,12,0.902097902097902,0.9148936170212766
2022,ONAGRI,BIGARADIER,30155,IMG-00002-39.jpg,139,139,134,5,5,0.9640287769784172,0.9640287769784172
2022,ONAGRI,BIGARADIER,30155,IMG-00003-39.jpg,115,108,107,1,8,0.9907407407407408,0.9304347826086956
2022,ONAGRI,BIGARADIER,30155,IMG-00006-39.jpg,44,42,37,5,7,0.8809523809523809,0.8409090909090909
2022,ONAGRI,BIGARADIER,30155,IMG-00011-39.jpg,100,94,93,1,7,0.9893617021276596,0.93
2022,ONAGRI,BIGARADIER,30155,IMG-00019-39.jpg,142,133,129,4,13,0.9699248120300752,0.908450704225352
2022,ONAGRI,BIGARADIER,30155,IMG-00026-39.jpg,124,120,115,5,9,0.9583333333333334,0.9274193548387096
2022,ONAGRI,BIGARADIER,30155,IMG-00032-39.jpg,81,77,71,6,10,0.922077922077922,0.8765432098765432
2022,ONAGRI,BIGARADIER,30155,IMG-00039-39.jpg,19,19,18,1,1,0.9473684210526316,0.9473684210526316
2022,ONAGRI,BIGARADIER,30155,IMG-00043-39.jpg,130,131,124,7,6,0.9465648854961832,0.953846153846154
2022,ONAGRI,CITRUS VOLKAMERIANA,30157,IMG-00003-39.jpg,227,220,215,5,12,0.9772727272727272,0.947136563876652
2022,ONAGRI,CITRUS VOLKAMERIANA,30157,IMG-00012-39.jpg,283,278,270,8,13,0.9712230215827338,0.9540636042402828
2022,ONAGRI,CITRUS VOLKAMERIANA,30157,IMG-00032-39.jpg,64,63,60,3,4,0.9523809523809524,0.9375
2022,ONAGRI,CITRUS VOLKAMERIANA,30157,IMG-00035-39.jpg,159,155,152,3,7,0.9806451612903224,0.9559748427672956
2022,KHOUALKA,CITRUS VOLKAMERIANA,30235,IMG-00001.jpg,93,91,91,0,2,1.0,0.978494623655914
2022,KHOUALKA,CITRUS VOLKAMERIANA,30235,IMG-00003-40.jpg,37,39,37,2,0,0.9487179487179488,1.0
2022,KHOUALKA,CITRUS VOLKAMERIANA,30235,IMG-00009-40.jpg,103,102,100,2,3,0.9803921568627452,0.970873786407767
2022,KHOUALKA,CITRUS VOLKAMERIANA,30235,IMG-00013-40.jpg,90,94,90,4,0,0.9574468085106383,1.0
2022,KHOUALKA,CITRUS VOLKAMERIANA,30235,IMG-00026-40.jpg,122,129,121,8,1,0.937984496124031,0.9918032786885246
2022,KHOUALKA,CITRUS VOLKAMERIANA,30235,IMG-00047-40.jpg,47,50,45,5,2,0.9,0.9574468085106383
2022,KHOUALKA,CITRUS VOLKAMERIANA,30235,IMG-00048-40.jpg,90,90,88,2,2,0.9777777777777776,0.9777777777777776
2022,KHOUALKA,CITRUS VOLKAMERIANA,30235,IMG-00049-40.jpg,44,48,44,4,0,0.9166666666666666,1.0
2022,KHOUALKA,CITRUS VOLKAMERIANA,30235,IMG-00050-40.jpg,84,84,82,2,2,0.9761904761904762,0.9761904761904762
2022,KHOUALKA,CITRUS VOLKAMERIANA,30235,IMG-00052-40.jpg,98,100,96,4,2,0.96,0.979591836734694
2022,KHOUALKA,CITRUS VOLKAMERIANA,30235,IMG-00057-40.jpg,80,77,72,5,8,0.935064935064935,0.9
2022,KHOUALKA,CITRUS VOLKAMERIANA,30235,IMG-00064-40.jpg,38,36,35,1,3,0.9722222222222222,0.9210526315789472
2022,KHOUALKA,CITRUS VOLKAMERIANA,30235,IMG-00067-40.jpg,107,107,104,3,3,0.97196261682243,0.97196261682243
2022,KHOUALKA,CITRUS VOLKAMERIANA,30235,IMG-00069-40.jpg,34,37,33,4,1,0.8918918918918919,0.9705882352941176
2022,KHOUALKA,CITRUS VOLKAMERIANA,30235,IMG-00075-40.jpg,95,98,95,3,0,0.9693877551020408,1.0
2022,KHOUALKA,BIGARADIER,40141,IMG-00006-40.jpg,7,7,6,1,1,0.8571428571428571,0.8571428571428571
2022,KHOUALKA,BIGARADIER,40141,IMG-00007-40.jpg,20,16,16,0,4,1.0,0.8
2022,KHOUALKA,BIGARADIER,40141,IMG-00008-40.jpg,15,13,12,1,3,0.9230769230769232,0.8
2022,ONAGRI,CITRANGE C35,40166,IMG-00009-39.jpg,38,35,35,0,3,1.0,0.9210526315789472
2022,ONAGRI,CITRANGE C35,40166,IMG-00011-39.jpg,173,170,164,6,9,0.9647058823529412,0.9479768786127168
2022,ONAGRI,CITRANGE C35,40166,IMG-00014-39.jpg,179,181,177,4,2,0.9779005524861878,0.988826815642458
2022,ONAGRI,CITRANGE C35,40166,IMG-00015-39.jpg,122,121,118,3,4,0.975206611570248,0.9672131147540984
2022,ONAGRI,CITRANGE C35,40166,IMG-00041-39.jpg,102,97,97,0,5,1.0,0.9509803921568628
2022,ONAGRI,CITRANGE C35,40167,IMG-00019-39.jpg,197,198,194,4,3,0.9797979797979798,0.9847715736040608
2022,ONAGRI,CITRANGE C35,40167,IMG-00030-39.jpg,126,119,119,0,7,1.0,0.9444444444444444
2022,ONAGRI,CITRANGE C35,40167,IMG-00039-39.jpg,217,203,197,6,20,0.9704433497536946,0.9078341013824884
2022,ONAGRI,CITRANGE C35,40171,IMG-00008-39.jpg,109,102,101,1,8,0.9901960784313726,0.926605504587156
2022,ONAGRI,CITRANGE C35,40171,IMG-00037-39.jpg,94,88,85,3,9,0.9659090909090908,0.9042553191489362
2022,ONAGRI,CITRANGE C35,40171,IMG-00040-39.jpg,149,142,141,1,8,0.9929577464788732,0.9463087248322148
2022,ONAGRI,CITRANGE C35,40172,IMG-00012-39.jpg,89,82,81,1,8,0.9878048780487804,0.9101123595505618
2022,ONAGRI,CITRANGE C35,40172,IMG-00025-39.jpg,109,107,104,3,5,0.97196261682243,0.9541284403669724
2022,ONAGRI,CITRANGE C35,40172,IMG-00027-39.jpg,103,95,93,2,10,0.9789473684210528,0.9029126213592232
2022,ONAGRI,CITRANGE C35,40173,IMG-00004-39.jpg,133,119,118,1,15,0.9915966386554622,0.8872180451127819
2022,ONAGRI,CITRANGE C35,40173,IMG-00008-39.jpg,57,50,50,0,7,1.0,0.8771929824561403
2022,ONAGRI,CITRANGE C35,40173,IMG-00010-39.jpg,53,58,51,7,2,0.8793103448275862,0.9622641509433962
2022,ONAGRI,CITRANGE C35,40175,IMG-00005-39.jpg,95,85,83,2,12,0.976470588235294,0.8736842105263158
2022,ONAGRI,CITRANGE C35,40175,IMG-00006-39.jpg,64,62,59,3,5,0.9516129032258064,0.921875
2022,ONAGRI,CITRANGE C35,40176,IMG-00004-39.jpg,79,75,69,6,10,0.92,0.8734177215189873
2022,ONAGRI,CITRANGE C35,40176,IMG-00012-39.jpg,105,105,103,2,2,0.9809523809523808,0.9809523809523808
2022,ONAGRI,CITRANGE C35,40176,IMG-00014-39.jpg,91,92,84,8,7,0.9130434782608696,0.9230769230769232
2022,ONAGRI,CITRUMELO SACCATON,40177,IMG-00012-39.jpg,89,88,85,3,4,0.9659090909090908,0.9550561797752808
2022,ONAGRI,CITRUMELO SACCATON,40177,IMG-00015-39.jpg,213,213,207,6,6,0.971830985915493,0.971830985915493
2022,ONAGRI,CITRUMELO SACCATON,40177,IMG-00037-39.jpg,95,93,88,5,7,0.946236559139785,0.9263157894736842
2022,ONAGRI,CITRANGE C35,40178,IMG-00013-39.jpg,76,76,76,0,0,1.0,1.0
2022,ONAGRI,CITRANGE C35,40178,IMG-00027-39.jpg,56,57,56,1,0,0.9824561403508772,1.0
2022,ONAGRI,CITRANGE C35,40178,IMG-00031-39.jpg,30,30,30,0,0,1.0,1.0
2022,ONAGRI,CITRANGE C35,40178,IMG-00032-39.jpg,27,27,27,0,0,1.0,1.0
2022,ONAGRI,CITRANGE C35,40178,IMG-00033-39.jpg,34,35,33,2,1,0.9428571428571428,0.9705882352941176
2022,ONAGRI,CITRANGE C35,40179,IMG-00001.jpg,83,86,79,7,4,0.9186046511627908,0.9518072289156626
2022,ONAGRI,CITRANGE C35,40179,IMG-00010-39.jpg,161,159,155,4,6,0.9748427672955976,0.9627329192546584
2022,ONAGRI,CITRANGE C35,40179,IMG-00011-39.jpg,102,101,100,1,2,0.99009900990099,0.9803921568627452
2022,ONAGRI,CITRANGE C35,40179,IMG-00018-39.jpg,9,11,9,2,0,0.8181818181818182,1.0
2022,ONAGRI,CITRUMELO SACCATON,40182,IMG-00004-39.jpg,35,36,34,2,1,0.9444444444444444,0.9714285714285714
2022,ONAGRI,CITRUMELO SACCATON,40182,IMG-00010-39.jpg,52,49,48,1,4,0.979591836734694,0.9230769230769232
2022,ONAGRI,CITRUMELO SACCATON,40182,IMG-00015-39.jpg,85,84,80,4,5,0.9523809523809524,0.9411764705882352
2022,ONAGRI,CITRUMELO SACCATON,40183,IMG-00005-39.jpg,68,67,67,0,1,1.0,0.9852941176470588
2022,ONAGRI,CITRUMELO SACCATON,40183,IMG-00009-39.jpg,57,58,55,3,2,0.9482758620689656,0.9649122807017544
2022,ONAGRI,CITRUMELO SACCATON,40183,IMG-00010-39.jpg,48,47,45,2,3,0.9574468085106383,0.9375
2024,KHOUALKA,CITRUS VOLKAMERIANA,50152,IMG-17274.jpg,170,144,140,4,30,0.9722222222222222,0.8235294117647058
2024,KHOUALKA,CITRUS VOLKAMERIANA,50152,IMG-17306.jpg,105,97,94,3,11,0.9690721649484536,0.8952380952380953
2024,KHOUALKA,CITRUS VOLKAMERIANA,50152,IMG-17330.jpg,41,30,30,0,11,1.0,0.7317073170731707
2024,KHOUALKA,CITRUS VOLKAMERIANA,50152,IMG-17335.jpg,44,37,37,0,7,1.0,0.8409090909090909
2024,KHOUALKA,CITRUS VOLKAMERIANA,50152,IMG-17340.jpg,108,85,82,3,26,0.9647058823529412,0.7592592592592593
2024,KHOUALKA,CITRUS VOLKAMERIANA,50152,IMG-17356.jpg,60,47,45,2,15,0.9574468085106383,0.75
2024,KHOUALKA,CITRUS VOLKAMERIANA,50152,IMG-17384.jpg,53,37,36,1,17,0.972972972972973,0.6792452830188679
2024,KHOUALKA,CITRUS VOLKAMERIANA,50154,IMG-17440.jpg,76,70,69,1,7,0.9857142857142858,0.9078947368421052
2024,KHOUALKA,CITRUS VOLKAMERIANA,50154,IMG-17490.jpg,107,85,84,1,23,0.9882352941176472,0.7850467289719626
2024,KHOUALKA,CITRUS VOLKAMERIANA,50154,IMG-17543.jpg,100,68,68,0,32,1.0,0.68
2024,KHOUALKA,CITRUS VOLKAMERIANA,50154,IMG-17545.jpg,94,72,72,0,22,1.0,0.7659574468085106
2024,KHOUALKA,CITRUS VOLKAMERIANA,50154,IMG-17562.jpg,129,112,110,2,19,0.9821428571428572,0.8527131782945736
2024,KHOUALKA,CITRUS VOLKAMERIANA,50154,IMG-17576.jpg,121,102,100,2,21,0.9803921568627452,0.8264462809917356
2024,KHOUALKA,CITRUS VOLKAMERIANA,50154,IMG-17585.jpg,171,147,144,3,27,0.979591836734694,0.8421052631578947
2024,KHOUALKA,CITRUS VOLKAMERIANA,50168,IMG-13980.jpg,174,125,125,0,49,1.0,0.7183908045977011
2024,KHOUALKA,CITRUS VOLKAMERIANA,50168,IMG-15749.jpg,147,116,116,0,31,1.0,0.7891156462585034
2024,KHOUALKA,CITRUS VOLKAMERIANA,50168,IMG-15758.jpg,163,128,126,2,37,0.984375,0.7730061349693251
2024,KHOUALKA,CITRUS VOLKAMERIANA,50168,IMG-15981.jpg,210,185,180,5,30,0.972972972972973,0.8571428571428571
2024,KHOUALKA,CITRUS VOLKAMERIANA,50168,IMG-15983.jpg,120,97,96,1,24,0.9896907216494846,0.8
2024,KHOUALKA,CITRUS VOLKAMERIANA,50176,IMG-16025.jpg,81,68,67,1,14,0.9852941176470588,0.8271604938271605
2024,KHOUALKA,CITRUS VOLKAMERIANA,50176,IMG-16051.jpg,85,79,76,3,9,0.9620253164556962,0.8941176470588236
2024,KHOUALKA,CITRUS VOLKAMERIANA,50176,IMG-16079.jpg,161,133,128,5,33,0.962406015037594,0.7950310559006211
2024,KHOUALKA,CITRUS VOLKAMERIANA,50176,IMG-16095.jpg,101,84,82,2,19,0.9761904761904762,0.8118811881188119
2024,KHOUALKA,CITRUS VOLKAMERIANA,50176,IMG-16105.jpg,43,37,35,2,8,0.945945945945946,0.813953488372093
2022,ONAGRI,CITRUMELO SACCATON,50193,IMG-00007-39.jpg,218,213,213,0,5,1.0,0.9770642201834864
2022,ONAGRI,CITRUMELO SACCATON,50193,IMG-00016-39.jpg,64,65,62,3,2,0.953846153846154,0.96875
2022,ONAGRI,CITRUMELO SACCATON,50193,IMG-00018-39.jpg,115,118,114,4,1,0.9661016949152542,0.991304347826087
2022,ONAGRI,CITRUMELO SACCATON,50193,IMG-00021-39.jpg,62,63,60,3,2,0.9523809523809524,0.967741935483871
2022,ONAGRI,CITRUMELO SACCATON,50193,IMG-00023-39.jpg,113,117,110,7,3,0.9401709401709402,0.9734513274336284
2022,ONAGRI,CITRUMELO SACCATON,50194,IMG-00032-39.jpg,162,167,158,9,4,0.9461077844311376,0.9753086419753086
2022,ONAGRI,CITRUMELO SACCATON,50194,IMG-00034-39.jpg,105,108,104,4,1,0.9629629629629628,0.9904761904761904
2022,ONAGRI,CITRUMELO SACCATON,50194,IMG-00036-39.jpg,161,161,150,11,11,0.9316770186335404,0.9316770186335404
2022,ONAGRI,CITRUMELO SACCATON,50194,IMG-00038-39.jpg,100,102,97,5,3,0.9509803921568628,0.97
2022,ONAGRI,CITRUMELO SACCATON,50194,IMG-00039-39.jpg,65,63,63,0,2,1.0,0.9692307692307692
2022,ONAGRI,CITRUMELO SACCATON,50194,IMG-00041-39.jpg,153,153,147,6,6,0.9607843137254902,0.9607843137254902
2022,ONAGRI,CITRUMELO SACCATON,50194,IMG-00051-39.jpg,137,131,127,4,10,0.9694656488549618,0.927007299270073
2022,ONAGRI,CITRUMELO SACCATON,50194,IMG-00054-39.jpg,111,107,104,3,7,0.97196261682243,0.9369369369369368
2022,ONAGRI,CITRUMELO SACCATON,51091,IMG-00015-39.jpg,85,87,83,4,2,0.9540229885057472,0.976470588235294
2022,ONAGRI,CITRUMELO SACCATON,51091,IMG-00016-39.jpg,170,170,166,4,4,0.976470588235294,0.976470588235294
2022,ONAGRI,CITRUMELO SACCATON,51091,IMG-00018-39.jpg,185,191,183,8,2,0.9581151832460733,0.9891891891891892
2022,ONAGRI,CITRUMELO SACCATON,51091,IMG-00022-39.jpg,135,140,133,7,2,0.95,0.9851851851851852
2022,ONAGRI,CITRUMELO SACCATON,51091,IMG-00023-39.jpg,140,135,134,1,6,0.9925925925925926,0.9571428571428572
2022,ONAGRI,CITRUMELO SACCATON,51091,IMG-00026-39.jpg,149,141,138,3,11,0.9787234042553192,0.9261744966442952
2022,ONAGRI,CITRUMELO SACCATON,51091,IMG-00044-39.jpg,168,168,163,5,5,0.9702380952380952,0.9702380952380952
2022,ONAGRI,CITRUMELO SACCATON,51095,IMG-00004-39.jpg,201,206,192,14,9,0.9320388349514565,0.9552238805970148
2022,ONAGRI,CITRUMELO SACCATON,51095,IMG-00013-39.jpg,154,157,150,7,4,0.9554140127388536,0.974025974025974
2022,ONAGRI,CITRUMELO SACCATON,51095,IMG-00014-39.jpg,140,139,134,5,6,0.9640287769784172,0.9571428571428572
2022,ONAGRI,CITRUMELO SACCATON,51095,IMG-00015-39.jpg,196,196,189,7,7,0.9642857142857144,0.9642857142857144
2022,ONAGRI,CITRUMELO SACCATON,51095,IMG-00024-39.jpg,234,226,222,4,12,0.9823008849557522,0.9487179487179488
2022,ONAGRI,CITRUMELO SACCATON,51095,IMG-00025-39.jpg,198,203,192,11,6,0.9458128078817734,0.9696969696969696
2022,ONAGRI,CITRUMELO SACCATON,51096,IMG-00009-39.jpg,219,215,210,5,9,0.9767441860465116,0.958904109589041
2022,ONAGRI,CITRUMELO SACCATON,51096,IMG-00011-39.jpg,145,151,140,11,5,0.9271523178807948,0.9655172413793104
2022,ONAGRI,CITRUMELO SACCATON,51096,IMG-00012-39.jpg,114,110,106,4,8,0.9636363636363636,0.9298245614035088
2022,ONAGRI,CITRUMELO SACCATON,51096,IMG-00055-39.jpg,217,205,199,6,18,0.9707317073170731,0.9170506912442395
2022,ONAGRI,MC PONSIRUCE TRIFOLIATA,51097,IMG-00025-39.jpg,121,124,117,7,4,0.9435483870967742,0.9669421487603306
2022,ONAGRI,MC PONSIRUCE TRIFOLIATA,51097,IMG-00029-39.jpg,106,108,103,5,3,0.9537037037037036,0.9716981132075472
2022,ONAGRI,MC PONSIRUCE TRIFOLIATA,51097,IMG-00044-39.jpg,182,183,174,9,8,0.9508196721311476,0.956043956043956
2022,ONAGRI,MC PONSIRUCE TRIFOLIATA,51098,IMG-00003-39.jpg,65,70,63,7,2,0.9,0.9692307692307692
2022,ONAGRI,MC PONSIRUCE TRIFOLIATA,51098,IMG-00010-39.jpg,184,184,177,7,7,0.9619565217391304,0.9619565217391304
2022,ONAGRI,MC PONSIRUCE TRIFOLIATA,51098,IMG-00015-39.jpg,162,163,160,3,2,0.98159509202454,0.9876543209876544
2022,ONAGRI,MC PONSIRUCE TRIFOLIATA,51099,IMG-00012-39.jpg,133,135,124,11,9,0.9185185185185184,0.9323308270676692
2024,ONAGRI,MC PONSIRUCE TRIFOLIATA,51101,IMG-12118.jpg,177,154,154,0,23,1.0,0.8700564971751412
2024,ONAGRI,MC PONSIRUCE TRIFOLIATA,51101,IMG-14223.jpg,153,132,131,1,22,0.9924242424242424,0.8562091503267973
2024,ONAGRI,MC PONSIRUCE TRIFOLIATA,51101,IMG-14226.jpg,151,138,136,2,15,0.9855072463768116,0.9006622516556292
2024,ONAGRI,MC PONSIRUCE TRIFOLIATA,51101,IMG-14255.jpg,189,176,173,3,16,0.9829545454545454,0.9153439153439152
2024,ONAGRI,MC PONSIRUCE TRIFOLIATA,51101,IMG-14281.jpg,150,137,134,3,16,0.978102189781022,0.8933333333333333
2022,ONAGRI,CITRUS VOLKAMERIANA,101020,IMG-00001.jpg,6,7,6,1,0,0.8571428571428571,1.0
2022,ONAGRI,CITRUS VOLKAMERIANA,101020,IMG-00004-44.jpg,53,52,50,2,3,0.9615384615384616,0.9433962264150944
2022,ONAGRI,CITRUS VOLKAMERIANA,101030,IMG-00003-44.jpg,29,28,28,0,1,1.0,0.9655172413793104
2022,ONAGRI,CITRUS VOLKAMERIANA,101030,IMG-00004-44.jpg,110,99,96,3,14,0.9696969696969696,0.8727272727272727
2022,ONAGRI,CITRUS VOLKAMERIANA,101030,IMG-00005-44.jpg,134,122,120,2,14,0.9836065573770492,0.8955223880597015
2022,ONAGRI,CITRUS VOLKAMERIANA,101030,IMG-00017-44.jpg,79,65,64,1,15,0.9846153846153848,0.810126582278481
2022,ONAGRI,CITRUS VOLKAMERIANA,101040,IMG-00005-44.jpg,172,159,154,5,18,0.9685534591194968,0.8953488372093024
2022,ONAGRI,CITRUS VOLKAMERIANA,101040,IMG-00009-44.jpg,131,132,128,4,3,0.9696969696969696,0.9770992366412212
2022,ONAGRI,CITRUS VOLKAMERIANA,101040,IMG-00011-44.jpg,64,61,58,3,6,0.9508196721311476,0.90625
2022,ONAGRI,CITRUS VOLKAMERIANA,101040,IMG-00012-44.jpg,139,130,127,3,12,0.9769230769230768,0.9136690647482014
2022,ONAGRI,CITRUS VOLKAMERIANA,101050,IMG-00002-44.jpg,95,88,86,2,9,0.9772727272727272,0.9052631578947368
2022,ONAGRI,CITRUS VOLKAMERIANA,101050,IMG-00005-44.jpg,59,54,54,0,5,1.0,0.9152542372881356
2022,ONAGRI,CITRUS VOLKAMERIANA,101050,IMG-00011-44.jpg,46,44,44,0,2,1.0,0.9565217391304348
2022,ONAGRI,CITRUS VOLKAMERIANA,101050,IMG-00024-44.jpg,40,39,39,0,1,1.0,0.975
2022,ONAGRI,CITRUS VOLKAMERIANA,101080,IMG-00005-44.jpg,42,40,39,1,3,0.975,0.9285714285714286
2022,ONAGRI,CITRUS VOLKAMERIANA,101080,IMG-00006-44.jpg,79,69,66,3,13,0.9565217391304348,0.8354430379746836
2022,ONAGRI,CITRUS VOLKAMERIANA,101080,IMG-00023-44.jpg,7,8,7,1,0,0.875,1.0
2022,ONAGRI,CITRUS VOLKAMERIANA,101080,IMG-00024-44.jpg,27,24,23,1,4,0.9583333333333334,0.8518518518518519
2022,ONAGRI,CITRUS VOLKAMERIANA,101090,IMG-00003-44.jpg,66,62,62,0,4,1.0,0.9393939393939394
2022,ONAGRI,CITRUS VOLKAMERIANA,101090,IMG-00006-44.jpg,41,35,35,0,6,1.0,0.8536585365853658
2022,ONAGRI,CITRUS VOLKAMERIANA,101090,IMG-00019-44.jpg,35,35,34,1,1,0.9714285714285714,0.9714285714285714
2022,ONAGRI,CITRUS VOLKAMERIANA,101090,IMG-00020-44.jpg,42,39,39,0,3,1.0,0.9285714285714286
2022,KHOUALKA,CITRANGE CARRIZO,102130,IMG-00001.jpg,5,4,4,0,1,1.0,0.8
2022,KHOUALKA,CITRANGE CARRIZO,102130,IMG-00004-43.jpg,24,16,16,0,8,1.0,0.6666666666666666
2022,KHOUALKA,CITRANGE CARRIZO,102130,IMG-00019-43.jpg,33,37,32,5,1,0.8648648648648649,0.9696969696969696
2022,KHOUALKA,CITRANGE CARRIZO,102130,IMG-00020-43.jpg,18,24,16,8,2,0.6666666666666666,0.8888888888888888
2022,KHOUALKA,MACROPHYLLA,201180,IMG-00007-43.jpg,38,41,38,3,0,0.926829268292683,1.0
2022,KHOUALKA,MACROPHYLLA,201180,IMG-00011-43.jpg,64,64,63,1,1,0.984375,0.984375
2022,KHOUALKA,MACROPHYLLA,201180,IMG-00019-43.jpg,64,62,60,2,4,0.967741935483871,0.9375
2022,KHOUALKA,MACROPHYLLA,201180,IMG-00020-43.jpg,43,46,41,5,2,0.8913043478260869,0.9534883720930232
2022,KHOUALKA,MACROPHYLLA,201190,IMG-00004-43.jpg,101,94,91,3,10,0.9680851063829788,0.900990099009901
2022,KHOUALKA,MACROPHYLLA,201190,IMG-00010-43.jpg,90,82,80,2,10,0.975609756097561,0.8888888888888888
2022,KHOUALKA,MACROPHYLLA,201190,IMG-00011-43.jpg,134,121,115,6,19,0.950413223140496,0.8582089552238806
2022,KHOUALKA,MACROPHYLLA,201190,IMG-00020-43.jpg,95,81,80,1,15,0.9876543209876544,0.8421052631578947
2022,KHOUALKA,CITRUS VOLKAMERIANA,201210,IMG-00011-43.jpg,103,100,99,1,4,0.99,0.9611650485436892
2022,KHOUALKA,CITRUS VOLKAMERIANA,201210,IMG-00012-43.jpg,42,41,41,0,1,1.0,0.9761904761904762
2022,KHOUALKA,CITRUS VOLKAMERIANA,201210,IMG-00015-43.jpg,77,72,72,0,5,1.0,0.935064935064935
2022,KHOUALKA,CITRUS VOLKAMERIANA,201210,IMG-00019-43.jpg,31,30,30,0,1,1.0,0.967741935483871
2022,KHOUALKA,BIGARADIER,201320,IMG-00006-43.jpg,87,71,70,1,17,0.9859154929577464,0.8045977011494253
2022,KHOUALKA,BIGARADIER,201320,IMG-00016-43.jpg,97,90,87,3,10,0.9666666666666668,0.8969072164948454
2022,KHOUALKA,BIGARADIER,201320,IMG-00017-43.jpg,49,47,46,1,3,0.9787234042553192,0.9387755102040816
2022,KHOUALKA,BIGARADIER,201320,IMG-00020-43.jpg,88,86,85,1,3,0.9883720930232558,0.9659090909090908
2022,ONAGRI,BIGARADIER,201390,IMG-00008-44.jpg,62,58,57,1,5,0.9827586206896552,0.9193548387096774
2022,ONAGRI,BIGARADIER,201390,IMG-00011-44.jpg,90,86,86,0,4,1.0,0.9555555555555556
2022,ONAGRI,BIGARADIER,201390,IMG-00013-44.jpg,77,65,59,6,18,0.9076923076923076,0.7662337662337663
2022,ONAGRI,BIGARADIER,201390,IMG-00016-44.jpg,69,61,61,0,8,1.0,0.8840579710144928
2022,KHOUALKA,CITRUS VOLKAMERIANA,202050,IMG-00006-43.jpg,89,87,85,2,4,0.9770114942528736,0.9550561797752808
2022,KHOUALKA,CITRUS VOLKAMERIANA,202050,IMG-00010-43.jpg,94,92,91,1,3,0.9891304347826086,0.9680851063829788
2022,KHOUALKA,CITRUS VOLKAMERIANA,202050,IMG-00011-43.jpg,151,148,144,4,7,0.972972972972973,0.9536423841059604
2022,KHOUALKA,CITRUS VOLKAMERIANA,202050,IMG-00020-43.jpg,129,119,118,1,11,0.9915966386554622,0.9147286821705426
2022,KHOUALKA,CITRUS VOLKAMERIANA,202070,IMG-00006-43.jpg,68,66,63,3,5,0.9545454545454546,0.9264705882352942
2022,KHOUALKA,CITRUS VOLKAMERIANA,202070,IMG-00009-43.jpg,120,116,115,1,5,0.9913793103448276,0.9583333333333334
2022,KHOUALKA,CITRUS VOLKAMERIANA,202070,IMG-00013-43.jpg,95,89,89,0,6,1.0,0.936842105263158
2022,KHOUALKA,CITRUS VOLKAMERIANA,202070,IMG-00019-43.jpg,57,56,54,2,3,0.9642857142857144,0.9473684210526316
2022,KHOUALKA,CITRUS VOLKAMERIANA,202080,IMG-00005-43.jpg,65,64,63,1,2,0.984375,0.9692307692307692
2022,KHOUALKA,CITRUS VOLKAMERIANA,202080,IMG-00008-43.jpg,31,29,29,0,2,1.0,0.935483870967742
2022,KHOUALKA,CITRUS VOLKAMERIANA,202080,IMG-00015-43.jpg,220,216,210,6,10,0.9722222222222222,0.9545454545454546
2022,KHOUALKA,CITRUS VOLKAMERIANA,202080,IMG-00016-43.jpg,131,131,129,2,2,0.9847328244274808,0.9847328244274808
2022,KHOUALKA,CITRANGE CARRIZO,301380,IMG-00007-43.jpg,30,27,26,1,4,0.9629629629629628,0.8666666666666667
2022,KHOUALKA,CITRANGE CARRIZO,301380,IMG-00011-43.jpg,53,55,52,3,1,0.9454545454545454,0.981132075471698
2022,KHOUALKA,CITRANGE CARRIZO,301380,IMG-00014-43.jpg,7,7,5,2,2,0.7142857142857143,0.7142857142857143
2022,KHOUALKA,CITRANGE CARRIZO,301380,IMG-00020-43.jpg,91,94,83,11,8,0.8829787234042553,0.912087912087912
2022,ONAGRI,CITRUS VOLKAMERIANA,301470,IMG-00003-44.jpg,148,146,144,2,4,0.9863013698630136,0.972972972972973
2022,ONAGRI,CITRUS VOLKAMERIANA,301470,IMG-00004-44.jpg,163,164,158,6,5,0.9634146341463414,0.9693251533742332
2022,ONAGRI,CITRUS VOLKAMERIANA,301470,IMG-00005-44.jpg,160,146,140,6,20,0.958904109589041,0.875
2022,ONAGRI,CITRUS VOLKAMERIANA,301480,IMG-00001.jpg,92,76,76,0,16,1.0,0.8260869565217391
2022,ONAGRI,CITRUS VOLKAMERIANA,301480,IMG-00003-43.jpg,26,25,25,0,1,1.0,0.9615384615384616
2022,ONAGRI,CITRUS VOLKAMERIANA,301480,IMG-00012-43.jpg,50,45,44,1,6,0.9777777777777776,0.88
2022,ONAGRI,CITRUS VOLKAMERIANA,301480,IMG-00014-43.jpg,77,68,68,0,9,1.0,0.8831168831168831
2022,ONAGRI,CITRUS VOLKAMERIANA,301490,IMG-00005-44.jpg,108,96,94,2,14,0.9791666666666666,0.8703703703703703
2022,ONAGRI,CITRUS VOLKAMERIANA,301490,IMG-00009-44.jpg,185,171,164,7,21,0.95906432748538,0.8864864864864865
2022,ONAGRI,CITRUS VOLKAMERIANA,301490,IMG-00012-44.jpg,162,153,147,6,15,0.9607843137254902,0.9074074074074074
2022,ONAGRI,CITRUS VOLKAMERIANA,301490,IMG-00015-44.jpg,109,103,100,3,9,0.970873786407767,0.9174311926605504
2022,ONAGRI,CITRUS VOLKAMERIANA,301510,IMG-00001.jpg,252,235,232,3,20,0.9872340425531916,0.9206349206349206
2022,ONAGRI,CITRUS VOLKAMERIANA,301510,IMG-00006-44.jpg,137,129,128,1,9,0.992248062015504,0.9343065693430656
2022,ONAGRI,CITRUS VOLKAMERIANA,301510,IMG-00007-44.jpg,115,116,107,9,8,0.9224137931034484,0.9304347826086956
2022,ONAGRI,CITRUS VOLKAMERIANA,301510,IMG-00008-44.jpg,150,133,127,6,23,0.9548872180451128,0.8466666666666667
2022,ONAGRI,BIGARADIER,301550,IMG-00008-44.jpg,144,136,133,3,11,0.9779411764705882,0.9236111111111112
2022,ONAGRI,BIGARADIER,301550,IMG-00011-44.jpg,40,37,35,2,5,0.945945945945946,0.875
2022,ONAGRI,BIGARADIER,301550,IMG-00013-44.jpg,76,68,66,2,10,0.9705882352941176,0.868421052631579
2022,ONAGRI,BIGARADIER,301550,IMG-00014-44.jpg,80,80,76,4,4,0.95,0.95
2022,ONAGRI,CITRUS VOLKAMERIANA,301570,IMG-00004-44.jpg,158,149,146,3,12,0.9798657718120806,0.9240506329113924
2022,ONAGRI,CITRUS VOLKAMERIANA,301570,IMG-00007-44.jpg,152,138,134,4,18,0.9710144927536232,0.881578947368421
2022,ONAGRI,CITRUS VOLKAMERIANA,301570,IMG-00008-44.jpg,103,93,89,4,14,0.956989247311828,0.8640776699029126
2022,ONAGRI,CITRUS VOLKAMERIANA,301570,IMG-00017-44.jpg,218,205,200,5,18,0.975609756097561,0.9174311926605504
2022,KHOUALKA,CITRUS VOLKAMERIANA,302340,IMG-00004-43.jpg,106,89,87,2,19,0.9775280898876404,0.8207547169811321
2022,KHOUALKA,CITRUS VOLKAMERIANA,302340,IMG-00005-43.jpg,105,91,88,3,17,0.967032967032967,0.8380952380952381
2022,KHOUALKA,CITRUS VOLKAMERIANA,302340,IMG-00011-43.jpg,75,71,71,0,4,1.0,0.9466666666666668
2022,KHOUALKA,CITRUS VOLKAMERIANA,302340,IMG-00015-43.jpg,92,81,81,0,11,1.0,0.8804347826086957
2022,KHOUALKA,CITRUS VOLKAMERIANA,302350,IMG-00008-43.jpg,33,31,29,2,4,0.935483870967742,0.8787878787878788
2022,KHOUALKA,CITRUS VOLKAMERIANA,302350,IMG-00013-43.jpg,80,76,73,3,7,0.9605263157894736,0.9125
2022,KHOUALKA,CITRUS VOLKAMERIANA,302350,IMG-00014-43.jpg,76,70,66,4,10,0.9428571428571428,0.868421052631579
2022,KHOUALKA,CITRUS VOLKAMERIANA,302350,IMG-00018-43.jpg,44,43,42,1,2,0.9767441860465116,0.9545454545454546
2022,KHOUALKA,CITRUS VOLKAMERIANA,302360,IMG-00005-43.jpg,97,92,92,0,5,1.0,0.9484536082474226
2022,KHOUALKA,CITRUS VOLKAMERIANA,302360,IMG-00006-43.jpg,118,108,108,0,10,1.0,0.9152542372881356
2022,KHOUALKA,CITRUS VOLKAMERIANA,302360,IMG-00016-43.jpg,67,63,63,0,4,1.0,0.9402985074626866
2022,KHOUALKA,CITRUS VOLKAMERIANA,302360,IMG-00021-43.jpg,65,72,65,7,0,0.9027777777777778,1.0
2022,KHOUALKA,CITRUS VOLKAMERIANA,302510,IMG-00001.jpg,73,69,68,1,5,0.9855072463768116,0.9315068493150684
2022,KHOUALKA,CITRUS VOLKAMERIANA,302510,IMG-00002-43.jpg,44,44,44,0,0,1.0,1.0
2022,KHOUALKA,CITRUS VOLKAMERIANA,302510,IMG-00003-43.jpg,78,79,77,2,1,0.9746835443037974,0.9871794871794872
2022,KHOUALKA,CITRUS VOLKAMERIANA,302510,IMG-00015-43.jpg,49,44,39,5,10,0.8863636363636364,0.7959183673469388
2022,KHOUALKA,BIGARADIER,401410,IMG-00093-43.jpg,35,25,25,0,10,1.0,0.7142857142857143
2022,KHOUALKA,BIGARADIER,401410,IMG-00099-43.jpg,6,4,4,0,2,1.0,0.6666666666666666
2022,KHOUALKA,BIGARADIER,401410,IMG-00102-43.jpg,78,65,65,0,13,1.0,0.8333333333333334
2022,KHOUALKA,BIGARADIER,401410,IMG-00104-43.jpg,81,66,64,2,17,0.9696969696969696,0.7901234567901234
2022,ONAGRI,CITRANGE C35,401660,IMG-00001.jpg,56,56,53,3,3,0.9464285714285714,0.9464285714285714
2022,ONAGRI,CITRANGE C35,401660,IMG-00008-44.jpg,42,39,39,0,3,1.0,0.9285714285714286
2022,ONAGRI,CITRANGE C35,401660,IMG-00010-44.jpg,29,29,26,3,3,0.896551724137931,0.896551724137931
2022,ONAGRI,CITRANGE C35,401660,IMG-00016-44.jpg,64,60,57,3,7,0.95,0.890625
2022,ONAGRI,CITRANGE C35,401710,IMG-00003-44.jpg,51,42,42,0,9,1.0,0.8235294117647058
2022,ONAGRI,CITRANGE C35,401710,IMG-00012-44.jpg,19,18,18,0,1,1.0,0.9473684210526316
2022,ONAGRI,CITRANGE C35,401710,IMG-00013-44.jpg,33,30,29,1,4,0.9666666666666668,0.8787878787878788
2022,ONAGRI,CITRANGE C35,401710,IMG-00019-44.jpg,76,74,74,0,2,1.0,0.9736842105263158
2022,ONAGRI,CITRANGE C35,401720,IMG-00007-44.jpg,93,96,92,4,1,0.9583333333333334,0.989247311827957
2022,ONAGRI,CITRANGE C35,401720,IMG-00008-44.jpg,38,37,34,3,4,0.918918918918919,0.8947368421052632
2022,ONAGRI,CITRANGE C35,401720,IMG-00010-44.jpg,50,45,44,1,6,0.9777777777777776,0.88
2022,ONAGRI,CITRANGE C35,401720,IMG-00017-44.jpg,68,66,62,4,6,0.9393939393939394,0.9117647058823528
2022,ONAGRI,CITRANGE C35,401730,IMG-00001.jpg,19,19,19,0,0,1.0,1.0
2022,ONAGRI,CITRANGE C35,401730,IMG-00010-44.jpg,50,50,50,0,0,1.0,1.0
2022,ONAGRI,CITRANGE C35,401730,IMG-00013-44.jpg,75,73,69,4,6,0.9452054794520548,0.92
2022,ONAGRI,CITRANGE C35,401730,IMG-00016-44.jpg,36,33,33,0,3,1.0,0.9166666666666666
2022,ONAGRI,CITRANGE C35,401750,IMG-00005-44.jpg,88,77,75,2,13,0.974025974025974,0.8522727272727273
2022,ONAGRI,CITRANGE C35,401750,IMG-00009-44.jpg,127,108,107,1,20,0.9907407407407408,0.84251968503937
2022,ONAGRI,CITRANGE C35,401750,IMG-00016-44.jpg,107,97,94,3,13,0.9690721649484536,0.8785046728971962
2022,ONAGRI,CITRANGE C35,401750,IMG-00024-44.jpg,50,45,40,5,10,0.8888888888888888,0.8
2022,ONAGRI,CITRUMELO SACCATON,401770,IMG-00003-44.jpg,24,21,21,0,3,1.0,0.875
2022,ONAGRI,CITRUMELO SACCATON,401770,IMG-00008-44.jpg,72,74,71,3,1,0.9594594594594594,0.9861111111111112
2022,ONAGRI,CITRUMELO SACCATON,401770,IMG-00009-44.jpg,14,13,13,0,1,1.0,0.9285714285714286
2022,ONAGRI,CITRUMELO SACCATON,401770,IMG-00017-44.jpg,20,15,15,0,5,1.0,0.75
2022,KHOUALKA,BIGARADIER,402440,IMG-00005-43.jpg,17,12,11,1,6,0.9166666666666666,0.6470588235294118
2022,KHOUALKA,BIGARADIER,402440,IMG-00012-43.jpg,46,39,37,2,9,0.9487179487179488,0.8043478260869565
2022,KHOUALKA,BIGARADIER,402440,IMG-00014-43.jpg,11,9,9,0,2,1.0,0.8181818181818182
2022,KHOUALKA,BIGARADIER,402440,IMG-00015-43.jpg,22,14,14,0,8,1.0,0.6363636363636364
2022,KHOUALKA,BIGARADIER,402590,IMG-00007-43.jpg,104,92,90,2,14,0.9782608695652174,0.8653846153846154
2022,KHOUALKA,BIGARADIER,402590,IMG-00012-43.jpg,45,41,40,1,5,0.975609756097561,0.8888888888888888
2022,KHOUALKA,BIGARADIER,402590,IMG-00015-43.jpg,58,53,52,1,6,0.981132075471698,0.896551724137931
2022,KHOUALKA,BIGARADIER,402590,IMG-00019-43.jpg,64,63,63,0,1,1.0,0.984375
2022,KHOUALKA,CITRUS VOLKAMERIANA,501520,IMG-00004-43.jpg,39,36,35,1,4,0.9722222222222222,0.8974358974358975
2022,KHOUALKA,CITRUS VOLKAMERIANA,501520,IMG-00007-43.jpg,43,42,41,1,2,0.9761904761904762,0.9534883720930232
2022,KHOUALKA,CITRUS VOLKAMERIANA,501520,IMG-00015-43.jpg,18,9,9,0,9,1.0,0.5
2022,KHOUALKA,CITRUS VOLKAMERIANA,501520,IMG-00020-43.jpg,48,44,44,0,4,1.0,0.9166666666666666
2022,KHOUALKA,CITRUS VOLKAMERIANA,501540,IMG-00006-43.jpg,38,37,36,1,2,0.972972972972973,0.9473684210526316
2022,KHOUALKA,CITRUS VOLKAMERIANA,501540,IMG-00012-43.jpg,102,102,94,8,8,0.9215686274509804,0.9215686274509804
2022,KHOUALKA,CITRUS VOLKAMERIANA,501540,IMG-00017-43.jpg,138,128,124,4,14,0.96875,0.8985507246376812
2022,KHOUALKA,CITRUS VOLKAMERIANA,501540,IMG-00018-43.jpg,51,47,47,0,4,1.0,0.9215686274509804
2022,KHOUALKA,CITRUS VOLKAMERIANA,501660,IMG-00006-43.jpg,60,61,59,2,1,0.9672131147540984,0.9833333333333332
2022,KHOUALKA,CITRUS VOLKAMERIANA,501660,IMG-00016-43.jpg,63,59,58,1,5,0.9830508474576272,0.9206349206349206
2022,KHOUALKA,CITRUS VOLKAMERIANA,501660,IMG-00018-43.jpg,112,98,92,6,20,0.9387755102040816,0.8214285714285714
2022,KHOUALKA,CITRUS VOLKAMERIANA,501660,IMG-00021-43.jpg,90,91,88,3,2,0.967032967032967,0.9777777777777776
2022,KHOUALKA,CITRUS VOLKAMERIANA,501680,IMG-00005-43.jpg,179,167,167,0,12,1.0,0.9329608938547486
2022,KHOUALKA,CITRUS VOLKAMERIANA,501680,IMG-00011-43.jpg,101,88,88,0,13,1.0,0.8712871287128713
2022,KHOUALKA,CITRUS VOLKAMERIANA,501680,IMG-00012-43.jpg,76,67,66,1,10,0.9850746268656716,0.868421052631579
2022,KHOUALKA,CITRUS VOLKAMERIANA,501680,IMG-00016-43.jpg,113,99,98,1,15,0.98989898989899,0.8672566371681416
2022,KHOUALKA,CITRUS VOLKAMERIANA,501690,IMG-00032-43.jpg,34,30,29,1,5,0.9666666666666668,0.8529411764705882
2022,KHOUALKA,CITRUS VOLKAMERIANA,501690,IMG-00039-43.jpg,186,169,168,1,18,0.9940828402366864,0.9032258064516128
2022,KHOUALKA,CITRUS VOLKAMERIANA,501690,IMG-00047-43.jpg,103,91,90,1,13,0.989010989010989,0.8737864077669902
2022,KHOUALKA,CITRUS VOLKAMERIANA,501690,IMG-00049-43.jpg,166,156,154,2,12,0.9871794871794872,0.927710843373494
2022,KHOUALKA,CITRUS VOLKAMERIANA,501760,IMG-00001.jpg,94,76,76,0,18,1.0,0.8085106382978723
2022,KHOUALKA,CITRUS VOLKAMERIANA,501760,IMG-00034-43.jpg,45,31,30,1,15,0.967741935483871,0.6666666666666666
2022,KHOUALKA,CITRUS VOLKAMERIANA,501760,IMG-00036-43.jpg,40,32,31,1,9,0.96875,0.775
2022,KHOUALKA,CITRUS VOLKAMERIANA,501760,IMG-00051-43.jpg,92,84,83,1,9,0.988095238095238,0.9021739130434784
2022,ONAGRI,CITRUMELO SACCATON,510910,IMG-00004-44.jpg,73,69,67,2,6,0.9710144927536232,0.9178082191780822
2022,ONAGRI,CITRUMELO SACCATON,510910,IMG-00008-44.jpg,152,133,133,0,19,1.0,0.875
2022,ONAGRI,CITRUMELO SACCATON,510910,IMG-00010-44.jpg,107,96,95,1,12,0.9895833333333334,0.8878504672897196
2022,ONAGRI,CITRUMELO SACCATON,510910,IMG-00011-44.jpg,92,87,86,1,6,0.9885057471264368,0.9347826086956522
2022,ONAGRI,CITRUMELO SACCATON,510950,IMG-00006-44.jpg,70,64,64,0,6,1.0,0.9142857142857144
2022,ONAGRI,CITRUMELO SACCATON,510950,IMG-00008-44.jpg,75,70,67,3,8,0.9571428571428572,0.8933333333333333
2022,ONAGRI,CITRUMELO SACCATON,510950,IMG-00009-44.jpg,85,74,74,0,11,1.0,0.8705882352941177
2022,ONAGRI,CITRUMELO SACCATON,510950,IMG-00011-44.jpg,135,124,124,0,11,1.0,0.9185185185185184
2022,ONAGRI,MC PONSIRUCE TRIFOLIATA,510980,IMG-00014-44.jpg,67,65,63,2,4,0.9692307692307692,0.9402985074626866
2022,ONAGRI,MC PONSIRUCE TRIFOLIATA,510980,IMG-00015-44.jpg,51,49,48,1,3,0.979591836734694,0.9411764705882352
2022,ONAGRI,MC PONSIRUCE TRIFOLIATA,510980,IMG-00016-44.jpg,99,92,87,5,12,0.9456521739130436,0.8787878787878788
2022,ONAGRI,MC PONSIRUCE TRIFOLIATA,510980,IMG-00019-44.jpg,102,91,89,2,13,0.978021978021978,0.8725490196078431
2022,ONAGRI,MC PONSIRUCE TRIFOLIATA,510990,IMG-00006-44.jpg,135,130,126,4,9,0.9692307692307692,0.9333333333333332
2022,ONAGRI,MC PONSIRUCE TRIFOLIATA,510990,IMG-00008-44.jpg,110,107,103,4,7,0.9626168224299064,0.9363636363636364
2022,ONAGRI,MC PONSIRUCE TRIFOLIATA,510990,IMG-00009-44.jpg,85,75,73,2,12,0.9733333333333334,0.8588235294117647
2022,ONAGRI,MC PONSIRUCE TRIFOLIATA,510990,IMG-00024-44.jpg,65,62,62,0,3,1.0,0.953846153846154
2022,ONAGRI,MC PONSIRUCE TRIFOLIATA,511030,IMG-00007-44.jpg,100,92,91,1,9,0.9891304347826086,0.91
2022,ONAGRI,MC PONSIRUCE TRIFOLIATA,511030,IMG-00016-44.jpg,63,60,58,2,5,0.9666666666666668,0.9206349206349206
2022,ONAGRI,MC PONSIRUCE TRIFOLIATA,511030,IMG-00022-44.jpg,98,94,92,2,6,0.9787234042553192,0.9387755102040816
2022,ONAGRI,MC PONSIRUCE TRIFOLIATA,511030,IMG-00027-44.jpg,82,82,80,2,2,0.975609756097561,0.975609756097561
2022,ONAGRI,MS PONSIRUCE TRIFOLIATA,511040,IMG-00004-44.jpg,77,69,68,1,9,0.9855072463768116,0.8831168831168831
2022,ONAGRI,MS PONSIRUCE TRIFOLIATA,511040,IMG-00014-44.jpg,48,41,40,1,8,0.975609756097561,0.8333333333333334
2022,ONAGRI,MS PONSIRUCE TRIFOLIATA,511040,IMG-00016-44.jpg,71,70,70,0,1,1.0,0.9859154929577464
2022,ONAGRI,MS PONSIRUCE TRIFOLIATA,511040,IMG-00025-44.jpg,56,51,51,0,5,1.0,0.9107142857142856
2022,ONAGRI,FUZHU,511050,IMG-00004-44.jpg,109,105,101,4,8,0.961904761904762,0.926605504587156
2022,ONAGRI,FUZHU,511050,IMG-00006-44.jpg,142,122,119,3,23,0.9754098360655736,0.8380281690140845
2022,ONAGRI,FUZHU,511050,IMG-00011-44.jpg,172,167,164,3,8,0.9820359281437124,0.9534883720930232
2022,ONAGRI,FUZHU,511050,IMG-00022-44.jpg,194,187,185,2,9,0.9893048128342246,0.9536082474226804
2022,ONAGRI,MS PONSIRUCE TRIFOLIATA,511060,IMG-00007-44.jpg,115,115,112,3,3,0.9739130434782608,0.9739130434782608
2022,ONAGRI,MS PONSIRUCE TRIFOLIATA,511060,IMG-00016-44.jpg,102,90,89,1,13,0.9888888888888888,0.8725490196078431
2022,ONAGRI,MS PONSIRUCE TRIFOLIATA,511060,IMG-00017-44.jpg,59,55,55,0,4,1.0,0.9322033898305084
2022,ONAGRI,MS PONSIRUCE TRIFOLIATA,511060,IMG-00019-44.jpg,108,95,90,5,18,0.9473684210526316,0.8333333333333334
2022,ONAGRI,FUZHU,511070,IMG-00006-44.jpg,82,83,79,4,3,0.9518072289156626,0.9634146341463414
2022,ONAGRI,FUZHU,511070,IMG-00016-44.jpg,96,89,83,6,13,0.9325842696629212,0.8645833333333334
2022,ONAGRI,FUZHU,511070,IMG-00018-44.jpg,93,87,87,0,6,1.0,0.935483870967742
2022,ONAGRI,FUZHU,511070,IMG-00019-44.jpg,142,132,130,2,12,0.9848484848484848,0.9154929577464788
