compagnie,Domaine,Porte-greffe,parcelle,Filename,True_count,detect_count,TP,FP,FN,Precision,Recall
2022,SAOUDA,BIGARADIER,10010,IMG-00011-45.jpg,28,37,28,9,0,0.7567567567567568,1.0
2022,SAOUDA,BIGARADIER,10010,IMG-00012-45.jpg,27,31,26,5,1,0.8387096774193549,0.9629629629629628
2022,SAOUDA,BIGARADIER,10010,IMG-00014-45.jpg,50,63,48,15,2,0.7619047619047619,0.96
2022,SAOUDA,BIGARADIER,10010,IMG-00018-45.jpg,30,37,29,8,1,0.7837837837837838,0.9666666666666668
2022,SAOUDA,BIGARADIER,10010,IMG-00020-45.jpg,31,41,31,10,0,0.7560975609756098,1.0
2024,SAOUDA,BIGARADIER,10010,IMG-23410.jpg,85,55,53,2,32,0.9636363636363636,0.6235294117647059
2024,SAOUDA,BIGARADIER,10010,IMG-23417.jpg,86,62,62,0,24,1.0,0.7209302325581395
2024,SAOUDA,BIGARADIER,10010,IMG-23430.jpg,74,57,57,0,17,1.0,0.7702702702702703
2024,SAOUDA,BIGARADIER,10010,IMG-23647.jpg,95,80,78,2,17,0.975,0.8210526315789474
2024,SAOUDA,BIGARADIER,10010,IMG-23672.jpg,47,24,23,1,24,0.9583333333333334,0.4893617021276596
2024,SAOUDA,BIGARADIER,10010,IMG-23707.jpg,30,24,24,0,6,1.0,0.8
2024,SAOUDA,BIGARADIER,10010,IMG-23709.jpg,31,22,22,0,9,1.0,0.7096774193548387
2024,SAOUDA,BIGARADIER,10010,IMG-23711.jpg,79,54,52,2,27,0.9629629629629628,0.6582278481012658
2022,SAOUDA,MACROPHYLLA,10030,IMG-00158-45.jpg,101,136,101,35,0,0.7426470588235294,1.0
2022,SAOUDA,MACROPHYLLA,10030,IMG-00159-45.jpg,155,191,153,38,2,0.8010471204188482,0.9870967741935484
2022,SAOUDA,MACROPHYLLA,10030,IMG-00162-45.jpg,119,144,118,26,1,0.8194444444444444,0.9915966386554622
2022,SAOUDA,MACROPHYLLA,10030,IMG-00169-45.jpg,72,97,72,25,0,0.7422680412371134,1.0
2022,SAOUDA,MACROPHYLLA,10031,IMG-00002-45.jpg,46,54,43,11,3,0.7962962962962963,0.9347826086956522
2022,SAOUDA,MACROPHYLLA,10031,IMG-00084-45.jpg,41,48,40,8,1,0.8333333333333334,0.975609756097561
2022,SAOUDA,MACROPHYLLA,10031,IMG-00450-45.jpg,27,40,26,14,1,0.65,0.9629629629629628
2022,SAOUDA,MACROPHYLLA,10031,IMG-00451-45.jpg,34,40,30,10,4,0.75,0.8823529411764706
2022,SAOUDA,MACROPHYLLA,10031,IMG-00464-45.jpg,33,42,33,9,0,0.7857142857142857,1.0
2022,ONAGRI,CITRUS VOLKAMERIANA,10101,IMG-00003-39.jpg,120,119,112,7,8,0.9411764705882352,0.9333333333333332
2022,ONAGRI,CITRUS VOLKAMERIANA,10101,IMG-00010-39.jpg,85,81,76,5,9,0.9382716049382716,0.8941176470588236
2024,ONAGRI,CITRUS VOLKAMERIANA,10101,IMG-10523.jpg,288,229,227,2,61,0.9912663755458516,0.7881944444444444
2024,ONAGRI,CITRUS VOLKAMERIANA,10101,IMG-10545.jpg,98,76,76,0,22,1.0,0.7755102040816326
2024,ONAGRI,CITRUS VOLKAMERIANA,10101,IMG-10558.jpg,143,103,101,2,42,0.9805825242718448,0.7062937062937062
2022,ONAGRI,CITRUS VOLKAMERIANA,10102,IMG-00003-39.jpg,48,41,41,0,7,1.0,0.8541666666666666
2024,ONAGRI,CITRUS VOLKAMERIANA,10102,IMG-10637.jpg,140,111,110,1,30,0.990990990990991,0.7857142857142857
2024,ONAGRI,CITRUS VOLKAMERIANA,10102,IMG-10658.jpg,163,129,127,2,36,0.9844961240310076,0.7791411042944786
2022,ONAGRI,CITRUS VOLKAMERIANA,10103,IMG-00003-39.jpg,215,197,188,9,27,0.9543147208121828,0.8744186046511628
2022,ONAGRI,CITRUS VOLKAMERIANA,10103,IMG-00008-39.jpg,195,189,178,11,17,0.9417989417989416,0.9128205128205128
2024,ONAGRI,CITRUS VOLKAMERIANA,10103,IMG-10614.jpg,134,113,112,1,22,0.991150442477876,0.835820895522388
2024,ONAGRI,CITRUS VOLKAMERIANA,10103,IMG-10630.jpg,213,175,173,2,40,0.9885714285714284,0.812206572769953
2024,ONAGRI,CITRUS VOLKAMERIANA,10103,IMG-10631.jpg,134,99,99,0,35,1.0,0.7388059701492538
2022,ONAGRI,CITRUS VOLKAMERIANA,10104,IMG-00004-39.jpg,65,61,59,2,6,0.9672131147540984,0.9076923076923076
2022,ONAGRI,CITRUS VOLKAMERIANA,10104,IMG-00008-39.jpg,69,63,57,6,12,0.9047619047619048,0.8260869565217391
2024,ONAGRI,CITRUS VOLKAMERIANA,10104,IMG-11267.jpg,22,13,13,0,9,1.0,0.5909090909090909
2024,ONAGRI,CITRUS VOLKAMERIANA,10104,IMG-11327.jpg,128,97,95,2,33,0.979381443298969,0.7421875
2024,ONAGRI,CITRUS VOLKAMERIANA,10104,IMG-11347.jpg,118,85,85,0,33,1.0,0.7203389830508474
2024,ONAGRI,CITRUS VOLKAMERIANA,10104,IMG-11366.jpg,351,242,240,2,111,0.9917355371900828,0.6837606837606838
2024,ONAGRI,CITRUS VOLKAMERIANA,10104,IMG-11386.jpg,99,72,72,0,27,1.0,0.7272727272727273
2022,ONAGRI,CITRUS VOLKAMERIANA,10105,IMG-00004-39.jpg,17,16,13,3,4,0.8125,0.7647058823529411
2022,ONAGRI,CITRUS VOLKAMERIANA,10105,IMG-00005-39.jpg,68,69,63,6,5,0.9130434782608696,0.9264705882352942
2022,ONAGRI,CITRUS VOLKAMERIANA,10108,IMG-00003-39.jpg,61,56,55,1,6,0.9821428571428572,0.9016393442622952
2022,ONAGRI,CITRUS VOLKAMERIANA,10108,IMG-00007-39.jpg,69,61,61,0,8,1.0,0.8840579710144928
2022,ONAGRI,CITRUS VOLKAMERIANA,10109,IMG-00003-39.jpg,4,4,4,0,0,1.0,1.0
2022,ONAGRI,CITRUS VOLKAMERIANA,10109,IMG-00008-39.jpg,105,102,97,5,8,0.9509803921568628,0.923809523809524
2022,KHOUALKA,CITRANGE CARRIZO,10213,IMG-00001.jpg,77,90,74,16,3,0.8222222222222222,0.961038961038961
2022,KHOUALKA,CITRANGE CARRIZO,10213,IMG-00005-40.jpg,73,85,72,13,1,0.8470588235294118,0.9863013698630136
2022,KHOUALKA,CITRANGE CARRIZO,10213,IMG-00009-40.jpg,14,16,13,3,1,0.8125,0.9285714285714286
2022,KHOUALKA,CITRANGE CARRIZO,10213,IMG-00014-40.jpg,21,23,20,3,1,0.8695652173913043,0.9523809523809524
2022,KHOUALKA,CITRANGE CARRIZO,10213,IMG-00028-40.jpg,47,47,45,2,2,0.9574468085106383,0.9574468085106383
2022,KHOUALKA,CITRANGE CARRIZO,10213,IMG-00034-40.jpg,48,48,47,1,1,0.9791666666666666,0.9791666666666666
2022,KHOUALKA,CITRANGE CARRIZO,10213,IMG-00035-40.jpg,37,39,36,3,1,0.9230769230769232,0.972972972972973
2022,KHOUALKA,CITRANGE CARRIZO,10213,IMG-00036-40.jpg,47,52,46,6,1,0.8846153846153846,0.9787234042553192
2022,KHOUALKA,CITRANGE CARRIZO,10213,IMG-00042-40.jpg,22,25,21,4,1,0.84,0.9545454545454546
2022,KHOUALKA,CITRANGE CARRIZO,10213,IMG-00047-40.jpg,70,75,68,7,2,0.9066666666666666,0.9714285714285714
2022,KHOUALKA,CITRANGE CARRIZO,10213,IMG-00054-40.jpg,33,37,33,4,0,0.8918918918918919,1.0
2022,KHOUALKA,CITRANGE CARRIZO,10213,IMG-00055-40.jpg,93,103,91,12,2,0.883495145631068,0.978494623655914
2022,KHOUALKA,CITRANGE CARRIZO,10213,IMG-00061-40.jpg,113,120,109,11,4,0.9083333333333332,0.9646017699115044
2022,KHOUALKA,CITRANGE CARRIZO,10213,IMG-00066-40.jpg,48,54,42,12,6,0.7777777777777778,0.875
2024,KHOUALKA,CITRANGE CARRIZO,10213,IMG-12628.jpg,119,106,104,2,15,0.981132075471698,0.8739495798319328
2024,KHOUALKA,CITRANGE CARRIZO,10213,IMG-12774.jpg,118,99,99,0,19,1.0,0.8389830508474576
2024,KHOUALKA,CITRANGE CARRIZO,10213,IMG-12780.jpg,44,40,39,1,5,0.975,0.8863636363636364
2024,KHOUALKA,CITRANGE CARRIZO,10213,IMG-12791.jpg,166,126,123,3,43,0.9761904761904762,0.7409638554216867
2024,KHOUALKA,CITRANGE CARRIZO,10213,IMG-12834.jpg,57,44,43,1,14,0.9772727272727272,0.7543859649122807
2024,KHOUALKA,CITRANGE CARRIZO,10213,IMG-12945.jpg,130,105,105,0,25,1.0,0.8076923076923077
2022,OUARGHA,MACROPHYLLA,11010,IMG-00001.jpg,40,41,39,2,1,0.951219512195122,0.975
2022,OUARGHA,MACROPHYLLA,11010,IMG-00015-41.jpg,24,28,23,5,1,0.8214285714285714,0.9583333333333334
2022,OUARGHA,MACROPHYLLA,11010,IMG-00019-41.jpg,20,32,20,12,0,0.625,1.0
2022,OUARGHA,MACROPHYLLA,11010,IMG-00024-41.jpg,21,24,20,4,1,0.8333333333333334,0.9523809523809524
2022,OUARGHA,MACROPHYLLA,11020,IMG-00017-41.jpg,51,58,51,7,0,0.8793103448275862,1.0
2022,OUARGHA,MACROPHYLLA,11020,IMG-00018-41.jpg,13,13,13,0,0,1.0,1.0
2022,OUARGHA,CITRANGE CARRIZO,13010,IMG-00067-41.jpg,55,75,55,20,0,0.7333333333333333,1.0
2022,OUARGHA,CITRANGE CARRIZO,13010,IMG-00086-41.jpg,49,59,49,10,0,0.8305084745762712,1.0
2022,OUARGHA,CITRANGE CARRIZO,13010,IMG-00194-41.jpg,33,41,33,8,0,0.8048780487804879,1.0
2022,OUARGHA,CITRANGE CARRIZO,13020,IMG-00023-41.jpg,31,35,31,4,0,0.8857142857142857,1.0
2022,OUARGHA,CITRANGE CARRIZO,13020,IMG-00024-41.jpg,18,27,18,9,0,0.6666666666666666,1.0
2022,OUARGHA,CITRANGE CARRIZO,13020,IMG-00039-41.jpg,4,12,4,8,0,0.3333333333333333,1.0
2022,OUARGHA,CITRANGE CARRIZO,13020,IMG-00040-41.jpg,6,13,6,7,0,0.4615384615384616,1.0
2022,OUARGHA,CITRUS VOLKAMERIANA,13030,IMG-00009-41.jpg,18,23,17,6,1,0.7391304347826086,0.9444444444444444
2022,OUARGHA,CITRUS VOLKAMERIANA,13030,IMG-00013-41.jpg,46,71,46,25,0,0.647887323943662,1.0
2022,OUARGHA,CITRUS VOLKAMERIANA,13030,IMG-00027-41.jpg,12,28,12,16,0,0.4285714285714285,1.0
2022,OUARGHA,CITRUS VOLKAMERIANA,13030,IMG-00029-41.jpg,18,32,18,14,0,0.5625,1.0
2022,OUARGHA,CITRUS VOLKAMERIANA,13030,IMG-00036-41.jpg,16,35,16,19,0,0.4571428571428571,1.0
2022,OUARGHA,CITRUS VOLKAMERIANA,14010,IMG-00008-41.jpg,40,48,40,8,0,0.8333333333333334,1.0
2022,OUARGHA,CITRUS VOLKAMERIANA,14010,IMG-00010-41.jpg,49,55,47,8,2,0.8545454545454545,0.9591836734693876
2022,OUARGHA,CITRUS VOLKAMERIANA,14010,IMG-00011-41.jpg,47,62,47,15,0,0.7580645161290323,1.0
2022,OUARGHA,CITRUS VOLKAMERIANA,14010,IMG-00018-41.jpg,44,60,43,17,1,0.7166666666666667,0.9772727272727272
2022,KHOUALKA,MACROPHYLLA,20118,IMG-00007-40.jpg,44,46,43,3,1,0.9347826086956522,0.9772727272727272
2022,KHOUALKA,MACROPHYLLA,20118,IMG-00008-40.jpg,115,135,114,21,1,0.8444444444444444,0.991304347826087
2022,KHOUALKA,MACROPHYLLA,20118,IMG-00022-40.jpg,113,115,109,6,4,0.9478260869565216,0.9646017699115044
2022,KHOUALKA,MACROPHYLLA,20118,IMG-00033-40.jpg,58,64,57,7,1,0.890625,0.9827586206896552
2022,KHOUALKA,MACROPHYLLA,20118,IMG-00037-40.jpg,29,32,29,3,0,0.90625,1.0
2022,KHOUALKA,MACROPHYLLA,20118,IMG-00042-40.jpg,137,147,133,14,4,0.9047619047619048,0.9708029197080292
2022,KHOUALKA,MACROPHYLLA,20118,IMG-00046-40.jpg,45,57,43,14,2,0.7543859649122807,0.9555555555555556
2022,KHOUALKA,MACROPHYLLA,20118,IMG-00050-40.jpg,48,50,45,5,3,0.9,0.9375
2022,KHOUALKA,MACROPHYLLA,20118,IMG-00055-40.jpg,52,57,50,7,2,0.8771929824561403,0.9615384615384616
2022,KHOUALKA,MACROPHYLLA,20118,IMG-00061-40.jpg,120,128,111,17,9,0.8671875,0.925
2022,KHOUALKA,MACROPHYLLA,20118,IMG-00062-40.jpg,63,62,56,6,7,0.9032258064516128,0.8888888888888888
2022,KHOUALKA,MACROPHYLLA,20118,IMG-00063-40.jpg,47,50,42,8,5,0.84,0.8936170212765957
2022,KHOUALKA,MACROPHYLLA,20118,IMG-00066-40.jpg,84,93,82,11,2,0.8817204301075269,0.9761904761904762
2024,KHOUALKA,MACROPHYLLA,20118,IMG-12691.jpg,22,15,15,0,7,1.0,0.6818181818181818
2024,KHOUALKA,MACROPHYLLA,20118,IMG-12729.jpg,56,43,43,0,13,1.0,0.7678571428571429
2024,KHOUALKA,MACROPHYLLA,20118,IMG-12735.jpg,88,68,68,0,20,1.0,0.7727272727272727
2024,KHOUALKA,MACROPHYLLA,20118,IMG-12748.jpg,107,81,79,2,28,0.9753086419753086,0.7383177570093458
2024,KHOUALKA,MACROPHYLLA,20118,IMG-12764.jpg,111,94,92,2,19,0.9787234042553192,0.8288288288288288
2024,KHOUALKA,MACROPHYLLA,20118,IMG-12808.jpg,113,76,75,1,38,0.986842105263158,0.6637168141592921
2024,KHOUALKA,MACROPHYLLA,20118,IMG-12851.jpg,24,12,12,0,12,1.0,0.5
2022,KHOUALKA,MACROPHYLLA,20119,IMG-00005-40.jpg,106,112,103,9,3,0.9196428571428572,0.9716981132075472
2022,KHOUALKA,MACROPHYLLA,20119,IMG-00008-40.jpg,142,146,133,13,9,0.910958904109589,0.9366197183098592
2022,KHOUALKA,MACROPHYLLA,20119,IMG-00014-40.jpg,132,140,132,8,0,0.9428571428571428,1.0
2022,KHOUALKA,BIGARADIER,20132,IMG-00004-40.jpg,181,185,178,7,3,0.9621621621621622,0.9834254143646408
2022,KHOUALKA,BIGARADIER,20132,IMG-00025-40.jpg,91,103,88,15,3,0.8543689320388349,0.967032967032967
2022,KHOUALKA,BIGARADIER,20132,IMG-00028-40.jpg,49,55,49,6,0,0.8909090909090909,1.0
2022,KHOUALKA,BIGARADIER,20132,IMG-00035-40.jpg,103,116,103,13,0,0.8879310344827587,1.0
2022,KHOUALKA,BIGARADIER,20132,IMG-00039-40.jpg,119,131,115,16,4,0.8778625954198473,0.9663865546218487
2022,KHOUALKA,BIGARADIER,20132,IMG-00046-40.jpg,156,167,153,14,3,0.9161676646706588,0.9807692307692308
2022,KHOUALKA,BIGARADIER,20132,IMG-00051-40.jpg,108,112,103,9,5,0.9196428571428572,0.9537037037037036
2022,KHOUALKA,BIGARADIER,20132,IMG-00055-40.jpg,67,64,61,3,6,0.953125,0.9104477611940298
2022,KHOUALKA,BIGARADIER,20132,IMG-00058-40.jpg,89,90,88,2,1,0.9777777777777776,0.9887640449438202
2022,KHOUALKA,BIGARADIER,20132,IMG-00059-40.jpg,139,136,131,5,8,0.9632352941176472,0.9424460431654677
2022,KHOUALKA,BIGARADIER,20132,IMG-00060-40.jpg,57,57,53,4,4,0.9298245614035088,0.9298245614035088
2022,KHOUALKA,BIGARADIER,20132,IMG-00064-40.jpg,117,129,116,13,1,0.8992248062015504,0.9914529914529916
2022,KHOUALKA,BIGARADIER,20132,IMG-00075-40.jpg,69,73,68,5,1,0.9315068493150684,0.9855072463768116
2022,ONAGRI,BIGARADIER,20139,IMG-00021-39.jpg,93,91,87,4,6,0.956043956043956,0.935483870967742
2024,KHOUALKA,CITRUS VOLKAMERIANA,20205,IMG-12040.jpg,123,100,96,4,27,0.96,0.7804878048780488
2024,KHOUALKA,CITRUS VOLKAMERIANA,20205,IMG-12058.jpg,116,110,106,4,10,0.9636363636363636,0.913793103448276
2024,KHOUALKA,CITRUS VOLKAMERIANA,20207,IMG-11892.jpg,94,71,69,2,25,0.971830985915493,0.7340425531914894
2024,KHOUALKA,CITRUS VOLKAMERIANA,20207,IMG-11921.jpg,264,194,190,4,74,0.979381443298969,0.7196969696969697
2024,KHOUALKA,CITRUS VOLKAMERIANA,20207,IMG-11927.jpg,195,143,141,2,54,0.986013986013986,0.7230769230769231
2024,KHOUALKA,CITRUS VOLKAMERIANA,20207,IMG-11961.jpg,113,87,87,0,26,1.0,0.7699115044247787
2024,KHOUALKA,CITRUS VOLKAMERIANA,20207,IMG-11972.jpg,94,74,68,6,26,0.918918918918919,0.723404255319149
2024,KHOUALKA,CITRUS VOLKAMERIANA,20207,IMG-11981.jpg,81,54,53,1,28,0.9814814814814816,0.654320987654321
2022,SAOUDA,CITRUS VOLKAMERIANA,21020,IMG-00033-45.jpg,67,80,65,15,2,0.8125,0.9701492537313432
2022,SAOUDA,CITRUS VOLKAMERIANA,21020,IMG-00087-45.jpg,21,27,20,7,1,0.7407407407407407,0.9523809523809524
2022,SAOUDA,CITRUS VOLKAMERIANA,21020,IMG-00138-45.jpg,40,50,40,10,0,0.8,1.0
2022,SAOUDA,CITRUS VOLKAMERIANA,21020,IMG-00145-45.jpg,37,43,37,6,0,0.8604651162790697,1.0
2022,SAOUDA,CITRUS VOLKAMERIANA,21020,IMG-00155-45.jpg,38,52,37,15,1,0.7115384615384616,0.9736842105263158
2022,SAOUDA,CITRUS VOLKAMERIANA,21030,IMG-00521-45.jpg,31,43,31,12,0,0.7209302325581395,1.0
2022,SAOUDA,CITRUS VOLKAMERIANA,21030,IMG-00524-45.jpg,71,87,71,16,0,0.8160919540229885,1.0
2022,SAOUDA,CITRUS VOLKAMERIANA,21030,IMG-00536-45.jpg,41,60,40,20,1,0.6666666666666666,0.975609756097561
2022,SAOUDA,CITRUS VOLKAMERIANA,21030,IMG-00537-45.jpg,52,67,51,16,1,0.7611940298507462,0.9807692307692308
2022,SAOUDA,CITRUS VOLKAMERIANA,22020,IMG-00053-45.jpg,39,57,39,18,0,0.6842105263157895,1.0
2022,SAOUDA,CITRUS VOLKAMERIANA,22020,IMG-00059-45.jpg,46,54,44,10,2,0.8148148148148148,0.9565217391304348
2022,SAOUDA,CITRUS VOLKAMERIANA,22020,IMG-00060-45.jpg,48,55,47,8,1,0.8545454545454545,0.9791666666666666
2022,SAOUDA,CITRUS VOLKAMERIANA,22020,IMG-00062-45.jpg,50,71,50,21,0,0.704225352112676,1.0
2022,SAOUDA,CITRUS VOLKAMERIANA,22030,IMG-00062-45.jpg,62,71,62,9,0,0.8732394366197183,1.0
2022,SAOUDA,CITRUS VOLKAMERIANA,22030,IMG-00063-45.jpg,83,99,81,18,2,0.8181818181818182,0.9759036144578314
2022,SAOUDA,CITRUS VOLKAMERIANA,22030,IMG-00065-45.jpg,58,63,56,7,2,0.8888888888888888,0.9655172413793104
2022,SAOUDA,CITRUS VOLKAMERIANA,22030,IMG-00068-45.jpg,66,78,65,13,1,0.8333333333333334,0.9848484848484848
2022,SAOUDA,CITRUS VOLKAMERIANA,23020,IMG-00024-45.jpg,47,62,46,16,1,0.7419354838709677,0.9787234042553192
2022,SAOUDA,CITRUS VOLKAMERIANA,23020,IMG-00032-45.jpg,33,38,33,5,0,0.868421052631579,1.0
2022,SAOUDA,CITRUS VOLKAMERIANA,23020,IMG-00074-45.jpg,28,33,27,6,1,0.8181818181818182,0.9642857142857144
2022,SAOUDA,CITRUS VOLKAMERIANA,23020,IMG-00079-45.jpg,28,38,28,10,0,0.7368421052631579,1.0
2022,SAOUDA,CITRUS VOLKAMERIANA,23030,IMG-00014-45.jpg,25,38,24,14,1,0.631578947368421,0.96
2022,SAOUDA,CITRUS VOLKAMERIANA,23030,IMG-00034-45.jpg,43,62,42,20,1,0.6774193548387096,0.9767441860465116
2022,SAOUDA,CITRUS VOLKAMERIANA,23030,IMG-00069-45.jpg,28,50,27,23,1,0.54,0.9642857142857144
2022,SAOUDA,CITRUS VOLKAMERIANA,23030,IMG-00079-45.jpg,50,75,49,26,1,0.6533333333333333,0.98
2022,SAOUDA,CITRANGE CARRIZO,24010,IMG-00097-45.jpg,59,71,56,15,3,0.7887323943661971,0.9491525423728814
2022,SAOUDA,CITRANGE CARRIZO,24010,IMG-00101-45.jpg,27,35,27,8,0,0.7714285714285715,1.0
2022,SAOUDA,CITRANGE CARRIZO,24010,IMG-00111-45.jpg,54,61,54,7,0,0.8852459016393442,1.0
2022,SAOUDA,CITRANGE CARRIZO,24010,IMG-00112-45.jpg,40,52,40,12,0,0.7692307692307693,1.0
2022,SAOUDA,CITRANGE CARRIZO,25010,IMG-00006-45.jpg,55,71,55,16,0,0.7746478873239436,1.0
2022,SAOUDA,CITRANGE CARRIZO,25010,IMG-00007-45.jpg,77,94,77,17,0,0.8191489361702128,1.0
2022,SAOUDA,CITRANGE CARRIZO,25010,IMG-00010-45.jpg,53,70,53,17,0,0.7571428571428571,1.0
2022,SAOUDA,CITRANGE CARRIZO,25010,IMG-00011-45.jpg,26,30,26,4,0,0.8666666666666667,1.0
2022,SAOUDA,CITRANGE CARRIZO,26010,IMG-00008-45.jpg,39,44,39,5,0,0.8863636363636364,1.0
2022,SAOUDA,CITRANGE CARRIZO,26010,IMG-00013-45.jpg,36,47,36,11,0,0.7659574468085106,1.0
2022,SAOUDA,CITRANGE CARRIZO,26010,IMG-00018-45.jpg,43,55,43,12,0,0.7818181818181819,1.0
2022,SAOUDA,CITRANGE CARRIZO,26010,IMG-00020-45.jpg,44,48,43,5,1,0.8958333333333334,0.9772727272727272
2022,KHOUALKA,CITRANGE CARRIZO,30138,IMG-00002-40.jpg,39,42,37,5,2,0.8809523809523809,0.9487179487179488
2022,KHOUALKA,CITRANGE CARRIZO,30138,IMG-00003-40.jpg,59,65,56,9,3,0.8615384615384616,0.9491525423728814
2022,KHOUALKA,CITRANGE CARRIZO,30138,IMG-00005-40.jpg,58,64,57,7,1,0.890625,0.9827586206896552
2022,KHOUALKA,CITRANGE CARRIZO,30138,IMG-00008-40.jpg,32,35,31,4,1,0.8857142857142857,0.96875
2022,KHOUALKA,CITRANGE CARRIZO,30138,IMG-00011-40.jpg,26,28,26,2,0,0.9285714285714286,1.0
2022,KHOUALKA,CITRANGE CARRIZO,30138,IMG-00019-40.jpg,2,1,1,0,1,1.0,0.5
2022,KHOUALKA,CITRANGE CARRIZO,30138,IMG-00037-40.jpg,30,39,29,10,1,0.7435897435897436,0.9666666666666668
2022,KHOUALKA,CITRANGE CARRIZO,30138,IMG-00040-40.jpg,41,44,40,4,1,0.9090909090909092,0.975609756097561
2022,KHOUALKA,CITRANGE CARRIZO,30138,IMG-00043-40.jpg,28,35,27,8,1,0.7714285714285715,0.9642857142857144
2022,KHOUALKA,CITRANGE CARRIZO,30138,IMG-00044-40.jpg,99,102,96,6,3,0.9411764705882352,0.9696969696969696
2022,KHOUALKA,CITRANGE CARRIZO,30138,IMG-00048-40.jpg,37,40,33,7,4,0.825,0.8918918918918919
2022,KHOUALKA,CITRANGE CARRIZO,30138,IMG-00057-40.jpg,73,77,70,7,3,0.9090909090909092,0.958904109589041
2022,KHOUALKA,CITRANGE CARRIZO,30138,IMG-00063-40.jpg,89,82,78,4,11,0.951219512195122,0.8764044943820225
2022,ONAGRI,CITRUS VOLKAMERIANA,30145,IMG-00018-39.jpg,219,208,200,8,19,0.9615384615384616,0.91324200913242
2022,ONAGRI,CITRUS VOLKAMERIANA,30145,IMG-00043-39.jpg,64,64,60,4,4,0.9375,0.9375
2022,ONAGRI,CITRUS VOLKAMERIANA,30146,IMG-00008-39.jpg,262,252,244,8,18,0.9682539682539684,0.931297709923664
2022,ONAGRI,CITRUS VOLKAMERIANA,30146,IMG-00045-39.jpg,190,194,182,12,8,0.9381443298969072,0.9578947368421052
2022,ONAGRI,CITRUS VOLKAMERIANA,30147,IMG-00002-39.jpg,269,261,250,11,19,0.9578544061302682,0.929368029739777
2022,ONAGRI,CITRUS VOLKAMERIANA,30147,IMG-00008-39.jpg,172,170,160,10,12,0.9411764705882352,0.9302325581395348
2022,ONAGRI,CITRUS VOLKAMERIANA,30148,IMG-00016-40.jpg,88,92,85,7,3,0.9239130434782608,0.9659090909090908
2022,ONAGRI,CITRUS VOLKAMERIANA,30148,IMG-00047-40.jpg,34,32,32,0,2,1.0,0.9411764705882352
2022,ONAGRI,CITRUS VOLKAMERIANA,30149,IMG-00018-39.jpg,151,140,136,4,15,0.9714285714285714,0.9006622516556292
2022,ONAGRI,CITRUS VOLKAMERIANA,30149,IMG-00027-39.jpg,226,205,204,1,22,0.9951219512195122,0.9026548672566372
2022,ONAGRI,CITRUS VOLKAMERIANA,30151,IMG-00012-39.jpg,185,169,161,8,24,0.9526627218934912,0.8702702702702703
2022,ONAGRI,CITRUS VOLKAMERIANA,30151,IMG-00033-39.jpg,214,205,199,6,15,0.9707317073170731,0.9299065420560748
2024,ONAGRI,CITRUS VOLKAMERIANA,30151,IMG-21881.jpg,73,52,51,1,22,0.9807692307692308,0.6986301369863014
2024,ONAGRI,CITRUS VOLKAMERIANA,30151,IMG-21935.jpg,179,135,134,1,45,0.9925925925925926,0.7486033519553073
2024,ONAGRI,CITRUS VOLKAMERIANA,30151,IMG-21936.jpg,93,67,67,0,26,1.0,0.7204301075268817
2022,ONAGRI,CITRUS VOLKAMERIANA,30152,IMG-00016-39.jpg,39,38,35,3,4,0.9210526315789472,0.8974358974358975
2022,ONAGRI,CITRUS VOLKAMERIANA,30152,IMG-00019-39.jpg,139,123,121,2,18,0.983739837398374,0.8705035971223022
2022,ONAGRI,CITRUS VOLKAMERIANA,30153,IMG-00001.jpg,157,151,145,6,12,0.9602649006622516,0.9235668789808916
2022,ONAGRI,CITRUS VOLKAMERIANA,30153,IMG-00007-39.jpg,127,114,113,1,14,0.9912280701754386,0.889763779527559
2022,ONAGRI,CITRUS VOLKAMERIANA,30153,IMG-00013-39.jpg,159,149,146,3,13,0.9798657718120806,0.9182389937106918
2022,ONAGRI,CITRUS VOLKAMERIANA,30153,IMG-00040-39.jpg,153,144,140,4,13,0.9722222222222222,0.915032679738562
2022,ONAGRI,CITRUS VOLKAMERIANA,30154,IMG-00017-39.jpg,160,154,149,5,11,0.9675324675324676,0.93125
2022,ONAGRI,CITRUS VOLKAMERIANA,30154,IMG-00027-39.jpg,220,216,210,6,10,0.9722222222222222,0.9545454545454546
2022,ONAGRI,CITRUS VOLKAMERIANA,30154,IMG-00033-39.jpg,51,50,49,1,2,0.98,0.9607843137254902
2022,ONAGRI,CITRUS VOLKAMERIANA,30154,IMG-00036-39.jpg,137,142,131,11,6,0.9225352112676056,0.9562043795620438
2022,ONAGRI,CITRUS VOLKAMERIANA,30154,IMG-00038-39.jpg,242,248,238,10,4,0.9596774193548387,0.9834710743801652
2022,ONAGRI,CITRUS VOLKAMERIANA,30154,IMG-00041-39.jpg,272,253,248,5,24,0.9802371541501976,0.9117647058823528
2022,ONAGRI,CITRUS VOLKAMERIANA,30154,IMG-00044-39.jpg,141,139,134,5,7,0.9640287769784172,0.950354609929078
2022,ONAGRI,BIGARADIER,30155,IMG-00002-39.jpg,139,145,137,8,2,0.9448275862068966,0.9856115107913668
2022,ONAGRI,BIGARADIER,30155,IMG-00003-39.jpg,115,113,107,6,8,0.9469026548672568,0.9304347826086956
2022,ONAGRI,BIGARADIER,30155,IMG-00006-39.jpg,44,46,42,4,2,0.9130434782608696,0.9545454545454546
2022,ONAGRI,BIGARADIER,30155,IMG-00011-39.jpg,100,95,94,1,6,0.9894736842105264,0.94
2022,ONAGRI,BIGARADIER,30155,IMG-00019-39.jpg,142,139,132,7,10,0.9496402877697842,0.9295774647887324
2022,ONAGRI,BIGARADIER,30155,IMG-00026-39.jpg,124,119,117,2,7,0.9831932773109244,0.9435483870967742
2022,ONAGRI,BIGARADIER,30155,IMG-00032-39.jpg,81,76,74,2,7,0.9736842105263158,0.9135802469135802
2022,ONAGRI,BIGARADIER,30155,IMG-00039-39.jpg,19,16,16,0,3,1.0,0.8421052631578947
2022,ONAGRI,BIGARADIER,30155,IMG-00043-39.jpg,130,133,123,10,7,0.924812030075188,0.946153846153846
2022,ONAGRI,CITRUS VOLKAMERIANA,30157,IMG-00003-39.jpg,227,217,217,0,10,1.0,0.9559471365638766
2022,ONAGRI,CITRUS VOLKAMERIANA,30157,IMG-00012-39.jpg,283,273,264,9,19,0.967032967032967,0.9328621908127208
2022,ONAGRI,CITRUS VOLKAMERIANA,30157,IMG-00032-39.jpg,64,68,62,6,2,0.9117647058823528,0.96875
2022,ONAGRI,CITRUS VOLKAMERIANA,30157,IMG-00035-39.jpg,159,152,146,6,13,0.9605263157894736,0.9182389937106918
2022,KHOUALKA,CITRUS VOLKAMERIANA,30235,IMG-00001.jpg,93,97,91,6,2,0.9381443298969072,0.978494623655914
2022,KHOUALKA,CITRUS VOLKAMERIANA,30235,IMG-00003-40.jpg,37,39,37,2,0,0.9487179487179488,1.0
2022,KHOUALKA,CITRUS VOLKAMERIANA,30235,IMG-00009-40.jpg,103,110,102,8,1,0.9272727272727272,0.9902912621359224
2022,KHOUALKA,CITRUS VOLKAMERIANA,30235,IMG-00013-40.jpg,90,102,87,15,3,0.8529411764705882,0.9666666666666668
2022,KHOUALKA,CITRUS VOLKAMERIANA,30235,IMG-00026-40.jpg,122,129,119,10,3,0.9224806201550388,0.9754098360655736
2022,KHOUALKA,CITRUS VOLKAMERIANA,30235,IMG-00047-40.jpg,47,49,42,7,5,0.8571428571428571,0.8936170212765957
2022,KHOUALKA,CITRUS VOLKAMERIANA,30235,IMG-00048-40.jpg,90,99,87,12,3,0.8787878787878788,0.9666666666666668
2022,KHOUALKA,CITRUS VOLKAMERIANA,30235,IMG-00049-40.jpg,44,50,42,8,2,0.84,0.9545454545454546
2022,KHOUALKA,CITRUS VOLKAMERIANA,30235,IMG-00050-40.jpg,84,87,79,8,5,0.9080459770114944,0.9404761904761904
2022,KHOUALKA,CITRUS VOLKAMERIANA,30235,IMG-00052-40.jpg,98,111,97,14,1,0.8738738738738738,0.9897959183673468
2022,KHOUALKA,CITRUS VOLKAMERIANA,30235,IMG-00057-40.jpg,80,80,74,6,6,0.925,0.925
2022,KHOUALKA,CITRUS VOLKAMERIANA,30235,IMG-00064-40.jpg,38,40,33,7,5,0.825,0.868421052631579
2022,KHOUALKA,CITRUS VOLKAMERIANA,30235,IMG-00067-40.jpg,107,105,99,6,8,0.9428571428571428,0.9252336448598132
2022,KHOUALKA,CITRUS VOLKAMERIANA,30235,IMG-00069-40.jpg,34,36,31,5,3,0.8611111111111112,0.9117647058823528
2022,KHOUALKA,CITRUS VOLKAMERIANA,30235,IMG-00075-40.jpg,95,98,89,9,6,0.9081632653061223,0.936842105263158
2022,KHOUALKA,BIGARADIER,40141,IMG-00006-40.jpg,7,9,6,3,1,0.6666666666666666,0.8571428571428571
2022,KHOUALKA,BIGARADIER,40141,IMG-00007-40.jpg,20,11,10,1,10,0.9090909090909092,0.5
2022,KHOUALKA,BIGARADIER,40141,IMG-00008-40.jpg,15,16,12,4,3,0.75,0.8
2022,ONAGRI,CITRANGE C35,40166,IMG-00009-39.jpg,38,39,37,2,1,0.9487179487179488,0.9736842105263158
2022,ONAGRI,CITRANGE C35,40166,IMG-00011-39.jpg,173,170,164,6,9,0.9647058823529412,0.9479768786127168
2022,ONAGRI,CITRANGE C35,40166,IMG-00014-39.jpg,179,177,175,2,4,0.9887005649717514,0.9776536312849162
2022,ONAGRI,CITRANGE C35,40166,IMG-00015-39.jpg,122,122,116,6,6,0.9508196721311476,0.9508196721311476
2022,ONAGRI,CITRANGE C35,40166,IMG-00041-39.jpg,102,99,99,0,3,1.0,0.9705882352941176
2022,ONAGRI,CITRANGE C35,40167,IMG-00019-39.jpg,197,196,192,4,5,0.979591836734694,0.9746192893401016
2022,ONAGRI,CITRANGE C35,40167,IMG-00030-39.jpg,126,122,119,3,7,0.9754098360655736,0.9444444444444444
2022,ONAGRI,CITRANGE C35,40167,IMG-00039-39.jpg,217,204,197,7,20,0.965686274509804,0.9078341013824884
2022,ONAGRI,CITRANGE C35,40171,IMG-00008-39.jpg,109,103,102,1,7,0.9902912621359224,0.9357798165137616
2022,ONAGRI,CITRANGE C35,40171,IMG-00037-39.jpg,94,90,87,3,7,0.9666666666666668,0.925531914893617
2022,ONAGRI,CITRANGE C35,40171,IMG-00040-39.jpg,149,146,140,6,9,0.958904109589041,0.9395973154362416
2022,ONAGRI,CITRANGE C35,40172,IMG-00012-39.jpg,89,82,82,0,7,1.0,0.9213483146067416
2022,ONAGRI,CITRANGE C35,40172,IMG-00025-39.jpg,109,102,100,2,9,0.9803921568627452,0.9174311926605504
2022,ONAGRI,CITRANGE C35,40172,IMG-00027-39.jpg,103,91,89,2,14,0.978021978021978,0.8640776699029126
2022,ONAGRI,CITRANGE C35,40173,IMG-00004-39.jpg,133,122,120,2,13,0.9836065573770492,0.9022556390977444
2022,ONAGRI,CITRANGE C35,40173,IMG-00008-39.jpg,57,43,43,0,14,1.0,0.7543859649122807
2022,ONAGRI,CITRANGE C35,40173,IMG-00010-39.jpg,53,55,51,4,2,0.9272727272727272,0.9622641509433962
2022,ONAGRI,CITRANGE C35,40175,IMG-00005-39.jpg,95,89,86,3,9,0.9662921348314608,0.9052631578947368
2022,ONAGRI,CITRANGE C35,40175,IMG-00006-39.jpg,64,66,62,4,2,0.9393939393939394,0.96875
2022,ONAGRI,CITRANGE C35,40176,IMG-00004-39.jpg,79,85,73,12,6,0.8588235294117647,0.9240506329113924
2022,ONAGRI,CITRANGE C35,40176,IMG-00012-39.jpg,105,110,101,9,4,0.9181818181818182,0.961904761904762
2022,ONAGRI,CITRANGE C35,40176,IMG-00014-39.jpg,91,95,87,8,4,0.9157894736842104,0.956043956043956
2022,ONAGRI,CITRUMELO SACCATON,40177,IMG-00012-39.jpg,89,96,87,9,2,0.90625,0.9775280898876404
2022,ONAGRI,CITRUMELO SACCATON,40177,IMG-00015-39.jpg,213,223,210,13,3,0.9417040358744396,0.9859154929577464
2022,ONAGRI,CITRUMELO SACCATON,40177,IMG-00037-39.jpg,95,97,91,6,4,0.9381443298969072,0.9578947368421052
2022,ONAGRI,CITRANGE C35,40178,IMG-00013-39.jpg,76,77,75,2,1,0.974025974025974,0.986842105263158
2022,ONAGRI,CITRANGE C35,40178,IMG-00027-39.jpg,56,58,55,3,1,0.9482758620689656,0.9821428571428572
2022,ONAGRI,CITRANGE C35,40178,IMG-00031-39.jpg,30,34,30,4,0,0.8823529411764706,1.0
2022,ONAGRI,CITRANGE C35,40178,IMG-00032-39.jpg,27,29,27,2,0,0.9310344827586208,1.0
2022,ONAGRI,CITRANGE C35,40178,IMG-00033-39.jpg,34,35,33,2,1,0.9428571428571428,0.9705882352941176
2022,ONAGRI,CITRANGE C35,40179,IMG-00001.jpg,83,84,79,5,4,0.9404761904761904,0.9518072289156626
2022,ONAGRI,CITRANGE C35,40179,IMG-00010-39.jpg,161,163,152,11,9,0.9325153374233128,0.9440993788819876
2022,ONAGRI,CITRANGE C35,40179,IMG-00011-39.jpg,102,105,95,10,7,0.9047619047619048,0.931372549019608
2022,ONAGRI,CITRANGE C35,40179,IMG-00018-39.jpg,9,10,9,1,0,0.9,1.0
2022,ONAGRI,CITRUMELO SACCATON,40182,IMG-00004-39.jpg,35,37,35,2,0,0.945945945945946,1.0
2022,ONAGRI,CITRUMELO SACCATON,40182,IMG-00010-39.jpg,52,53,49,4,3,0.9245283018867924,0.9423076923076924
2022,ONAGRI,CITRUMELO SACCATON,40182,IMG-00015-39.jpg,85,89,78,11,7,0.8764044943820225,0.9176470588235294
2022,ONAGRI,CITRUMELO SACCATON,40183,IMG-00005-39.jpg,68,69,67,2,1,0.9710144927536232,0.9852941176470588
2022,ONAGRI,CITRUMELO SACCATON,40183,IMG-00009-39.jpg,57,62,57,5,0,0.9193548387096774,1.0
2022,ONAGRI,CITRUMELO SACCATON,40183,IMG-00010-39.jpg,48,53,47,6,1,0.8867924528301887,0.9791666666666666
2024,KHOUALKA,CITRUS VOLKAMERIANA,50152,IMG-17274.jpg,170,125,123,2,47,0.984,0.7235294117647059
2024,KHOUALKA,CITRUS VOLKAMERIANA,50152,IMG-17306.jpg,105,90,90,0,15,1.0,0.8571428571428571
2024,KHOUALKA,CITRUS VOLKAMERIANA,50152,IMG-17330.jpg,41,32,32,0,9,1.0,0.7804878048780488
2024,KHOUALKA,CITRUS VOLKAMERIANA,50152,IMG-17335.jpg,44,33,33,0,11,1.0,0.75
2024,KHOUALKA,CITRUS VOLKAMERIANA,50152,IMG-17340.jpg,108,76,74,2,34,0.9736842105263158,0.6851851851851852
2024,KHOUALKA,CITRUS VOLKAMERIANA,50152,IMG-17356.jpg,60,44,42,2,18,0.9545454545454546,0.7
2024,KHOUALKA,CITRUS VOLKAMERIANA,50152,IMG-17384.jpg,53,31,31,0,22,1.0,0.5849056603773585
2024,KHOUALKA,CITRUS VOLKAMERIANA,50154,IMG-17440.jpg,76,63,63,0,13,1.0,0.8289473684210527
2024,KHOUALKA,CITRUS VOLKAMERIANA,50154,IMG-17490.jpg,107,77,77,0,30,1.0,0.719626168224299
2024,KHOUALKA,CITRUS VOLKAMERIANA,50154,IMG-17543.jpg,100,72,72,0,28,1.0,0.72
2024,KHOUALKA,CITRUS VOLKAMERIANA,50154,IMG-17545.jpg,94,71,71,0,23,1.0,0.7553191489361702
2024,KHOUALKA,CITRUS VOLKAMERIANA,50154,IMG-17562.jpg,129,106,106,0,23,1.0,0.8217054263565892
2024,KHOUALKA,CITRUS VOLKAMERIANA,50154,IMG-17576.jpg,121,96,96,0,25,1.0,0.7933884297520661
2024,KHOUALKA,CITRUS VOLKAMERIANA,50154,IMG-17585.jpg,171,127,125,2,46,0.984251968503937,0.7309941520467836
2024,KHOUALKA,CITRUS VOLKAMERIANA,50168,IMG-13980.jpg,174,128,128,0,46,1.0,0.735632183908046
2024,KHOUALKA,CITRUS VOLKAMERIANA,50168,IMG-15749.jpg,147,115,114,1,33,0.991304347826087,0.7755102040816326
2024,KHOUALKA,CITRUS VOLKAMERIANA,50168,IMG-15758.jpg,163,132,131,1,32,0.9924242424242424,0.803680981595092
2024,KHOUALKA,CITRUS VOLKAMERIANA,50168,IMG-15981.jpg,210,158,157,1,53,0.9936708860759492,0.7476190476190476
2024,KHOUALKA,CITRUS VOLKAMERIANA,50168,IMG-15983.jpg,120,91,91,0,29,1.0,0.7583333333333333
2024,KHOUALKA,CITRUS VOLKAMERIANA,50176,IMG-16025.jpg,81,65,65,0,16,1.0,0.8024691358024691
2024,KHOUALKA,CITRUS VOLKAMERIANA,50176,IMG-16051.jpg,85,62,62,0,23,1.0,0.7294117647058823
2024,KHOUALKA,CITRUS VOLKAMERIANA,50176,IMG-16079.jpg,161,122,121,1,40,0.9918032786885246,0.7515527950310559
2024,KHOUALKA,CITRUS VOLKAMERIANA,50176,IMG-16095.jpg,101,71,71,0,30,1.0,0.7029702970297029
2024,KHOUALKA,CITRUS VOLKAMERIANA,50176,IMG-16105.jpg,43,31,31,0,12,1.0,0.7209302325581395
2022,ONAGRI,CITRUMELO SACCATON,50193,IMG-00007-39.jpg,218,240,218,22,0,0.9083333333333332,1.0
2022,ONAGRI,CITRUMELO SACCATON,50193,IMG-00016-39.jpg,64,75,61,14,3,0.8133333333333334,0.953125
2022,ONAGRI,CITRUMELO SACCATON,50193,IMG-00018-39.jpg,115,123,112,11,3,0.9105691056910568,0.9739130434782608
2022,ONAGRI,CITRUMELO SACCATON,50193,IMG-00021-39.jpg,62,63,59,4,3,0.9365079365079364,0.9516129032258064
2022,ONAGRI,CITRUMELO SACCATON,50193,IMG-00023-39.jpg,113,127,112,15,1,0.8818897637795275,0.991150442477876
2022,ONAGRI,CITRUMELO SACCATON,50194,IMG-00032-39.jpg,162,169,153,16,9,0.9053254437869822,0.9444444444444444
2022,ONAGRI,CITRUMELO SACCATON,50194,IMG-00034-39.jpg,105,114,104,10,1,0.912280701754386,0.9904761904761904
2022,ONAGRI,CITRUMELO SACCATON,50194,IMG-00036-39.jpg,161,183,153,30,8,0.8360655737704918,0.9503105590062112
2022,ONAGRI,CITRUMELO SACCATON,50194,IMG-00038-39.jpg,100,116,97,19,3,0.8362068965517241,0.97
2022,ONAGRI,CITRUMELO SACCATON,50194,IMG-00039-39.jpg,65,65,63,2,2,0.9692307692307692,0.9692307692307692
2022,ONAGRI,CITRUMELO SACCATON,50194,IMG-00041-39.jpg,153,158,147,11,6,0.930379746835443,0.9607843137254902
2022,ONAGRI,CITRUMELO SACCATON,50194,IMG-00051-39.jpg,137,143,134,9,3,0.9370629370629372,0.978102189781022
2022,ONAGRI,CITRUMELO SACCATON,50194,IMG-00054-39.jpg,111,111,103,8,8,0.927927927927928,0.927927927927928
2022,ONAGRI,CITRUMELO SACCATON,51091,IMG-00015-39.jpg,85,97,84,13,1,0.865979381443299,0.9882352941176472
2022,ONAGRI,CITRUMELO SACCATON,51091,IMG-00016-39.jpg,170,178,169,9,1,0.949438202247191,0.9941176470588236
2022,ONAGRI,CITRUMELO SACCATON,51091,IMG-00018-39.jpg,185,202,180,22,5,0.8910891089108911,0.972972972972973
2022,ONAGRI,CITRUMELO SACCATON,51091,IMG-00022-39.jpg,135,152,132,20,3,0.868421052631579,0.9777777777777776
2022,ONAGRI,CITRUMELO SACCATON,51091,IMG-00023-39.jpg,140,142,134,8,6,0.943661971830986,0.9571428571428572
2022,ONAGRI,CITRUMELO SACCATON,51091,IMG-00026-39.jpg,149,146,140,6,9,0.958904109589041,0.9395973154362416
2022,ONAGRI,CITRUMELO SACCATON,51091,IMG-00044-39.jpg,168,180,165,15,3,0.9166666666666666,0.9821428571428572
2022,ONAGRI,CITRUMELO SACCATON,51095,IMG-00004-39.jpg,201,218,194,24,7,0.8899082568807339,0.965174129353234
2022,ONAGRI,CITRUMELO SACCATON,51095,IMG-00013-39.jpg,154,151,144,7,10,0.9536423841059604,0.935064935064935
2022,ONAGRI,CITRUMELO SACCATON,51095,IMG-00014-39.jpg,140,141,130,11,10,0.9219858156028368,0.9285714285714286
2022,ONAGRI,CITRUMELO SACCATON,51095,IMG-00015-39.jpg,196,200,192,8,4,0.96,0.979591836734694
2022,ONAGRI,CITRUMELO SACCATON,51095,IMG-00024-39.jpg,234,239,226,13,8,0.9456066945606696,0.9658119658119658
2022,ONAGRI,CITRUMELO SACCATON,51095,IMG-00025-39.jpg,198,208,192,16,6,0.9230769230769232,0.9696969696969696
2022,ONAGRI,CITRUMELO SACCATON,51096,IMG-00009-39.jpg,219,227,212,15,7,0.933920704845815,0.9680365296803652
2022,ONAGRI,CITRUMELO SACCATON,51096,IMG-00011-39.jpg,145,155,142,13,3,0.9161290322580644,0.9793103448275862
2022,ONAGRI,CITRUMELO SACCATON,51096,IMG-00012-39.jpg,114,108,103,5,11,0.9537037037037036,0.9035087719298246
2022,ONAGRI,CITRUMELO SACCATON,51096,IMG-00055-39.jpg,217,218,206,12,11,0.944954128440367,0.9493087557603688
2022,ONAGRI,MC PONSIRUCE TRIFOLIATA,51097,IMG-00025-39.jpg,121,137,115,22,6,0.8394160583941606,0.950413223140496
2022,ONAGRI,MC PONSIRUCE TRIFOLIATA,51097,IMG-00029-39.jpg,106,116,102,14,4,0.8793103448275862,0.9622641509433962
2022,ONAGRI,MC PONSIRUCE TRIFOLIATA,51097,IMG-00044-39.jpg,182,192,175,17,7,0.9114583333333334,0.9615384615384616
2022,ONAGRI,MC PONSIRUCE TRIFOLIATA,51098,IMG-00003-39.jpg,65,74,64,10,1,0.8648648648648649,0.9846153846153848
2022,ONAGRI,MC PONSIRUCE TRIFOLIATA,51098,IMG-00010-39.jpg,184,186,179,7,5,0.9623655913978496,0.9728260869565216
2022,ONAGRI,MC PONSIRUCE TRIFOLIATA,51098,IMG-00015-39.jpg,162,174,162,12,0,0.9310344827586208,1.0
2022,ONAGRI,MC PONSIRUCE TRIFOLIATA,51099,IMG-00012-39.jpg,133,146,130,16,3,0.8904109589041096,0.9774436090225564
2024,ONAGRI,MC PONSIRUCE TRIFOLIATA,51101,IMG-12118.jpg,177,130,130,0,47,1.0,0.7344632768361582
2024,ONAGRI,MC PONSIRUCE TRIFOLIATA,51101,IMG-14223.jpg,153,122,122,0,31,1.0,0.7973856209150327
2024,ONAGRI,MC PONSIRUCE TRIFOLIATA,51101,IMG-14226.jpg,151,123,122,1,29,0.991869918699187,0.8079470198675497
2024,ONAGRI,MC PONSIRUCE TRIFOLIATA,51101,IMG-14255.jpg,189,151,150,1,39,0.9933774834437086,0.7936507936507936
2024,ONAGRI,MC PONSIRUCE TRIFOLIATA,51101,IMG-14281.jpg,150,118,118,0,32,1.0,0.7866666666666666
2022,ONAGRI,CITRUS VOLKAMERIANA,101020,IMG-00001.jpg,6,7,6,1,0,0.8571428571428571,1.0
2022,ONAGRI,CITRUS VOLKAMERIANA,101020,IMG-00004-44.jpg,53,51,49,2,4,0.9607843137254902,0.9245283018867924
2022,ONAGRI,CITRUS VOLKAMERIANA,101030,IMG-00003-44.jpg,29,29,28,1,1,0.9655172413793104,0.9655172413793104
2022,ONAGRI,CITRUS VOLKAMERIANA,101030,IMG-00004-44.jpg,110,102,100,2,10,0.9803921568627452,0.9090909090909092
2022,ONAGRI,CITRUS VOLKAMERIANA,101030,IMG-00005-44.jpg,134,127,122,5,12,0.9606299212598424,0.9104477611940298
2022,ONAGRI,CITRUS VOLKAMERIANA,101030,IMG-00017-44.jpg,79,73,73,0,6,1.0,0.9240506329113924
2022,ONAGRI,CITRUS VOLKAMERIANA,101040,IMG-00005-44.jpg,172,164,162,2,10,0.9878048780487804,0.9418604651162792
2022,ONAGRI,CITRUS VOLKAMERIANA,101040,IMG-00009-44.jpg,131,132,124,8,7,0.9393939393939394,0.9465648854961832
2022,ONAGRI,CITRUS VOLKAMERIANA,101040,IMG-00011-44.jpg,64,63,60,3,4,0.9523809523809524,0.9375
2022,ONAGRI,CITRUS VOLKAMERIANA,101040,IMG-00012-44.jpg,139,128,124,4,15,0.96875,0.8920863309352518
2022,ONAGRI,CITRUS VOLKAMERIANA,101050,IMG-00002-44.jpg,95,91,87,4,8,0.956043956043956,0.9157894736842104
2022,ONAGRI,CITRUS VOLKAMERIANA,101050,IMG-00005-44.jpg,59,56,56,0,3,1.0,0.9491525423728814
2022,ONAGRI,CITRUS VOLKAMERIANA,101050,IMG-00011-44.jpg,46,46,45,1,1,0.9782608695652174,0.9782608695652174
2022,ONAGRI,CITRUS VOLKAMERIANA,101050,IMG-00024-44.jpg,40,42,39,3,1,0.9285714285714286,0.975
2022,ONAGRI,CITRUS VOLKAMERIANA,101080,IMG-00005-44.jpg,42,37,37,0,5,1.0,0.8809523809523809
2022,ONAGRI,CITRUS VOLKAMERIANA,101080,IMG-00006-44.jpg,79,74,72,2,7,0.972972972972973,0.9113924050632912
2022,ONAGRI,CITRUS VOLKAMERIANA,101080,IMG-00023-44.jpg,7,8,7,1,0,0.875,1.0
2022,ONAGRI,CITRUS VOLKAMERIANA,101080,IMG-00024-44.jpg,27,27,26,1,1,0.9629629629629628,0.9629629629629628
2022,ONAGRI,CITRUS VOLKAMERIANA,101090,IMG-00003-44.jpg,66,60,58,2,8,0.9666666666666668,0.8787878787878788
2022,ONAGRI,CITRUS VOLKAMERIANA,101090,IMG-00006-44.jpg,41,37,37,0,4,1.0,0.902439024390244
2022,ONAGRI,CITRUS VOLKAMERIANA,101090,IMG-00019-44.jpg,35,35,34,1,1,0.9714285714285714,0.9714285714285714
2022,ONAGRI,CITRUS VOLKAMERIANA,101090,IMG-00020-44.jpg,42,39,39,0,3,1.0,0.9285714285714286
2022,KHOUALKA,CITRANGE CARRIZO,102130,IMG-00001.jpg,5,4,4,0,1,1.0,0.8
2022,KHOUALKA,CITRANGE CARRIZO,102130,IMG-00004-43.jpg,24,20,19,1,5,0.95,0.7916666666666666
2022,KHOUALKA,CITRANGE CARRIZO,102130,IMG-00019-43.jpg,33,29,28,1,5,0.9655172413793104,0.8484848484848485
2022,KHOUALKA,CITRANGE CARRIZO,102130,IMG-00020-43.jpg,18,23,17,6,1,0.7391304347826086,0.9444444444444444
2022,KHOUALKA,MACROPHYLLA,201180,IMG-00007-43.jpg,38,41,38,3,0,0.926829268292683,1.0
2022,KHOUALKA,MACROPHYLLA,201180,IMG-00011-43.jpg,64,63,61,2,3,0.9682539682539684,0.953125
2022,KHOUALKA,MACROPHYLLA,201180,IMG-00019-43.jpg,64,59,58,1,6,0.9830508474576272,0.90625
2022,KHOUALKA,MACROPHYLLA,201180,IMG-00020-43.jpg,43,39,38,1,5,0.9743589743589745,0.8837209302325582
2022,KHOUALKA,MACROPHYLLA,201190,IMG-00004-43.jpg,101,73,73,0,28,1.0,0.7227722772277227
2022,KHOUALKA,MACROPHYLLA,201190,IMG-00010-43.jpg,90,65,65,0,25,1.0,0.7222222222222222
2022,KHOUALKA,MACROPHYLLA,201190,IMG-00011-43.jpg,134,98,98,0,36,1.0,0.7313432835820896
2022,KHOUALKA,MACROPHYLLA,201190,IMG-00020-43.jpg,95,70,69,1,26,0.9857142857142858,0.7263157894736842
2022,KHOUALKA,CITRUS VOLKAMERIANA,201210,IMG-00011-43.jpg,103,94,94,0,9,1.0,0.912621359223301
2022,KHOUALKA,CITRUS VOLKAMERIANA,201210,IMG-00012-43.jpg,42,37,37,0,5,1.0,0.8809523809523809
2022,KHOUALKA,CITRUS VOLKAMERIANA,201210,IMG-00015-43.jpg,77,66,66,0,11,1.0,0.8571428571428571
2022,KHOUALKA,CITRUS VOLKAMERIANA,201210,IMG-00019-43.jpg,31,29,29,0,2,1.0,0.935483870967742
2022,KHOUALKA,BIGARADIER,201320,IMG-00006-43.jpg,87,81,78,3,9,0.9629629629629628,0.896551724137931
2022,KHOUALKA,BIGARADIER,201320,IMG-00016-43.jpg,97,96,92,4,5,0.9583333333333334,0.9484536082474226
2022,KHOUALKA,BIGARADIER,201320,IMG-00017-43.jpg,49,49,47,2,2,0.9591836734693876,0.9591836734693876
2022,KHOUALKA,BIGARADIER,201320,IMG-00020-43.jpg,88,85,82,3,6,0.9647058823529412,0.9318181818181818
2022,ONAGRI,BIGARADIER,201390,IMG-00008-44.jpg,62,54,52,2,10,0.9629629629629628,0.8387096774193549
2022,ONAGRI,BIGARADIER,201390,IMG-00011-44.jpg,90,76,72,4,18,0.9473684210526316,0.8
2022,ONAGRI,BIGARADIER,201390,IMG-00013-44.jpg,77,43,41,2,36,0.9534883720930232,0.5324675324675324
2022,ONAGRI,BIGARADIER,201390,IMG-00016-44.jpg,69,48,46,2,23,0.9583333333333334,0.6666666666666666
2022,KHOUALKA,CITRUS VOLKAMERIANA,202050,IMG-00006-43.jpg,89,82,81,1,8,0.9878048780487804,0.9101123595505618
2022,KHOUALKA,CITRUS VOLKAMERIANA,202050,IMG-00010-43.jpg,94,85,85,0,9,1.0,0.9042553191489362
2022,KHOUALKA,CITRUS VOLKAMERIANA,202050,IMG-00011-43.jpg,151,134,133,1,18,0.9925373134328358,0.8807947019867549
2022,KHOUALKA,CITRUS VOLKAMERIANA,202050,IMG-00020-43.jpg,129,115,114,1,15,0.991304347826087,0.8837209302325582
2022,KHOUALKA,CITRUS VOLKAMERIANA,202070,IMG-00006-43.jpg,68,60,60,0,8,1.0,0.8823529411764706
2022,KHOUALKA,CITRUS VOLKAMERIANA,202070,IMG-00009-43.jpg,120,108,108,0,12,1.0,0.9
2022,KHOUALKA,CITRUS VOLKAMERIANA,202070,IMG-00013-43.jpg,95,78,77,1,18,0.9871794871794872,0.8105263157894737
2022,KHOUALKA,CITRUS VOLKAMERIANA,202070,IMG-00019-43.jpg,57,52,50,2,7,0.9615384615384616,0.8771929824561403
2022,KHOUALKA,CITRUS VOLKAMERIANA,202080,IMG-00005-43.jpg,65,58,58,0,7,1.0,0.8923076923076924
2022,KHOUALKA,CITRUS VOLKAMERIANA,202080,IMG-00008-43.jpg,31,28,28,0,3,1.0,0.9032258064516128
2022,KHOUALKA,CITRUS VOLKAMERIANA,202080,IMG-00015-43.jpg,220,187,186,1,34,0.9946524064171124,0.8454545454545455
2022,KHOUALKA,CITRUS VOLKAMERIANA,202080,IMG-00016-43.jpg,131,116,114,2,17,0.9827586206896552,0.8702290076335878
2022,KHOUALKA,CITRANGE CARRIZO,301380,IMG-00007-43.jpg,30,33,28,5,2,0.8484848484848485,0.9333333333333332
2022,KHOUALKA,CITRANGE CARRIZO,301380,IMG-00011-43.jpg,53,52,51,1,2,0.9807692307692308,0.9622641509433962
2022,KHOUALKA,CITRANGE CARRIZO,301380,IMG-00014-43.jpg,7,7,6,1,1,0.8571428571428571,0.8571428571428571
2022,KHOUALKA,CITRANGE CARRIZO,301380,IMG-00020-43.jpg,91,94,88,6,3,0.9361702127659576,0.967032967032967
2022,ONAGRI,CITRUS VOLKAMERIANA,301470,IMG-00003-44.jpg,148,137,137,0,11,1.0,0.9256756756756755
2022,ONAGRI,CITRUS VOLKAMERIANA,301470,IMG-00004-44.jpg,163,131,128,3,35,0.9770992366412212,0.7852760736196319
2022,ONAGRI,CITRUS VOLKAMERIANA,301470,IMG-00005-44.jpg,160,124,124,0,36,1.0,0.775
2022,ONAGRI,CITRUS VOLKAMERIANA,301480,IMG-00001.jpg,92,64,64,0,28,1.0,0.6956521739130435
2022,ONAGRI,CITRUS VOLKAMERIANA,301480,IMG-00003-43.jpg,26,16,16,0,10,1.0,0.6153846153846154
2022,ONAGRI,CITRUS VOLKAMERIANA,301480,IMG-00012-43.jpg,50,39,37,2,13,0.9487179487179488,0.74
2022,ONAGRI,CITRUS VOLKAMERIANA,301480,IMG-00014-43.jpg,77,62,62,0,15,1.0,0.8051948051948052
2022,ONAGRI,CITRUS VOLKAMERIANA,301490,IMG-00005-44.jpg,108,81,80,1,28,0.9876543209876544,0.7407407407407407
2022,ONAGRI,CITRUS VOLKAMERIANA,301490,IMG-00009-44.jpg,185,150,147,3,38,0.98,0.7945945945945946
2022,ONAGRI,CITRUS VOLKAMERIANA,301490,IMG-00012-44.jpg,162,132,130,2,32,0.9848484848484848,0.8024691358024691
2022,ONAGRI,CITRUS VOLKAMERIANA,301490,IMG-00015-44.jpg,109,94,93,1,16,0.9893617021276596,0.8532110091743119
2022,ONAGRI,CITRUS VOLKAMERIANA,301510,IMG-00001.jpg,252,187,185,2,67,0.9893048128342246,0.7341269841269841
2022,ONAGRI,CITRUS VOLKAMERIANA,301510,IMG-00006-44.jpg,137,118,115,3,22,0.9745762711864406,0.8394160583941606
2022,ONAGRI,CITRUS VOLKAMERIANA,301510,IMG-00007-44.jpg,115,96,92,4,23,0.9583333333333334,0.8
2022,ONAGRI,CITRUS VOLKAMERIANA,301510,IMG-00008-44.jpg,150,108,104,4,46,0.9629629629629628,0.6933333333333334
2022,ONAGRI,BIGARADIER,301550,IMG-00008-44.jpg,144,116,114,2,30,0.9827586206896552,0.7916666666666666
2022,ONAGRI,BIGARADIER,301550,IMG-00011-44.jpg,40,32,31,1,9,0.96875,0.775
2022,ONAGRI,BIGARADIER,301550,IMG-00013-44.jpg,76,53,53,0,23,1.0,0.6973684210526315
2022,ONAGRI,BIGARADIER,301550,IMG-00014-44.jpg,80,66,64,2,16,0.9696969696969696,0.8
2022,ONAGRI,CITRUS VOLKAMERIANA,301570,IMG-00004-44.jpg,158,138,135,3,23,0.9782608695652174,0.8544303797468354
2022,ONAGRI,CITRUS VOLKAMERIANA,301570,IMG-00007-44.jpg,152,128,126,2,26,0.984375,0.8289473684210527
2022,ONAGRI,CITRUS VOLKAMERIANA,301570,IMG-00008-44.jpg,103,83,80,3,23,0.963855421686747,0.7766990291262136
2022,ONAGRI,CITRUS VOLKAMERIANA,301570,IMG-00017-44.jpg,218,185,183,2,35,0.9891891891891892,0.8394495412844036
2022,KHOUALKA,CITRUS VOLKAMERIANA,302340,IMG-00004-43.jpg,106,78,77,1,29,0.9871794871794872,0.7264150943396226
2022,KHOUALKA,CITRUS VOLKAMERIANA,302340,IMG-00005-43.jpg,105,76,76,0,29,1.0,0.7238095238095238
2022,KHOUALKA,CITRUS VOLKAMERIANA,302340,IMG-00011-43.jpg,75,56,54,2,21,0.9642857142857144,0.72
2022,KHOUALKA,CITRUS VOLKAMERIANA,302340,IMG-00015-43.jpg,92,67,64,3,28,0.9552238805970148,0.6956521739130435
2022,KHOUALKA,CITRUS VOLKAMERIANA,302350,IMG-00008-43.jpg,33,35,33,2,0,0.9428571428571428,1.0
2022,KHOUALKA,CITRUS VOLKAMERIANA,302350,IMG-00013-43.jpg,80,83,78,5,2,0.9397590361445785,0.975
2022,KHOUALKA,CITRUS VOLKAMERIANA,302350,IMG-00014-43.jpg,76,75,70,5,6,0.9333333333333332,0.9210526315789472
2022,KHOUALKA,CITRUS VOLKAMERIANA,302350,IMG-00018-43.jpg,44,42,41,1,3,0.9761904761904762,0.9318181818181818
2022,KHOUALKA,CITRUS VOLKAMERIANA,302360,IMG-00005-43.jpg,97,84,83,1,14,0.988095238095238,0.8556701030927835
2022,KHOUALKA,CITRUS VOLKAMERIANA,302360,IMG-00006-43.jpg,118,94,93,1,25,0.9893617021276596,0.788135593220339
2022,KHOUALKA,CITRUS VOLKAMERIANA,302360,IMG-00016-43.jpg,67,58,58,0,9,1.0,0.8656716417910447
2022,KHOUALKA,CITRUS VOLKAMERIANA,302360,IMG-00021-43.jpg,65,62,58,4,7,0.935483870967742,0.8923076923076924
2022,KHOUALKA,CITRUS VOLKAMERIANA,302510,IMG-00001.jpg,73,46,46,0,27,1.0,0.6301369863013698
2022,KHOUALKA,CITRUS VOLKAMERIANA,302510,IMG-00002-43.jpg,44,33,31,2,13,0.9393939393939394,0.7045454545454546
2022,KHOUALKA,CITRUS VOLKAMERIANA,302510,IMG-00003-43.jpg,78,64,62,2,16,0.96875,0.7948717948717948
2022,KHOUALKA,CITRUS VOLKAMERIANA,302510,IMG-00015-43.jpg,49,30,29,1,20,0.9666666666666668,0.5918367346938775
2022,KHOUALKA,BIGARADIER,401410,IMG-00093-43.jpg,35,20,20,0,15,1.0,0.5714285714285714
2022,KHOUALKA,BIGARADIER,401410,IMG-00099-43.jpg,6,3,3,0,3,1.0,0.5
2022,KHOUALKA,BIGARADIER,401410,IMG-00102-43.jpg,78,55,54,1,24,0.9818181818181818,0.6923076923076923
2022,KHOUALKA,BIGARADIER,401410,IMG-00104-43.jpg,81,60,60,0,21,1.0,0.7407407407407407
2022,ONAGRI,CITRANGE C35,401660,IMG-00001.jpg,56,51,51,0,5,1.0,0.9107142857142856
2022,ONAGRI,CITRANGE C35,401660,IMG-00008-44.jpg,42,32,32,0,10,1.0,0.7619047619047619
2022,ONAGRI,CITRANGE C35,401660,IMG-00010-44.jpg,29,21,21,0,8,1.0,0.7241379310344828
2022,ONAGRI,CITRANGE C35,401660,IMG-00016-44.jpg,64,53,53,0,11,1.0,0.828125
2022,ONAGRI,CITRANGE C35,401710,IMG-00003-44.jpg,51,37,37,0,14,1.0,0.7254901960784313
2022,ONAGRI,CITRANGE C35,401710,IMG-00012-44.jpg,19,18,18,0,1,1.0,0.9473684210526316
2022,ONAGRI,CITRANGE C35,401710,IMG-00013-44.jpg,33,27,27,0,6,1.0,0.8181818181818182
2022,ONAGRI,CITRANGE C35,401710,IMG-00019-44.jpg,76,70,70,0,6,1.0,0.9210526315789472
2022,ONAGRI,CITRANGE C35,401720,IMG-00007-44.jpg,93,90,88,2,5,0.9777777777777776,0.946236559139785
2022,ONAGRI,CITRANGE C35,401720,IMG-00008-44.jpg,38,31,30,1,8,0.967741935483871,0.7894736842105263
2022,ONAGRI,CITRANGE C35,401720,IMG-00010-44.jpg,50,33,33,0,17,1.0,0.66
2022,ONAGRI,CITRANGE C35,401720,IMG-00017-44.jpg,68,51,51,0,17,1.0,0.75
2022,ONAGRI,CITRANGE C35,401730,IMG-00001.jpg,19,17,17,0,2,1.0,0.8947368421052632
2022,ONAGRI,CITRANGE C35,401730,IMG-00010-44.jpg,50,46,45,1,5,0.9782608695652174,0.9
2022,ONAGRI,CITRANGE C35,401730,IMG-00013-44.jpg,75,63,63,0,12,1.0,0.84
2022,ONAGRI,CITRANGE C35,401730,IMG-00016-44.jpg,36,28,28,0,8,1.0,0.7777777777777778
2022,ONAGRI,CITRANGE C35,401750,IMG-00005-44.jpg,88,54,53,1,35,0.9814814814814816,0.6022727272727273
2022,ONAGRI,CITRANGE C35,401750,IMG-00009-44.jpg,127,97,96,1,31,0.9896907216494846,0.7559055118110236
2022,ONAGRI,CITRANGE C35,401750,IMG-00016-44.jpg,107,80,79,1,28,0.9875,0.7383177570093458
2022,ONAGRI,CITRANGE C35,401750,IMG-00024-44.jpg,50,36,35,1,15,0.9722222222222222,0.7
2022,ONAGRI,CITRUMELO SACCATON,401770,IMG-00003-44.jpg,24,20,20,0,4,1.0,0.8333333333333334
2022,ONAGRI,CITRUMELO SACCATON,401770,IMG-00008-44.jpg,72,64,64,0,8,1.0,0.8888888888888888
2022,ONAGRI,CITRUMELO SACCATON,401770,IMG-00009-44.jpg,14,11,10,1,4,0.9090909090909092,0.7142857142857143
2022,ONAGRI,CITRUMELO SACCATON,401770,IMG-00017-44.jpg,20,15,15,0,5,1.0,0.75
2022,KHOUALKA,BIGARADIER,402440,IMG-00005-43.jpg,17,10,9,1,8,0.9,0.5294117647058824
2022,KHOUALKA,BIGARADIER,402440,IMG-00012-43.jpg,46,31,30,1,16,0.967741935483871,0.6521739130434783
2022,KHOUALKA,BIGARADIER,402440,IMG-00014-43.jpg,11,6,6,0,5,1.0,0.5454545454545454
2022,KHOUALKA,BIGARADIER,402440,IMG-00015-43.jpg,22,9,9,0,13,1.0,0.4090909090909091
2022,KHOUALKA,BIGARADIER,402590,IMG-00007-43.jpg,104,68,67,1,37,0.9852941176470588,0.6442307692307693
2022,KHOUALKA,BIGARADIER,402590,IMG-00012-43.jpg,45,33,33,0,12,1.0,0.7333333333333333
2022,KHOUALKA,BIGARADIER,402590,IMG-00015-43.jpg,58,45,45,0,13,1.0,0.7758620689655172
2022,KHOUALKA,BIGARADIER,402590,IMG-00019-43.jpg,64,57,56,1,8,0.9824561403508772,0.875
2022,KHOUALKA,CITRUS VOLKAMERIANA,501520,IMG-00004-43.jpg,39,33,30,3,9,0.9090909090909092,0.7692307692307693
2022,KHOUALKA,CITRUS VOLKAMERIANA,501520,IMG-00007-43.jpg,43,32,32,0,11,1.0,0.7441860465116279
2022,KHOUALKA,CITRUS VOLKAMERIANA,501520,IMG-00015-43.jpg,18,9,9,0,9,1.0,0.5
2022,KHOUALKA,CITRUS VOLKAMERIANA,501520,IMG-00020-43.jpg,48,41,40,1,8,0.975609756097561,0.8333333333333334
2022,KHOUALKA,CITRUS VOLKAMERIANA,501540,IMG-00006-43.jpg,38,32,32,0,6,1.0,0.8421052631578947
2022,KHOUALKA,CITRUS VOLKAMERIANA,501540,IMG-00012-43.jpg,102,90,90,0,12,1.0,0.8823529411764706
2022,KHOUALKA,CITRUS VOLKAMERIANA,501540,IMG-00017-43.jpg,138,106,106,0,32,1.0,0.7681159420289855
2022,KHOUALKA,CITRUS VOLKAMERIANA,501540,IMG-00018-43.jpg,51,40,39,1,12,0.975,0.7647058823529411
2022,KHOUALKA,CITRUS VOLKAMERIANA,501660,IMG-00006-43.jpg,60,51,49,2,11,0.9607843137254902,0.8166666666666667
2022,KHOUALKA,CITRUS VOLKAMERIANA,501660,IMG-00016-43.jpg,63,48,47,1,16,0.9791666666666666,0.746031746031746
2022,KHOUALKA,CITRUS VOLKAMERIANA,501660,IMG-00018-43.jpg,112,78,76,2,36,0.9743589743589745,0.6785714285714286
2022,KHOUALKA,CITRUS VOLKAMERIANA,501660,IMG-00021-43.jpg,90,90,84,6,6,0.9333333333333332,0.9333333333333332
2022,KHOUALKA,CITRUS VOLKAMERIANA,501680,IMG-00005-43.jpg,179,136,136,0,43,1.0,0.7597765363128491
2022,KHOUALKA,CITRUS VOLKAMERIANA,501680,IMG-00011-43.jpg,101,70,70,0,31,1.0,0.693069306930693
2022,KHOUALKA,CITRUS VOLKAMERIANA,501680,IMG-00012-43.jpg,76,50,48,2,28,0.96,0.631578947368421
2022,KHOUALKA,CITRUS VOLKAMERIANA,501680,IMG-00016-43.jpg,113,88,86,2,27,0.9772727272727272,0.7610619469026548
2022,KHOUALKA,CITRUS VOLKAMERIANA,501690,IMG-00032-43.jpg,34,23,22,1,12,0.9565217391304348,0.6470588235294118
2022,KHOUALKA,CITRUS VOLKAMERIANA,501690,IMG-00039-43.jpg,186,129,127,2,59,0.9844961240310076,0.6827956989247311
2022,KHOUALKA,CITRUS VOLKAMERIANA,501690,IMG-00047-43.jpg,103,69,69,0,34,1.0,0.6699029126213593
2022,KHOUALKA,CITRUS VOLKAMERIANA,501690,IMG-00049-43.jpg,166,135,132,3,34,0.9777777777777776,0.7951807228915663
2022,KHOUALKA,CITRUS VOLKAMERIANA,501760,IMG-00001.jpg,94,47,47,0,47,1.0,0.5
2022,KHOUALKA,CITRUS VOLKAMERIANA,501760,IMG-00034-43.jpg,45,21,21,0,24,1.0,0.4666666666666667
2022,KHOUALKA,CITRUS VOLKAMERIANA,501760,IMG-00036-43.jpg,40,20,20,0,20,1.0,0.5
2022,KHOUALKA,CITRUS VOLKAMERIANA,501760,IMG-00051-43.jpg,92,54,54,0,38,1.0,0.5869565217391305
2022,ONAGRI,CITRUMELO SACCATON,510910,IMG-00004-44.jpg,73,62,61,1,12,0.9838709677419356,0.8356164383561644
2022,ONAGRI,CITRUMELO SACCATON,510910,IMG-00008-44.jpg,152,104,103,1,49,0.9903846153846154,0.6776315789473685
2022,ONAGRI,CITRUMELO SACCATON,510910,IMG-00010-44.jpg,107,85,81,4,26,0.9529411764705882,0.7570093457943925
2022,ONAGRI,CITRUMELO SACCATON,510910,IMG-00011-44.jpg,92,70,70,0,22,1.0,0.7608695652173914
2022,ONAGRI,CITRUMELO SACCATON,510950,IMG-00006-44.jpg,70,55,55,0,15,1.0,0.7857142857142857
2022,ONAGRI,CITRUMELO SACCATON,510950,IMG-00008-44.jpg,75,61,60,1,15,0.9836065573770492,0.8
2022,ONAGRI,CITRUMELO SACCATON,510950,IMG-00009-44.jpg,85,64,64,0,21,1.0,0.7529411764705882
2022,ONAGRI,CITRUMELO SACCATON,510950,IMG-00011-44.jpg,135,108,107,1,28,0.9907407407407408,0.7925925925925926
2022,ONAGRI,MC PONSIRUCE TRIFOLIATA,510980,IMG-00014-44.jpg,67,50,50,0,17,1.0,0.746268656716418
2022,ONAGRI,MC PONSIRUCE TRIFOLIATA,510980,IMG-00015-44.jpg,51,44,43,1,8,0.9772727272727272,0.8431372549019608
2022,ONAGRI,MC PONSIRUCE TRIFOLIATA,510980,IMG-00016-44.jpg,99,78,78,0,21,1.0,0.7878787878787878
2022,ONAGRI,MC PONSIRUCE TRIFOLIATA,510980,IMG-00019-44.jpg,102,78,78,0,24,1.0,0.7647058823529411
2022,ONAGRI,MC PONSIRUCE TRIFOLIATA,510990,IMG-00006-44.jpg,135,110,109,1,26,0.990909090909091,0.8074074074074075
2022,ONAGRI,MC PONSIRUCE TRIFOLIATA,510990,IMG-00008-44.jpg,110,97,95,2,15,0.979381443298969,0.8636363636363636
2022,ONAGRI,MC PONSIRUCE TRIFOLIATA,510990,IMG-00009-44.jpg,85,72,71,1,14,0.9861111111111112,0.8352941176470589
2022,ONAGRI,MC PONSIRUCE TRIFOLIATA,510990,IMG-00024-44.jpg,65,56,56,0,9,1.0,0.8615384615384616
2022,ONAGRI,MC PONSIRUCE TRIFOLIATA,511030,IMG-00007-44.jpg,100,82,80,2,20,0.975609756097561,0.8
2022,ONAGRI,MC PONSIRUCE TRIFOLIATA,511030,IMG-00016-44.jpg,63,53,53,0,10,1.0,0.8412698412698413
2022,ONAGRI,MC PONSIRUCE TRIFOLIATA,511030,IMG-00022-44.jpg,98,85,83,2,15,0.976470588235294,0.8469387755102041
2022,ONAGRI,MC PONSIRUCE TRIFOLIATA,511030,IMG-00027-44.jpg,82,71,71,0,11,1.0,0.8658536585365854
2022,ONAGRI,MS PONSIRUCE TRIFOLIATA,511040,IMG-00004-44.jpg,77,63,63,0,14,1.0,0.8181818181818182
2022,ONAGRI,MS PONSIRUCE TRIFOLIATA,511040,IMG-00014-44.jpg,48,33,33,0,15,1.0,0.6875
2022,ONAGRI,MS PONSIRUCE TRIFOLIATA,511040,IMG-00016-44.jpg,71,55,55,0,16,1.0,0.7746478873239436
2022,ONAGRI,MS PONSIRUCE TRIFOLIATA,511040,IMG-00025-44.jpg,56,41,40,1,16,0.975609756097561,0.7142857142857143
2022,ONAGRI,FUZHU,511050,IMG-00004-44.jpg,109,78,78,0,31,1.0,0.7155963302752294
2022,ONAGRI,FUZHU,511050,IMG-00006-44.jpg,142,102,102,0,40,1.0,0.7183098591549296
2022,ONAGRI,FUZHU,511050,IMG-00011-44.jpg,172,146,142,4,30,0.9726027397260274,0.8255813953488372
2022,ONAGRI,FUZHU,511050,IMG-00022-44.jpg,194,155,155,0,39,1.0,0.7989690721649485
2022,ONAGRI,MS PONSIRUCE TRIFOLIATA,511060,IMG-00007-44.jpg,115,94,93,1,22,0.9893617021276596,0.808695652173913
2022,ONAGRI,MS PONSIRUCE TRIFOLIATA,511060,IMG-00016-44.jpg,102,81,78,3,24,0.9629629629629628,0.7647058823529411
2022,ONAGRI,MS PONSIRUCE TRIFOLIATA,511060,IMG-00017-44.jpg,59,40,40,0,19,1.0,0.6779661016949152
2022,ONAGRI,MS PONSIRUCE TRIFOLIATA,511060,IMG-00019-44.jpg,108,84,82,2,26,0.9761904761904762,0.7592592592592593
2022,ONAGRI,FUZHU,511070,IMG-00006-44.jpg,82,73,73,0,9,1.0,0.8902439024390244
2022,ONAGRI,FUZHU,511070,IMG-00016-44.jpg,96,76,75,1,21,0.986842105263158,0.78125
2022,ONAGRI,FUZHU,511070,IMG-00018-44.jpg,93,72,71,1,22,0.9861111111111112,0.7634408602150538
2022,ONAGRI,FUZHU,511070,IMG-00019-44.jpg,142,118,118,0,24,1.0,0.8309859154929577
