compagnie,Domaine,Porte-greffe,parcelle,Filename,True_count,detect_count,TP,FP,FN,Precision,Recall
2022,SAOUDA,BIGARADIER,10010,IMG-00011-45.jpg,28,29,28,1,0,0.9655172413793104,1.0
2022,SAOUDA,BIGARADIER,10010,IMG-00012-45.jpg,27,28,27,1,0,0.9642857142857144,1.0
2022,SAOUDA,BIGARADIER,10010,IMG-00014-45.jpg,50,51,49,2,1,0.9607843137254902,0.98
2022,SAOUDA,BIGARADIER,10010,IMG-00018-45.jpg,30,29,29,0,1,1.0,0.9666666666666668
2022,SAOUDA,BIGARADIER,10010,IMG-00020-45.jpg,31,32,29,3,2,0.90625,0.935483870967742
2024,SAOUDA,BIGARADIER,10010,IMG-23410.jpg,85,69,67,2,18,0.9710144927536232,0.788235294117647
2024,SAOUDA,BIGARADIER,10010,IMG-23417.jpg,86,66,66,0,20,1.0,0.7674418604651163
2024,SAOUDA,BIGARADIER,10010,IMG-23430.jpg,74,59,59,0,15,1.0,0.7972972972972973
2024,SAOUDA,BIGARADIER,10010,IMG-23647.jpg,95,79,79,0,16,1.0,0.8315789473684211
2024,SAOUDA,BIGARADIER,10010,IMG-23672.jpg,47,32,32,0,15,1.0,0.6808510638297872
2024,SAOUDA,BIGARADIER,10010,IMG-23707.jpg,30,27,27,0,3,1.0,0.9
2024,SAOUDA,BIGARADIER,10010,IMG-23709.jpg,31,24,24,0,7,1.0,0.7741935483870968
2024,SAOUDA,BIGARADIER,10010,IMG-23711.jpg,79,65,61,4,18,0.9384615384615383,0.7721518987341772
2022,SAOUDA,MACROPHYLLA,10030,IMG-00158-45.jpg,101,104,93,11,8,0.8942307692307693,0.9207920792079208
2022,SAOUDA,MACROPHYLLA,10030,IMG-00159-45.jpg,155,155,145,10,10,0.935483870967742,0.935483870967742
2022,SAOUDA,MACROPHYLLA,10030,IMG-00162-45.jpg,119,120,116,4,3,0.9666666666666668,0.9747899159663864
2022,SAOUDA,MACROPHYLLA,10030,IMG-00169-45.jpg,72,74,70,4,2,0.945945945945946,0.9722222222222222
2022,SAOUDA,MACROPHYLLA,10031,IMG-00002-45.jpg,46,45,41,4,5,0.9111111111111112,0.8913043478260869
2022,SAOUDA,MACROPHYLLA,10031,IMG-00084-45.jpg,41,43,38,5,3,0.8837209302325582,0.926829268292683
2022,SAOUDA,MACROPHYLLA,10031,IMG-00450-45.jpg,27,29,26,3,1,0.896551724137931,0.9629629629629628
2022,SAOUDA,MACROPHYLLA,10031,IMG-00451-45.jpg,34,33,30,3,4,0.9090909090909092,0.8823529411764706
2022,SAOUDA,MACROPHYLLA,10031,IMG-00464-45.jpg,33,31,30,1,3,0.967741935483871,0.9090909090909092
2022,ONAGRI,CITRUS VOLKAMERIANA,10101,IMG-00003-39.jpg,120,113,110,3,10,0.9734513274336284,0.9166666666666666
2022,ONAGRI,CITRUS VOLKAMERIANA,10101,IMG-00010-39.jpg,85,78,71,7,14,0.9102564102564102,0.8352941176470589
2024,ONAGRI,CITRUS VOLKAMERIANA,10101,IMG-10523.jpg,288,224,223,1,65,0.9955357142857144,0.7743055555555556
2024,ONAGRI,CITRUS VOLKAMERIANA,10101,IMG-10545.jpg,98,74,74,0,24,1.0,0.7551020408163265
2024,ONAGRI,CITRUS VOLKAMERIANA,10101,IMG-10558.jpg,143,97,96,1,47,0.9896907216494846,0.6713286713286714
2022,ONAGRI,CITRUS VOLKAMERIANA,10102,IMG-00003-39.jpg,48,40,38,2,10,0.95,0.7916666666666666
2024,ONAGRI,CITRUS VOLKAMERIANA,10102,IMG-10637.jpg,140,116,115,1,25,0.9913793103448276,0.8214285714285714
2024,ONAGRI,CITRUS VOLKAMERIANA,10102,IMG-10658.jpg,163,131,128,3,35,0.9770992366412212,0.7852760736196319
2022,ONAGRI,CITRUS VOLKAMERIANA,10103,IMG-00003-39.jpg,215,192,186,6,29,0.96875,0.8651162790697674
2022,ONAGRI,CITRUS VOLKAMERIANA,10103,IMG-00008-39.jpg,195,187,175,12,20,0.9358288770053476,0.8974358974358975
2024,ONAGRI,CITRUS VOLKAMERIANA,10103,IMG-10614.jpg,134,111,110,1,24,0.990990990990991,0.8208955223880597
2024,ONAGRI,CITRUS VOLKAMERIANA,10103,IMG-10630.jpg,213,173,172,1,41,0.9942196531791908,0.8075117370892019
2024,ONAGRI,CITRUS VOLKAMERIANA,10103,IMG-10631.jpg,134,94,94,0,40,1.0,0.7014925373134329
2022,ONAGRI,CITRUS VOLKAMERIANA,10104,IMG-00004-39.jpg,65,61,58,3,7,0.9508196721311476,0.8923076923076924
2022,ONAGRI,CITRUS VOLKAMERIANA,10104,IMG-00008-39.jpg,69,65,58,7,11,0.8923076923076924,0.8405797101449275
2024,ONAGRI,CITRUS VOLKAMERIANA,10104,IMG-11267.jpg,22,11,11,0,11,1.0,0.5
2024,ONAGRI,CITRUS VOLKAMERIANA,10104,IMG-11327.jpg,128,93,92,1,36,0.989247311827957,0.71875
2024,ONAGRI,CITRUS VOLKAMERIANA,10104,IMG-11347.jpg,118,87,87,0,31,1.0,0.7372881355932204
2024,ONAGRI,CITRUS VOLKAMERIANA,10104,IMG-11366.jpg,351,250,246,4,105,0.984,0.7008547008547008
2024,ONAGRI,CITRUS VOLKAMERIANA,10104,IMG-11386.jpg,99,71,71,0,28,1.0,0.7171717171717171
2022,ONAGRI,CITRUS VOLKAMERIANA,10105,IMG-00004-39.jpg,17,20,15,5,2,0.75,0.8823529411764706
2022,ONAGRI,CITRUS VOLKAMERIANA,10105,IMG-00005-39.jpg,68,70,63,7,5,0.9,0.9264705882352942
2022,ONAGRI,CITRUS VOLKAMERIANA,10108,IMG-00003-39.jpg,61,53,51,2,10,0.9622641509433962,0.8360655737704918
2022,ONAGRI,CITRUS VOLKAMERIANA,10108,IMG-00007-39.jpg,69,57,55,2,14,0.9649122807017544,0.7971014492753623
2022,ONAGRI,CITRUS VOLKAMERIANA,10109,IMG-00003-39.jpg,4,4,4,0,0,1.0,1.0
2022,ONAGRI,CITRUS VOLKAMERIANA,10109,IMG-00008-39.jpg,105,106,99,7,6,0.9339622641509434,0.9428571428571428
2022,KHOUALKA,CITRANGE CARRIZO,10213,IMG-00001.jpg,77,75,75,0,2,1.0,0.974025974025974
2022,KHOUALKA,CITRANGE CARRIZO,10213,IMG-00005-40.jpg,73,72,70,2,3,0.9722222222222222,0.958904109589041
2022,KHOUALKA,CITRANGE CARRIZO,10213,IMG-00009-40.jpg,14,14,14,0,0,1.0,1.0
2022,KHOUALKA,CITRANGE CARRIZO,10213,IMG-00014-40.jpg,21,21,19,2,2,0.9047619047619048,0.9047619047619048
2022,KHOUALKA,CITRANGE CARRIZO,10213,IMG-00028-40.jpg,47,50,47,3,0,0.94,1.0
2022,KHOUALKA,CITRANGE CARRIZO,10213,IMG-00034-40.jpg,48,48,48,0,0,1.0,1.0
2022,KHOUALKA,CITRANGE CARRIZO,10213,IMG-00035-40.jpg,37,37,36,1,1,0.972972972972973,0.972972972972973
2022,KHOUALKA,CITRANGE CARRIZO,10213,IMG-00036-40.jpg,47,49,45,4,2,0.9183673469387756,0.9574468085106383
2022,KHOUALKA,CITRANGE CARRIZO,10213,IMG-00042-40.jpg,22,23,22,1,0,0.9565217391304348,1.0
2022,KHOUALKA,CITRANGE CARRIZO,10213,IMG-00047-40.jpg,70,69,69,0,1,1.0,0.9857142857142858
2022,KHOUALKA,CITRANGE CARRIZO,10213,IMG-00054-40.jpg,33,36,33,3,0,0.9166666666666666,1.0
2022,KHOUALKA,CITRANGE CARRIZO,10213,IMG-00055-40.jpg,93,92,90,2,3,0.9782608695652174,0.967741935483871
2022,KHOUALKA,CITRANGE CARRIZO,10213,IMG-00061-40.jpg,113,116,113,3,0,0.9741379310344828,1.0
2022,KHOUALKA,CITRANGE CARRIZO,10213,IMG-00066-40.jpg,48,50,47,3,1,0.94,0.9791666666666666
2024,KHOUALKA,CITRANGE CARRIZO,10213,IMG-12628.jpg,119,98,97,1,22,0.9897959183673468,0.8151260504201681
2024,KHOUALKA,CITRANGE CARRIZO,10213,IMG-12774.jpg,118,95,94,1,24,0.9894736842105264,0.7966101694915254
2024,KHOUALKA,CITRANGE CARRIZO,10213,IMG-12780.jpg,44,40,40,0,4,1.0,0.9090909090909092
2024,KHOUALKA,CITRANGE CARRIZO,10213,IMG-12791.jpg,166,117,117,0,49,1.0,0.7048192771084337
2024,KHOUALKA,CITRANGE CARRIZO,10213,IMG-12834.jpg,57,45,44,1,13,0.9777777777777776,0.7719298245614035
2024,KHOUALKA,CITRANGE CARRIZO,10213,IMG-12945.jpg,130,105,105,0,25,1.0,0.8076923076923077
2022,OUARGHA,MACROPHYLLA,11010,IMG-00001.jpg,40,40,40,0,0,1.0,1.0
2022,OUARGHA,MACROPHYLLA,11010,IMG-00015-41.jpg,24,22,22,0,2,1.0,0.9166666666666666
2022,OUARGHA,MACROPHYLLA,11010,IMG-00019-41.jpg,20,22,18,4,2,0.8181818181818182,0.9
2022,OUARGHA,MACROPHYLLA,11010,IMG-00024-41.jpg,21,21,20,1,1,0.9523809523809524,0.9523809523809524
2022,OUARGHA,MACROPHYLLA,11020,IMG-00017-41.jpg,51,55,51,4,0,0.9272727272727272,1.0
2022,OUARGHA,MACROPHYLLA,11020,IMG-00018-41.jpg,13,13,12,1,1,0.9230769230769232,0.9230769230769232
2022,OUARGHA,CITRANGE CARRIZO,13010,IMG-00067-41.jpg,55,54,53,1,2,0.9814814814814816,0.9636363636363636
2022,OUARGHA,CITRANGE CARRIZO,13010,IMG-00086-41.jpg,49,50,49,1,0,0.98,1.0
2022,OUARGHA,CITRANGE CARRIZO,13010,IMG-00194-41.jpg,33,33,33,0,0,1.0,1.0
2022,OUARGHA,CITRANGE CARRIZO,13020,IMG-00023-41.jpg,31,30,29,1,2,0.9666666666666668,0.935483870967742
2022,OUARGHA,CITRANGE CARRIZO,13020,IMG-00024-41.jpg,18,18,18,0,0,1.0,1.0
2022,OUARGHA,CITRANGE CARRIZO,13020,IMG-00039-41.jpg,4,4,4,0,0,1.0,1.0
2022,OUARGHA,CITRANGE CARRIZO,13020,IMG-00040-41.jpg,6,5,5,0,1,1.0,0.8333333333333334
2022,OUARGHA,CITRUS VOLKAMERIANA,13030,IMG-00009-41.jpg,18,18,18,0,0,1.0,1.0
2022,OUARGHA,CITRUS VOLKAMERIANA,13030,IMG-00013-41.jpg,46,44,44,0,2,1.0,0.9565217391304348
2022,OUARGHA,CITRUS VOLKAMERIANA,13030,IMG-00027-41.jpg,12,11,10,1,2,0.9090909090909092,0.8333333333333334
2022,OUARGHA,CITRUS VOLKAMERIANA,13030,IMG-00029-41.jpg,18,20,18,2,0,0.9,1.0
2022,OUARGHA,CITRUS VOLKAMERIANA,13030,IMG-00036-41.jpg,16,20,14,6,2,0.7,0.875
2022,OUARGHA,CITRUS VOLKAMERIANA,14010,IMG-00008-41.jpg,40,39,36,3,4,0.9230769230769232,0.9
2022,OUARGHA,CITRUS VOLKAMERIANA,14010,IMG-00010-41.jpg,49,50,49,1,0,0.98,1.0
2022,OUARGHA,CITRUS VOLKAMERIANA,14010,IMG-00011-41.jpg,47,48,47,1,0,0.9791666666666666,1.0
2022,OUARGHA,CITRUS VOLKAMERIANA,14010,IMG-00018-41.jpg,44,46,42,4,2,0.9130434782608696,0.9545454545454546
2022,KHOUALKA,MACROPHYLLA,20118,IMG-00007-40.jpg,44,45,42,3,2,0.9333333333333332,0.9545454545454546
2022,KHOUALKA,MACROPHYLLA,20118,IMG-00008-40.jpg,115,118,115,3,0,0.9745762711864406,1.0
2022,KHOUALKA,MACROPHYLLA,20118,IMG-00022-40.jpg,113,111,111,0,2,1.0,0.9823008849557522
2022,KHOUALKA,MACROPHYLLA,20118,IMG-00033-40.jpg,58,61,57,4,1,0.9344262295081968,0.9827586206896552
2022,KHOUALKA,MACROPHYLLA,20118,IMG-00037-40.jpg,29,28,28,0,1,1.0,0.9655172413793104
2022,KHOUALKA,MACROPHYLLA,20118,IMG-00042-40.jpg,137,132,131,1,6,0.9924242424242424,0.9562043795620438
2022,KHOUALKA,MACROPHYLLA,20118,IMG-00046-40.jpg,45,47,43,4,2,0.9148936170212766,0.9555555555555556
2022,KHOUALKA,MACROPHYLLA,20118,IMG-00050-40.jpg,48,47,47,0,1,1.0,0.9791666666666666
2022,KHOUALKA,MACROPHYLLA,20118,IMG-00055-40.jpg,52,50,48,2,4,0.96,0.9230769230769232
2022,KHOUALKA,MACROPHYLLA,20118,IMG-00061-40.jpg,120,124,118,6,2,0.9516129032258064,0.9833333333333332
2022,KHOUALKA,MACROPHYLLA,20118,IMG-00062-40.jpg,63,63,59,4,4,0.9365079365079364,0.9365079365079364
2022,KHOUALKA,MACROPHYLLA,20118,IMG-00063-40.jpg,47,50,46,4,1,0.92,0.9787234042553192
2022,KHOUALKA,MACROPHYLLA,20118,IMG-00066-40.jpg,84,87,82,5,2,0.942528735632184,0.9761904761904762
2024,KHOUALKA,MACROPHYLLA,20118,IMG-12691.jpg,22,14,14,0,8,1.0,0.6363636363636364
2024,KHOUALKA,MACROPHYLLA,20118,IMG-12729.jpg,56,45,44,1,12,0.9777777777777776,0.7857142857142857
2024,KHOUALKA,MACROPHYLLA,20118,IMG-12735.jpg,88,65,65,0,23,1.0,0.7386363636363636
2024,KHOUALKA,MACROPHYLLA,20118,IMG-12748.jpg,107,74,74,0,33,1.0,0.6915887850467289
2024,KHOUALKA,MACROPHYLLA,20118,IMG-12764.jpg,111,92,91,1,20,0.9891304347826086,0.8198198198198198
2024,KHOUALKA,MACROPHYLLA,20118,IMG-12808.jpg,113,80,80,0,33,1.0,0.7079646017699115
2024,KHOUALKA,MACROPHYLLA,20118,IMG-12851.jpg,24,12,12,0,12,1.0,0.5
2022,KHOUALKA,MACROPHYLLA,20119,IMG-00005-40.jpg,106,109,103,6,3,0.944954128440367,0.9716981132075472
2022,KHOUALKA,MACROPHYLLA,20119,IMG-00008-40.jpg,142,143,131,12,11,0.916083916083916,0.9225352112676056
2022,KHOUALKA,MACROPHYLLA,20119,IMG-00014-40.jpg,132,128,122,6,10,0.953125,0.9242424242424242
2022,KHOUALKA,BIGARADIER,20132,IMG-00004-40.jpg,181,172,168,4,13,0.9767441860465116,0.9281767955801103
2022,KHOUALKA,BIGARADIER,20132,IMG-00025-40.jpg,91,95,86,9,5,0.9052631578947368,0.945054945054945
2022,KHOUALKA,BIGARADIER,20132,IMG-00028-40.jpg,49,49,47,2,2,0.9591836734693876,0.9591836734693876
2022,KHOUALKA,BIGARADIER,20132,IMG-00035-40.jpg,103,111,103,8,0,0.927927927927928,1.0
2022,KHOUALKA,BIGARADIER,20132,IMG-00039-40.jpg,119,125,117,8,2,0.936,0.9831932773109244
2022,KHOUALKA,BIGARADIER,20132,IMG-00046-40.jpg,156,158,153,5,3,0.9683544303797468,0.9807692307692308
2022,KHOUALKA,BIGARADIER,20132,IMG-00051-40.jpg,108,105,104,1,4,0.9904761904761904,0.9629629629629628
2022,KHOUALKA,BIGARADIER,20132,IMG-00055-40.jpg,67,65,64,1,3,0.9846153846153848,0.9552238805970148
2022,KHOUALKA,BIGARADIER,20132,IMG-00058-40.jpg,89,87,87,0,2,1.0,0.9775280898876404
2022,KHOUALKA,BIGARADIER,20132,IMG-00059-40.jpg,139,132,127,5,12,0.9621212121212122,0.9136690647482014
2022,KHOUALKA,BIGARADIER,20132,IMG-00060-40.jpg,57,56,56,0,1,1.0,0.9824561403508772
2022,KHOUALKA,BIGARADIER,20132,IMG-00064-40.jpg,117,116,110,6,7,0.9482758620689656,0.9401709401709402
2022,KHOUALKA,BIGARADIER,20132,IMG-00075-40.jpg,69,73,69,4,0,0.9452054794520548,1.0
2022,ONAGRI,BIGARADIER,20139,IMG-00021-39.jpg,93,89,86,3,7,0.9662921348314608,0.9247311827956988
2024,KHOUALKA,CITRUS VOLKAMERIANA,20205,IMG-12040.jpg,123,91,88,3,35,0.967032967032967,0.7154471544715447
2024,KHOUALKA,CITRUS VOLKAMERIANA,20205,IMG-12058.jpg,116,108,107,1,9,0.9907407407407408,0.9224137931034484
2024,KHOUALKA,CITRUS VOLKAMERIANA,20207,IMG-11892.jpg,94,70,67,3,27,0.9571428571428572,0.7127659574468085
2024,KHOUALKA,CITRUS VOLKAMERIANA,20207,IMG-11921.jpg,264,184,183,1,81,0.9945652173913044,0.6931818181818182
2024,KHOUALKA,CITRUS VOLKAMERIANA,20207,IMG-11927.jpg,195,132,131,1,64,0.9924242424242424,0.6717948717948717
2024,KHOUALKA,CITRUS VOLKAMERIANA,20207,IMG-11961.jpg,113,83,83,0,30,1.0,0.7345132743362832
2024,KHOUALKA,CITRUS VOLKAMERIANA,20207,IMG-11972.jpg,94,68,66,2,28,0.9705882352941176,0.7021276595744681
2024,KHOUALKA,CITRUS VOLKAMERIANA,20207,IMG-11981.jpg,81,56,55,1,26,0.9821428571428572,0.6790123456790124
2022,SAOUDA,CITRUS VOLKAMERIANA,21020,IMG-00033-45.jpg,67,68,65,3,2,0.9558823529411764,0.9701492537313432
2022,SAOUDA,CITRUS VOLKAMERIANA,21020,IMG-00087-45.jpg,21,21,20,1,1,0.9523809523809524,0.9523809523809524
2022,SAOUDA,CITRUS VOLKAMERIANA,21020,IMG-00138-45.jpg,40,40,39,1,1,0.975,0.975
2022,SAOUDA,CITRUS VOLKAMERIANA,21020,IMG-00145-45.jpg,37,39,37,2,0,0.9487179487179488,1.0
2022,SAOUDA,CITRUS VOLKAMERIANA,21020,IMG-00155-45.jpg,38,38,35,3,3,0.9210526315789472,0.9210526315789472
2022,SAOUDA,CITRUS VOLKAMERIANA,21030,IMG-00521-45.jpg,31,37,31,6,0,0.8378378378378378,1.0
2022,SAOUDA,CITRUS VOLKAMERIANA,21030,IMG-00524-45.jpg,71,75,69,6,2,0.92,0.971830985915493
2022,SAOUDA,CITRUS VOLKAMERIANA,21030,IMG-00536-45.jpg,41,46,39,7,2,0.8478260869565217,0.951219512195122
2022,SAOUDA,CITRUS VOLKAMERIANA,21030,IMG-00537-45.jpg,52,54,50,4,2,0.925925925925926,0.9615384615384616
2022,SAOUDA,CITRUS VOLKAMERIANA,22020,IMG-00053-45.jpg,39,45,39,6,0,0.8666666666666667,1.0
2022,SAOUDA,CITRUS VOLKAMERIANA,22020,IMG-00059-45.jpg,46,48,45,3,1,0.9375,0.9782608695652174
2022,SAOUDA,CITRUS VOLKAMERIANA,22020,IMG-00060-45.jpg,48,49,46,3,2,0.9387755102040816,0.9583333333333334
2022,SAOUDA,CITRUS VOLKAMERIANA,22020,IMG-00062-45.jpg,50,55,50,5,0,0.9090909090909092,1.0
2022,SAOUDA,CITRUS VOLKAMERIANA,22030,IMG-00062-45.jpg,62,63,62,1,0,0.984126984126984,1.0
2022,SAOUDA,CITRUS VOLKAMERIANA,22030,IMG-00063-45.jpg,83,85,82,3,1,0.9647058823529412,0.9879518072289156
2022,SAOUDA,CITRUS VOLKAMERIANA,22030,IMG-00065-45.jpg,58,59,56,3,2,0.9491525423728814,0.9655172413793104
2022,SAOUDA,CITRUS VOLKAMERIANA,22030,IMG-00068-45.jpg,66,68,64,4,2,0.9411764705882352,0.9696969696969696
2022,SAOUDA,CITRUS VOLKAMERIANA,23020,IMG-00024-45.jpg,47,50,47,3,0,0.94,1.0
2022,SAOUDA,CITRUS VOLKAMERIANA,23020,IMG-00032-45.jpg,33,36,33,3,0,0.9166666666666666,1.0
2022,SAOUDA,CITRUS VOLKAMERIANA,23020,IMG-00074-45.jpg,28,30,27,3,1,0.9,0.9642857142857144
2022,SAOUDA,CITRUS VOLKAMERIANA,23020,IMG-00079-45.jpg,28,30,27,3,1,0.9,0.9642857142857144
2022,SAOUDA,CITRUS VOLKAMERIANA,23030,IMG-00014-45.jpg,25,26,25,1,0,0.9615384615384616,1.0
2022,SAOUDA,CITRUS VOLKAMERIANA,23030,IMG-00034-45.jpg,43,42,40,2,3,0.9523809523809524,0.9302325581395348
2022,SAOUDA,CITRUS VOLKAMERIANA,23030,IMG-00069-45.jpg,28,31,26,5,2,0.8387096774193549,0.9285714285714286
2022,SAOUDA,CITRUS VOLKAMERIANA,23030,IMG-00079-45.jpg,50,52,49,3,1,0.9423076923076924,0.98
2022,SAOUDA,CITRANGE CARRIZO,24010,IMG-00097-45.jpg,59,58,56,2,3,0.9655172413793104,0.9491525423728814
2022,SAOUDA,CITRANGE CARRIZO,24010,IMG-00101-45.jpg,27,30,27,3,0,0.9,1.0
2022,SAOUDA,CITRANGE CARRIZO,24010,IMG-00111-45.jpg,54,56,53,3,1,0.9464285714285714,0.9814814814814816
2022,SAOUDA,CITRANGE CARRIZO,24010,IMG-00112-45.jpg,40,41,37,4,3,0.902439024390244,0.925
2022,SAOUDA,CITRANGE CARRIZO,25010,IMG-00006-45.jpg,55,53,52,1,3,0.981132075471698,0.9454545454545454
2022,SAOUDA,CITRANGE CARRIZO,25010,IMG-00007-45.jpg,77,79,76,3,1,0.9620253164556962,0.987012987012987
2022,SAOUDA,CITRANGE CARRIZO,25010,IMG-00010-45.jpg,53,51,51,0,2,1.0,0.9622641509433962
2022,SAOUDA,CITRANGE CARRIZO,25010,IMG-00011-45.jpg,26,26,26,0,0,1.0,1.0
2022,SAOUDA,CITRANGE CARRIZO,26010,IMG-00008-45.jpg,39,39,39,0,0,1.0,1.0
2022,SAOUDA,CITRANGE CARRIZO,26010,IMG-00013-45.jpg,36,37,36,1,0,0.972972972972973,1.0
2022,SAOUDA,CITRANGE CARRIZO,26010,IMG-00018-45.jpg,43,45,43,2,0,0.9555555555555556,1.0
2022,SAOUDA,CITRANGE CARRIZO,26010,IMG-00020-45.jpg,44,45,43,2,1,0.9555555555555556,0.9772727272727272
2022,KHOUALKA,CITRANGE CARRIZO,30138,IMG-00002-40.jpg,39,41,39,2,0,0.951219512195122,1.0
2022,KHOUALKA,CITRANGE CARRIZO,30138,IMG-00003-40.jpg,59,58,55,3,4,0.9482758620689656,0.9322033898305084
2022,KHOUALKA,CITRANGE CARRIZO,30138,IMG-00005-40.jpg,58,62,58,4,0,0.935483870967742,1.0
2022,KHOUALKA,CITRANGE CARRIZO,30138,IMG-00008-40.jpg,32,33,30,3,2,0.9090909090909092,0.9375
2022,KHOUALKA,CITRANGE CARRIZO,30138,IMG-00011-40.jpg,26,27,26,1,0,0.9629629629629628,1.0
2022,KHOUALKA,CITRANGE CARRIZO,30138,IMG-00019-40.jpg,2,2,2,0,0,1.0,1.0
2022,KHOUALKA,CITRANGE CARRIZO,30138,IMG-00037-40.jpg,30,32,29,3,1,0.90625,0.9666666666666668
2022,KHOUALKA,CITRANGE CARRIZO,30138,IMG-00040-40.jpg,41,41,41,0,0,1.0,1.0
2022,KHOUALKA,CITRANGE CARRIZO,30138,IMG-00043-40.jpg,28,32,27,5,1,0.84375,0.9642857142857144
2022,KHOUALKA,CITRANGE CARRIZO,30138,IMG-00044-40.jpg,99,98,97,1,2,0.9897959183673468,0.9797979797979798
2022,KHOUALKA,CITRANGE CARRIZO,30138,IMG-00048-40.jpg,37,39,34,5,3,0.8717948717948718,0.918918918918919
2022,KHOUALKA,CITRANGE CARRIZO,30138,IMG-00057-40.jpg,73,74,71,3,2,0.9594594594594594,0.9726027397260274
2022,KHOUALKA,CITRANGE CARRIZO,30138,IMG-00063-40.jpg,89,90,87,3,2,0.9666666666666668,0.9775280898876404
2022,ONAGRI,CITRUS VOLKAMERIANA,30145,IMG-00018-39.jpg,219,203,193,10,26,0.9507389162561576,0.8812785388127854
2022,ONAGRI,CITRUS VOLKAMERIANA,30145,IMG-00043-39.jpg,64,63,62,1,2,0.984126984126984,0.96875
2022,ONAGRI,CITRUS VOLKAMERIANA,30146,IMG-00008-39.jpg,262,251,236,15,26,0.9402390438247012,0.900763358778626
2022,ONAGRI,CITRUS VOLKAMERIANA,30146,IMG-00045-39.jpg,190,189,181,8,9,0.9576719576719576,0.9526315789473684
2022,ONAGRI,CITRUS VOLKAMERIANA,30147,IMG-00002-39.jpg,269,262,250,12,19,0.9541984732824428,0.929368029739777
2022,ONAGRI,CITRUS VOLKAMERIANA,30147,IMG-00008-39.jpg,172,169,158,11,14,0.9349112426035504,0.9186046511627908
2022,ONAGRI,CITRUS VOLKAMERIANA,30148,IMG-00016-40.jpg,88,86,84,2,4,0.9767441860465116,0.9545454545454546
2022,ONAGRI,CITRUS VOLKAMERIANA,30148,IMG-00047-40.jpg,34,30,30,0,4,1.0,0.8823529411764706
2022,ONAGRI,CITRUS VOLKAMERIANA,30149,IMG-00018-39.jpg,151,138,136,2,15,0.9855072463768116,0.9006622516556292
2022,ONAGRI,CITRUS VOLKAMERIANA,30149,IMG-00027-39.jpg,226,206,205,1,21,0.9951456310679612,0.9070796460176992
2022,ONAGRI,CITRUS VOLKAMERIANA,30151,IMG-00012-39.jpg,185,166,161,5,24,0.9698795180722892,0.8702702702702703
2022,ONAGRI,CITRUS VOLKAMERIANA,30151,IMG-00033-39.jpg,214,207,200,7,14,0.966183574879227,0.9345794392523364
2024,ONAGRI,CITRUS VOLKAMERIANA,30151,IMG-21881.jpg,73,51,50,1,23,0.9803921568627452,0.684931506849315
2024,ONAGRI,CITRUS VOLKAMERIANA,30151,IMG-21935.jpg,179,151,146,5,33,0.9668874172185432,0.8156424581005587
2024,ONAGRI,CITRUS VOLKAMERIANA,30151,IMG-21936.jpg,93,73,73,0,20,1.0,0.7849462365591398
2022,ONAGRI,CITRUS VOLKAMERIANA,30152,IMG-00016-39.jpg,39,38,37,1,2,0.9736842105263158,0.9487179487179488
2022,ONAGRI,CITRUS VOLKAMERIANA,30152,IMG-00019-39.jpg,139,120,114,6,25,0.95,0.8201438848920863
2022,ONAGRI,CITRUS VOLKAMERIANA,30153,IMG-00001.jpg,157,143,135,8,22,0.944055944055944,0.8598726114649682
2022,ONAGRI,CITRUS VOLKAMERIANA,30153,IMG-00007-39.jpg,127,118,115,3,12,0.9745762711864406,0.905511811023622
2022,ONAGRI,CITRUS VOLKAMERIANA,30153,IMG-00013-39.jpg,159,147,144,3,15,0.979591836734694,0.9056603773584906
2022,ONAGRI,CITRUS VOLKAMERIANA,30153,IMG-00040-39.jpg,153,137,132,5,21,0.9635036496350364,0.8627450980392157
2022,ONAGRI,CITRUS VOLKAMERIANA,30154,IMG-00017-39.jpg,160,161,152,9,8,0.9440993788819876,0.95
2022,ONAGRI,CITRUS VOLKAMERIANA,30154,IMG-00027-39.jpg,220,212,202,10,18,0.9528301886792452,0.9181818181818182
2022,ONAGRI,CITRUS VOLKAMERIANA,30154,IMG-00033-39.jpg,51,50,47,3,4,0.94,0.9215686274509804
2022,ONAGRI,CITRUS VOLKAMERIANA,30154,IMG-00036-39.jpg,137,134,130,4,7,0.9701492537313432,0.948905109489051
2022,ONAGRI,CITRUS VOLKAMERIANA,30154,IMG-00038-39.jpg,242,246,236,10,6,0.959349593495935,0.975206611570248
2022,ONAGRI,CITRUS VOLKAMERIANA,30154,IMG-00041-39.jpg,272,263,253,10,19,0.9619771863117872,0.9301470588235294
2022,ONAGRI,CITRUS VOLKAMERIANA,30154,IMG-00044-39.jpg,141,150,133,17,8,0.8866666666666667,0.9432624113475178
2022,ONAGRI,BIGARADIER,30155,IMG-00002-39.jpg,139,140,134,6,5,0.9571428571428572,0.9640287769784172
2022,ONAGRI,BIGARADIER,30155,IMG-00003-39.jpg,115,108,105,3,10,0.9722222222222222,0.9130434782608696
2022,ONAGRI,BIGARADIER,30155,IMG-00006-39.jpg,44,42,37,5,7,0.8809523809523809,0.8409090909090909
2022,ONAGRI,BIGARADIER,30155,IMG-00011-39.jpg,100,92,92,0,8,1.0,0.92
2022,ONAGRI,BIGARADIER,30155,IMG-00019-39.jpg,142,137,131,6,11,0.9562043795620438,0.9225352112676056
2022,ONAGRI,BIGARADIER,30155,IMG-00026-39.jpg,124,114,111,3,13,0.9736842105263158,0.8951612903225806
2022,ONAGRI,BIGARADIER,30155,IMG-00032-39.jpg,81,76,70,6,11,0.9210526315789472,0.8641975308641975
2022,ONAGRI,BIGARADIER,30155,IMG-00039-39.jpg,19,16,15,1,4,0.9375,0.7894736842105263
2022,ONAGRI,BIGARADIER,30155,IMG-00043-39.jpg,130,132,124,8,6,0.9393939393939394,0.953846153846154
2022,ONAGRI,CITRUS VOLKAMERIANA,30157,IMG-00003-39.jpg,227,226,217,9,10,0.9601769911504424,0.9559471365638766
2022,ONAGRI,CITRUS VOLKAMERIANA,30157,IMG-00012-39.jpg,283,283,272,11,11,0.96113074204947,0.96113074204947
2022,ONAGRI,CITRUS VOLKAMERIANA,30157,IMG-00032-39.jpg,64,65,61,4,3,0.9384615384615383,0.953125
2022,ONAGRI,CITRUS VOLKAMERIANA,30157,IMG-00035-39.jpg,159,150,144,6,15,0.96,0.9056603773584906
2022,KHOUALKA,CITRUS VOLKAMERIANA,30235,IMG-00001.jpg,93,92,90,2,3,0.9782608695652174,0.967741935483871
2022,KHOUALKA,CITRUS VOLKAMERIANA,30235,IMG-00003-40.jpg,37,38,37,1,0,0.9736842105263158,1.0
2022,KHOUALKA,CITRUS VOLKAMERIANA,30235,IMG-00009-40.jpg,103,104,100,4,3,0.9615384615384616,0.970873786407767
2022,KHOUALKA,CITRUS VOLKAMERIANA,30235,IMG-00013-40.jpg,90,94,90,4,0,0.9574468085106383,1.0
2022,KHOUALKA,CITRUS VOLKAMERIANA,30235,IMG-00026-40.jpg,122,126,119,7,3,0.9444444444444444,0.9754098360655736
2022,KHOUALKA,CITRUS VOLKAMERIANA,30235,IMG-00047-40.jpg,47,51,45,6,2,0.8823529411764706,0.9574468085106383
2022,KHOUALKA,CITRUS VOLKAMERIANA,30235,IMG-00048-40.jpg,90,93,88,5,2,0.946236559139785,0.9777777777777776
2022,KHOUALKA,CITRUS VOLKAMERIANA,30235,IMG-00049-40.jpg,44,44,43,1,1,0.9772727272727272,0.9772727272727272
2022,KHOUALKA,CITRUS VOLKAMERIANA,30235,IMG-00050-40.jpg,84,85,82,3,2,0.9647058823529412,0.9761904761904762
2022,KHOUALKA,CITRUS VOLKAMERIANA,30235,IMG-00052-40.jpg,98,103,98,5,0,0.9514563106796116,1.0
2022,KHOUALKA,CITRUS VOLKAMERIANA,30235,IMG-00057-40.jpg,80,75,71,4,9,0.9466666666666668,0.8875
2022,KHOUALKA,CITRUS VOLKAMERIANA,30235,IMG-00064-40.jpg,38,38,37,1,1,0.9736842105263158,0.9736842105263158
2022,KHOUALKA,CITRUS VOLKAMERIANA,30235,IMG-00067-40.jpg,107,105,102,3,5,0.9714285714285714,0.9532710280373832
2022,KHOUALKA,CITRUS VOLKAMERIANA,30235,IMG-00069-40.jpg,34,38,32,6,2,0.8421052631578947,0.9411764705882352
2022,KHOUALKA,CITRUS VOLKAMERIANA,30235,IMG-00075-40.jpg,95,100,94,6,1,0.94,0.9894736842105264
2022,KHOUALKA,BIGARADIER,40141,IMG-00006-40.jpg,7,7,6,1,1,0.8571428571428571,0.8571428571428571
2022,KHOUALKA,BIGARADIER,40141,IMG-00007-40.jpg,20,17,16,1,4,0.9411764705882352,0.8
2022,KHOUALKA,BIGARADIER,40141,IMG-00008-40.jpg,15,13,11,2,4,0.8461538461538461,0.7333333333333333
2022,ONAGRI,CITRANGE C35,40166,IMG-00009-39.jpg,38,39,36,3,2,0.9230769230769232,0.9473684210526316
2022,ONAGRI,CITRANGE C35,40166,IMG-00011-39.jpg,173,176,167,9,6,0.9488636363636364,0.9653179190751444
2022,ONAGRI,CITRANGE C35,40166,IMG-00014-39.jpg,179,181,175,6,4,0.9668508287292816,0.9776536312849162
2022,ONAGRI,CITRANGE C35,40166,IMG-00015-39.jpg,122,126,119,7,3,0.9444444444444444,0.9754098360655736
2022,ONAGRI,CITRANGE C35,40166,IMG-00041-39.jpg,102,101,100,1,2,0.99009900990099,0.9803921568627452
2022,ONAGRI,CITRANGE C35,40167,IMG-00019-39.jpg,197,198,195,3,2,0.9848484848484848,0.9898477157360406
2022,ONAGRI,CITRANGE C35,40167,IMG-00030-39.jpg,126,121,119,2,7,0.9834710743801652,0.9444444444444444
2022,ONAGRI,CITRANGE C35,40167,IMG-00039-39.jpg,217,209,199,10,18,0.9521531100478468,0.9170506912442395
2022,ONAGRI,CITRANGE C35,40171,IMG-00008-39.jpg,109,104,103,1,6,0.9903846153846154,0.944954128440367
2022,ONAGRI,CITRANGE C35,40171,IMG-00037-39.jpg,94,88,85,3,9,0.9659090909090908,0.9042553191489362
2022,ONAGRI,CITRANGE C35,40171,IMG-00040-39.jpg,149,144,141,3,8,0.9791666666666666,0.9463087248322148
2022,ONAGRI,CITRANGE C35,40172,IMG-00012-39.jpg,89,82,80,2,9,0.975609756097561,0.898876404494382
2022,ONAGRI,CITRANGE C35,40172,IMG-00025-39.jpg,109,104,102,2,7,0.9807692307692308,0.9357798165137616
2022,ONAGRI,CITRANGE C35,40172,IMG-00027-39.jpg,103,93,92,1,11,0.989247311827957,0.8932038834951457
2022,ONAGRI,CITRANGE C35,40173,IMG-00004-39.jpg,133,120,119,1,14,0.9916666666666668,0.8947368421052632
2022,ONAGRI,CITRANGE C35,40173,IMG-00008-39.jpg,57,48,47,1,10,0.9791666666666666,0.8245614035087719
2022,ONAGRI,CITRANGE C35,40173,IMG-00010-39.jpg,53,57,51,6,2,0.8947368421052632,0.9622641509433962
2022,ONAGRI,CITRANGE C35,40175,IMG-00005-39.jpg,95,88,84,4,11,0.9545454545454546,0.8842105263157894
2022,ONAGRI,CITRANGE C35,40175,IMG-00006-39.jpg,64,66,62,4,2,0.9393939393939394,0.96875
2022,ONAGRI,CITRANGE C35,40176,IMG-00004-39.jpg,79,77,72,5,7,0.935064935064935,0.9113924050632912
2022,ONAGRI,CITRANGE C35,40176,IMG-00012-39.jpg,105,107,101,6,4,0.9439252336448598,0.961904761904762
2022,ONAGRI,CITRANGE C35,40176,IMG-00014-39.jpg,91,92,84,8,7,0.9130434782608696,0.9230769230769232
2022,ONAGRI,CITRUMELO SACCATON,40177,IMG-00012-39.jpg,89,88,85,3,4,0.9659090909090908,0.9550561797752808
2022,ONAGRI,CITRUMELO SACCATON,40177,IMG-00015-39.jpg,213,218,208,10,5,0.9541284403669724,0.976525821596244
2022,ONAGRI,CITRUMELO SACCATON,40177,IMG-00037-39.jpg,95,95,89,6,6,0.936842105263158,0.936842105263158
2022,ONAGRI,CITRANGE C35,40178,IMG-00013-39.jpg,76,76,76,0,0,1.0,1.0
2022,ONAGRI,CITRANGE C35,40178,IMG-00027-39.jpg,56,58,56,2,0,0.9655172413793104,1.0
2022,ONAGRI,CITRANGE C35,40178,IMG-00031-39.jpg,30,30,30,0,0,1.0,1.0
2022,ONAGRI,CITRANGE C35,40178,IMG-00032-39.jpg,27,29,27,2,0,0.9310344827586208,1.0
2022,ONAGRI,CITRANGE C35,40178,IMG-00033-39.jpg,34,35,33,2,1,0.9428571428571428,0.9705882352941176
2022,ONAGRI,CITRANGE C35,40179,IMG-00001.jpg,83,85,80,5,3,0.9411764705882352,0.963855421686747
2022,ONAGRI,CITRANGE C35,40179,IMG-00010-39.jpg,161,161,154,7,7,0.9565217391304348,0.9565217391304348
2022,ONAGRI,CITRANGE C35,40179,IMG-00011-39.jpg,102,100,99,1,3,0.99,0.9705882352941176
2022,ONAGRI,CITRANGE C35,40179,IMG-00018-39.jpg,9,9,9,0,0,1.0,1.0
2022,ONAGRI,CITRUMELO SACCATON,40182,IMG-00004-39.jpg,35,37,35,2,0,0.945945945945946,1.0
2022,ONAGRI,CITRUMELO SACCATON,40182,IMG-00010-39.jpg,52,50,49,1,3,0.98,0.9423076923076924
2022,ONAGRI,CITRUMELO SACCATON,40182,IMG-00015-39.jpg,85,82,78,4,7,0.951219512195122,0.9176470588235294
2022,ONAGRI,CITRUMELO SACCATON,40183,IMG-00005-39.jpg,68,67,67,0,1,1.0,0.9852941176470588
2022,ONAGRI,CITRUMELO SACCATON,40183,IMG-00009-39.jpg,57,56,54,2,3,0.9642857142857144,0.9473684210526316
2022,ONAGRI,CITRUMELO SACCATON,40183,IMG-00010-39.jpg,48,46,44,2,4,0.9565217391304348,0.9166666666666666
2024,KHOUALKA,CITRUS VOLKAMERIANA,50152,IMG-17274.jpg,170,125,124,1,46,0.992,0.7294117647058823
2024,KHOUALKA,CITRUS VOLKAMERIANA,50152,IMG-17306.jpg,105,88,88,0,17,1.0,0.8380952380952381
2024,KHOUALKA,CITRUS VOLKAMERIANA,50152,IMG-17330.jpg,41,28,28,0,13,1.0,0.6829268292682927
2024,KHOUALKA,CITRUS VOLKAMERIANA,50152,IMG-17335.jpg,44,32,32,0,12,1.0,0.7272727272727273
2024,KHOUALKA,CITRUS VOLKAMERIANA,50152,IMG-17340.jpg,108,72,71,1,37,0.9861111111111112,0.6574074074074074
2024,KHOUALKA,CITRUS VOLKAMERIANA,50152,IMG-17356.jpg,60,41,40,1,20,0.975609756097561,0.6666666666666666
2024,KHOUALKA,CITRUS VOLKAMERIANA,50152,IMG-17384.jpg,53,31,31,0,22,1.0,0.5849056603773585
2024,KHOUALKA,CITRUS VOLKAMERIANA,50154,IMG-17440.jpg,76,60,60,0,16,1.0,0.7894736842105263
2024,KHOUALKA,CITRUS VOLKAMERIANA,50154,IMG-17490.jpg,107,72,72,0,35,1.0,0.6728971962616822
2024,KHOUALKA,CITRUS VOLKAMERIANA,50154,IMG-17543.jpg,100,68,68,0,32,1.0,0.68
2024,KHOUALKA,CITRUS VOLKAMERIANA,50154,IMG-17545.jpg,94,67,67,0,27,1.0,0.7127659574468085
2024,KHOUALKA,CITRUS VOLKAMERIANA,50154,IMG-17562.jpg,129,98,98,0,31,1.0,0.7596899224806202
2024,KHOUALKA,CITRUS VOLKAMERIANA,50154,IMG-17576.jpg,121,96,96,0,25,1.0,0.7933884297520661
2024,KHOUALKA,CITRUS VOLKAMERIANA,50154,IMG-17585.jpg,171,132,130,2,41,0.9848484848484848,0.7602339181286549
2024,KHOUALKA,CITRUS VOLKAMERIANA,50168,IMG-13980.jpg,174,124,124,0,50,1.0,0.7126436781609196
2024,KHOUALKA,CITRUS VOLKAMERIANA,50168,IMG-15749.jpg,147,118,118,0,29,1.0,0.8027210884353742
2024,KHOUALKA,CITRUS VOLKAMERIANA,50168,IMG-15758.jpg,163,128,126,2,37,0.984375,0.7730061349693251
2024,KHOUALKA,CITRUS VOLKAMERIANA,50168,IMG-15981.jpg,210,158,157,1,53,0.9936708860759492,0.7476190476190476
2024,KHOUALKA,CITRUS VOLKAMERIANA,50168,IMG-15983.jpg,120,85,85,0,35,1.0,0.7083333333333334
2024,KHOUALKA,CITRUS VOLKAMERIANA,50176,IMG-16025.jpg,81,59,59,0,22,1.0,0.7283950617283951
2024,KHOUALKA,CITRUS VOLKAMERIANA,50176,IMG-16051.jpg,85,62,62,0,23,1.0,0.7294117647058823
2024,KHOUALKA,CITRUS VOLKAMERIANA,50176,IMG-16079.jpg,161,117,117,0,44,1.0,0.7267080745341615
2024,KHOUALKA,CITRUS VOLKAMERIANA,50176,IMG-16095.jpg,101,65,65,0,36,1.0,0.6435643564356436
2024,KHOUALKA,CITRUS VOLKAMERIANA,50176,IMG-16105.jpg,43,28,28,0,15,1.0,0.6511627906976745
2022,ONAGRI,CITRUMELO SACCATON,50193,IMG-00007-39.jpg,218,218,216,2,2,0.9908256880733946,0.9908256880733946
2022,ONAGRI,CITRUMELO SACCATON,50193,IMG-00016-39.jpg,64,63,60,3,4,0.9523809523809524,0.9375
2022,ONAGRI,CITRUMELO SACCATON,50193,IMG-00018-39.jpg,115,119,114,5,1,0.957983193277311,0.991304347826087
2022,ONAGRI,CITRUMELO SACCATON,50193,IMG-00021-39.jpg,62,63,60,3,2,0.9523809523809524,0.967741935483871
2022,ONAGRI,CITRUMELO SACCATON,50193,IMG-00023-39.jpg,113,116,110,6,3,0.9482758620689656,0.9734513274336284
2022,ONAGRI,CITRUMELO SACCATON,50194,IMG-00032-39.jpg,162,166,159,7,3,0.9578313253012049,0.9814814814814816
2022,ONAGRI,CITRUMELO SACCATON,50194,IMG-00034-39.jpg,105,112,105,7,0,0.9375,1.0
2022,ONAGRI,CITRUMELO SACCATON,50194,IMG-00036-39.jpg,161,169,152,17,9,0.8994082840236687,0.9440993788819876
2022,ONAGRI,CITRUMELO SACCATON,50194,IMG-00038-39.jpg,100,100,97,3,3,0.97,0.97
2022,ONAGRI,CITRUMELO SACCATON,50194,IMG-00039-39.jpg,65,66,64,2,1,0.9696969696969696,0.9846153846153848
2022,ONAGRI,CITRUMELO SACCATON,50194,IMG-00041-39.jpg,153,155,148,7,5,0.9548387096774194,0.9673202614379084
2022,ONAGRI,CITRUMELO SACCATON,50194,IMG-00051-39.jpg,137,135,130,5,7,0.9629629629629628,0.948905109489051
2022,ONAGRI,CITRUMELO SACCATON,50194,IMG-00054-39.jpg,111,111,106,5,5,0.954954954954955,0.954954954954955
2022,ONAGRI,CITRUMELO SACCATON,51091,IMG-00015-39.jpg,85,88,82,6,3,0.9318181818181818,0.9647058823529412
2022,ONAGRI,CITRUMELO SACCATON,51091,IMG-00016-39.jpg,170,176,169,7,1,0.9602272727272728,0.9941176470588236
2022,ONAGRI,CITRUMELO SACCATON,51091,IMG-00018-39.jpg,185,196,183,13,2,0.9336734693877552,0.9891891891891892
2022,ONAGRI,CITRUMELO SACCATON,51091,IMG-00022-39.jpg,135,145,135,10,0,0.9310344827586208,1.0
2022,ONAGRI,CITRUMELO SACCATON,51091,IMG-00023-39.jpg,140,138,137,1,3,0.9927536231884058,0.9785714285714284
2022,ONAGRI,CITRUMELO SACCATON,51091,IMG-00026-39.jpg,149,145,140,5,9,0.9655172413793104,0.9395973154362416
2022,ONAGRI,CITRUMELO SACCATON,51091,IMG-00044-39.jpg,168,172,165,7,3,0.9593023255813954,0.9821428571428572
2022,ONAGRI,CITRUMELO SACCATON,51095,IMG-00004-39.jpg,201,208,195,13,6,0.9375,0.9701492537313432
2022,ONAGRI,CITRUMELO SACCATON,51095,IMG-00013-39.jpg,154,154,149,5,5,0.9675324675324676,0.9675324675324676
2022,ONAGRI,CITRUMELO SACCATON,51095,IMG-00014-39.jpg,140,142,135,7,5,0.9507042253521126,0.9642857142857144
2022,ONAGRI,CITRUMELO SACCATON,51095,IMG-00015-39.jpg,196,197,191,6,5,0.9695431472081218,0.9744897959183674
2022,ONAGRI,CITRUMELO SACCATON,51095,IMG-00024-39.jpg,234,231,223,8,11,0.9653679653679652,0.9529914529914528
2022,ONAGRI,CITRUMELO SACCATON,51095,IMG-00025-39.jpg,198,200,190,10,8,0.95,0.9595959595959596
2022,ONAGRI,CITRUMELO SACCATON,51096,IMG-00009-39.jpg,219,217,214,3,5,0.9861751152073732,0.9771689497716894
2022,ONAGRI,CITRUMELO SACCATON,51096,IMG-00011-39.jpg,145,150,138,12,7,0.92,0.9517241379310344
2022,ONAGRI,CITRUMELO SACCATON,51096,IMG-00012-39.jpg,114,112,107,5,7,0.9553571428571428,0.9385964912280702
2022,ONAGRI,CITRUMELO SACCATON,51096,IMG-00055-39.jpg,217,206,200,6,17,0.970873786407767,0.9216589861751152
2022,ONAGRI,MC PONSIRUCE TRIFOLIATA,51097,IMG-00025-39.jpg,121,128,116,12,5,0.90625,0.9586776859504132
2022,ONAGRI,MC PONSIRUCE TRIFOLIATA,51097,IMG-00029-39.jpg,106,110,103,7,3,0.9363636363636364,0.9716981132075472
2022,ONAGRI,MC PONSIRUCE TRIFOLIATA,51097,IMG-00044-39.jpg,182,183,176,7,6,0.9617486338797814,0.967032967032967
2022,ONAGRI,MC PONSIRUCE TRIFOLIATA,51098,IMG-00003-39.jpg,65,70,63,7,2,0.9,0.9692307692307692
2022,ONAGRI,MC PONSIRUCE TRIFOLIATA,51098,IMG-00010-39.jpg,184,185,177,8,7,0.9567567567567568,0.9619565217391304
2022,ONAGRI,MC PONSIRUCE TRIFOLIATA,51098,IMG-00015-39.jpg,162,165,159,6,3,0.9636363636363636,0.9814814814814816
2022,ONAGRI,MC PONSIRUCE TRIFOLIATA,51099,IMG-00012-39.jpg,133,134,125,9,8,0.9328358208955224,0.9398496240601504
2024,ONAGRI,MC PONSIRUCE TRIFOLIATA,51101,IMG-12118.jpg,177,121,121,0,56,1.0,0.6836158192090396
2024,ONAGRI,MC PONSIRUCE TRIFOLIATA,51101,IMG-14223.jpg,153,113,113,0,40,1.0,0.738562091503268
2024,ONAGRI,MC PONSIRUCE TRIFOLIATA,51101,IMG-14226.jpg,151,117,117,0,34,1.0,0.7748344370860927
2024,ONAGRI,MC PONSIRUCE TRIFOLIATA,51101,IMG-14255.jpg,189,149,149,0,40,1.0,0.7883597883597884
2024,ONAGRI,MC PONSIRUCE TRIFOLIATA,51101,IMG-14281.jpg,150,117,117,0,33,1.0,0.78
2022,ONAGRI,CITRUS VOLKAMERIANA,101020,IMG-00001.jpg,6,7,6,1,0,0.8571428571428571,1.0
2022,ONAGRI,CITRUS VOLKAMERIANA,101020,IMG-00004-44.jpg,53,51,49,2,4,0.9607843137254902,0.9245283018867924
2022,ONAGRI,CITRUS VOLKAMERIANA,101030,IMG-00003-44.jpg,29,28,28,0,1,1.0,0.9655172413793104
2022,ONAGRI,CITRUS VOLKAMERIANA,101030,IMG-00004-44.jpg,110,101,97,4,13,0.9603960396039604,0.8818181818181818
2022,ONAGRI,CITRUS VOLKAMERIANA,101030,IMG-00005-44.jpg,134,128,123,5,11,0.9609375,0.917910447761194
2022,ONAGRI,CITRUS VOLKAMERIANA,101030,IMG-00017-44.jpg,79,72,70,2,9,0.9722222222222222,0.8860759493670886
2022,ONAGRI,CITRUS VOLKAMERIANA,101040,IMG-00005-44.jpg,172,160,157,3,15,0.98125,0.9127906976744186
2022,ONAGRI,CITRUS VOLKAMERIANA,101040,IMG-00009-44.jpg,131,133,127,6,4,0.9548872180451128,0.9694656488549618
2022,ONAGRI,CITRUS VOLKAMERIANA,101040,IMG-00011-44.jpg,64,65,59,6,5,0.9076923076923076,0.921875
2022,ONAGRI,CITRUS VOLKAMERIANA,101040,IMG-00012-44.jpg,139,130,127,3,12,0.9769230769230768,0.9136690647482014
2022,ONAGRI,CITRUS VOLKAMERIANA,101050,IMG-00002-44.jpg,95,92,88,4,7,0.9565217391304348,0.9263157894736842
2022,ONAGRI,CITRUS VOLKAMERIANA,101050,IMG-00005-44.jpg,59,55,55,0,4,1.0,0.9322033898305084
2022,ONAGRI,CITRUS VOLKAMERIANA,101050,IMG-00011-44.jpg,46,43,42,1,4,0.9767441860465116,0.9130434782608696
2022,ONAGRI,CITRUS VOLKAMERIANA,101050,IMG-00024-44.jpg,40,42,40,2,0,0.9523809523809524,1.0
2022,ONAGRI,CITRUS VOLKAMERIANA,101080,IMG-00005-44.jpg,42,39,38,1,4,0.9743589743589745,0.9047619047619048
2022,ONAGRI,CITRUS VOLKAMERIANA,101080,IMG-00006-44.jpg,79,71,68,3,11,0.9577464788732394,0.8607594936708861
2022,ONAGRI,CITRUS VOLKAMERIANA,101080,IMG-00023-44.jpg,7,8,7,1,0,0.875,1.0
2022,ONAGRI,CITRUS VOLKAMERIANA,101080,IMG-00024-44.jpg,27,26,25,1,2,0.9615384615384616,0.925925925925926
2022,ONAGRI,CITRUS VOLKAMERIANA,101090,IMG-00003-44.jpg,66,63,61,2,5,0.9682539682539684,0.9242424242424242
2022,ONAGRI,CITRUS VOLKAMERIANA,101090,IMG-00006-44.jpg,41,34,33,1,8,0.9705882352941176,0.8048780487804879
2022,ONAGRI,CITRUS VOLKAMERIANA,101090,IMG-00019-44.jpg,35,35,34,1,1,0.9714285714285714,0.9714285714285714
2022,ONAGRI,CITRUS VOLKAMERIANA,101090,IMG-00020-44.jpg,42,41,40,1,2,0.975609756097561,0.9523809523809524
2022,KHOUALKA,CITRANGE CARRIZO,102130,IMG-00001.jpg,5,5,4,1,1,0.8,0.8
2022,KHOUALKA,CITRANGE CARRIZO,102130,IMG-00004-43.jpg,24,17,17,0,7,1.0,0.7083333333333334
2022,KHOUALKA,CITRANGE CARRIZO,102130,IMG-00019-43.jpg,33,35,32,3,1,0.9142857142857144,0.9696969696969696
2022,KHOUALKA,CITRANGE CARRIZO,102130,IMG-00020-43.jpg,18,24,16,8,2,0.6666666666666666,0.8888888888888888
2022,KHOUALKA,MACROPHYLLA,201180,IMG-00007-43.jpg,38,42,38,4,0,0.9047619047619048,1.0
2022,KHOUALKA,MACROPHYLLA,201180,IMG-00011-43.jpg,64,65,60,5,4,0.9230769230769232,0.9375
2022,KHOUALKA,MACROPHYLLA,201180,IMG-00019-43.jpg,64,59,58,1,6,0.9830508474576272,0.90625
2022,KHOUALKA,MACROPHYLLA,201180,IMG-00020-43.jpg,43,42,40,2,3,0.9523809523809524,0.9302325581395348
2022,KHOUALKA,MACROPHYLLA,201190,IMG-00004-43.jpg,101,94,91,3,10,0.9680851063829788,0.900990099009901
2022,KHOUALKA,MACROPHYLLA,201190,IMG-00010-43.jpg,90,85,80,5,10,0.9411764705882352,0.8888888888888888
2022,KHOUALKA,MACROPHYLLA,201190,IMG-00011-43.jpg,134,120,119,1,15,0.9916666666666668,0.8880597014925373
2022,KHOUALKA,MACROPHYLLA,201190,IMG-00020-43.jpg,95,81,81,0,14,1.0,0.8526315789473684
2022,KHOUALKA,CITRUS VOLKAMERIANA,201210,IMG-00011-43.jpg,103,98,98,0,5,1.0,0.9514563106796116
2022,KHOUALKA,CITRUS VOLKAMERIANA,201210,IMG-00012-43.jpg,42,41,41,0,1,1.0,0.9761904761904762
2022,KHOUALKA,CITRUS VOLKAMERIANA,201210,IMG-00015-43.jpg,77,68,68,0,9,1.0,0.8831168831168831
2022,KHOUALKA,CITRUS VOLKAMERIANA,201210,IMG-00019-43.jpg,31,30,30,0,1,1.0,0.967741935483871
2022,KHOUALKA,BIGARADIER,201320,IMG-00006-43.jpg,87,70,69,1,18,0.9857142857142858,0.7931034482758621
2022,KHOUALKA,BIGARADIER,201320,IMG-00016-43.jpg,97,92,87,5,10,0.9456521739130436,0.8969072164948454
2022,KHOUALKA,BIGARADIER,201320,IMG-00017-43.jpg,49,46,46,0,3,1.0,0.9387755102040816
2022,KHOUALKA,BIGARADIER,201320,IMG-00020-43.jpg,88,88,87,1,1,0.9886363636363636,0.9886363636363636
2022,ONAGRI,BIGARADIER,201390,IMG-00008-44.jpg,62,63,60,3,2,0.9523809523809524,0.967741935483871
2022,ONAGRI,BIGARADIER,201390,IMG-00011-44.jpg,90,84,84,0,6,1.0,0.9333333333333332
2022,ONAGRI,BIGARADIER,201390,IMG-00013-44.jpg,77,57,54,3,23,0.9473684210526316,0.7012987012987013
2022,ONAGRI,BIGARADIER,201390,IMG-00016-44.jpg,69,65,64,1,5,0.9846153846153848,0.927536231884058
2022,KHOUALKA,CITRUS VOLKAMERIANA,202050,IMG-00006-43.jpg,89,86,86,0,3,1.0,0.9662921348314608
2022,KHOUALKA,CITRUS VOLKAMERIANA,202050,IMG-00010-43.jpg,94,90,89,1,5,0.9888888888888888,0.946808510638298
2022,KHOUALKA,CITRUS VOLKAMERIANA,202050,IMG-00011-43.jpg,151,143,141,2,10,0.986013986013986,0.933774834437086
2022,KHOUALKA,CITRUS VOLKAMERIANA,202050,IMG-00020-43.jpg,129,118,116,2,13,0.9830508474576272,0.8992248062015504
2022,KHOUALKA,CITRUS VOLKAMERIANA,202070,IMG-00006-43.jpg,68,66,64,2,4,0.9696969696969696,0.9411764705882352
2022,KHOUALKA,CITRUS VOLKAMERIANA,202070,IMG-00009-43.jpg,120,119,116,3,4,0.9747899159663864,0.9666666666666668
2022,KHOUALKA,CITRUS VOLKAMERIANA,202070,IMG-00013-43.jpg,95,89,89,0,6,1.0,0.936842105263158
2022,KHOUALKA,CITRUS VOLKAMERIANA,202070,IMG-00019-43.jpg,57,57,55,2,2,0.9649122807017544,0.9649122807017544
2022,KHOUALKA,CITRUS VOLKAMERIANA,202080,IMG-00005-43.jpg,65,64,63,1,2,0.984375,0.9692307692307692
2022,KHOUALKA,CITRUS VOLKAMERIANA,202080,IMG-00008-43.jpg,31,32,31,1,0,0.96875,1.0
2022,KHOUALKA,CITRUS VOLKAMERIANA,202080,IMG-00015-43.jpg,220,217,211,6,9,0.9723502304147466,0.9590909090909092
2022,KHOUALKA,CITRUS VOLKAMERIANA,202080,IMG-00016-43.jpg,131,129,126,3,5,0.9767441860465116,0.9618320610687024
2022,KHOUALKA,CITRANGE CARRIZO,301380,IMG-00007-43.jpg,30,27,26,1,4,0.9629629629629628,0.8666666666666667
2022,KHOUALKA,CITRANGE CARRIZO,301380,IMG-00011-43.jpg,53,55,52,3,1,0.9454545454545454,0.981132075471698
2022,KHOUALKA,CITRANGE CARRIZO,301380,IMG-00014-43.jpg,7,6,5,1,2,0.8333333333333334,0.7142857142857143
2022,KHOUALKA,CITRANGE CARRIZO,301380,IMG-00020-43.jpg,91,97,85,12,6,0.8762886597938144,0.934065934065934
2022,ONAGRI,CITRUS VOLKAMERIANA,301470,IMG-00003-44.jpg,148,146,142,4,6,0.9726027397260274,0.9594594594594594
2022,ONAGRI,CITRUS VOLKAMERIANA,301470,IMG-00004-44.jpg,163,165,158,7,5,0.9575757575757576,0.9693251533742332
2022,ONAGRI,CITRUS VOLKAMERIANA,301470,IMG-00005-44.jpg,160,148,144,4,16,0.972972972972973,0.9
2022,ONAGRI,CITRUS VOLKAMERIANA,301480,IMG-00001.jpg,92,78,78,0,14,1.0,0.8478260869565217
2022,ONAGRI,CITRUS VOLKAMERIANA,301480,IMG-00003-43.jpg,26,24,24,0,2,1.0,0.9230769230769232
2022,ONAGRI,CITRUS VOLKAMERIANA,301480,IMG-00012-43.jpg,50,44,43,1,7,0.9772727272727272,0.86
2022,ONAGRI,CITRUS VOLKAMERIANA,301480,IMG-00014-43.jpg,77,69,69,0,8,1.0,0.8961038961038961
2022,ONAGRI,CITRUS VOLKAMERIANA,301490,IMG-00005-44.jpg,108,94,93,1,15,0.9893617021276596,0.8611111111111112
2022,ONAGRI,CITRUS VOLKAMERIANA,301490,IMG-00009-44.jpg,185,171,165,6,20,0.9649122807017544,0.8918918918918919
2022,ONAGRI,CITRUS VOLKAMERIANA,301490,IMG-00012-44.jpg,162,146,143,3,19,0.9794520547945206,0.8827160493827161
2022,ONAGRI,CITRUS VOLKAMERIANA,301490,IMG-00015-44.jpg,109,101,100,1,9,0.99009900990099,0.9174311926605504
2022,ONAGRI,CITRUS VOLKAMERIANA,301510,IMG-00001.jpg,252,223,223,0,29,1.0,0.8849206349206349
2022,ONAGRI,CITRUS VOLKAMERIANA,301510,IMG-00006-44.jpg,137,130,127,3,10,0.9769230769230768,0.927007299270073
2022,ONAGRI,CITRUS VOLKAMERIANA,301510,IMG-00007-44.jpg,115,114,105,9,10,0.9210526315789472,0.9130434782608696
2022,ONAGRI,CITRUS VOLKAMERIANA,301510,IMG-00008-44.jpg,150,137,132,5,18,0.9635036496350364,0.88
2022,ONAGRI,BIGARADIER,301550,IMG-00008-44.jpg,144,136,133,3,11,0.9779411764705882,0.9236111111111112
2022,ONAGRI,BIGARADIER,301550,IMG-00011-44.jpg,40,38,35,3,5,0.9210526315789472,0.875
2022,ONAGRI,BIGARADIER,301550,IMG-00013-44.jpg,76,71,71,0,5,1.0,0.9342105263157896
2022,ONAGRI,BIGARADIER,301550,IMG-00014-44.jpg,80,82,75,7,5,0.9146341463414634,0.9375
2022,ONAGRI,CITRUS VOLKAMERIANA,301570,IMG-00004-44.jpg,158,146,144,2,14,0.9863013698630136,0.9113924050632912
2022,ONAGRI,CITRUS VOLKAMERIANA,301570,IMG-00007-44.jpg,152,136,132,4,20,0.9705882352941176,0.868421052631579
2022,ONAGRI,CITRUS VOLKAMERIANA,301570,IMG-00008-44.jpg,103,96,87,9,16,0.90625,0.8446601941747572
2022,ONAGRI,CITRUS VOLKAMERIANA,301570,IMG-00017-44.jpg,218,203,197,6,21,0.9704433497536946,0.9036697247706422
2022,KHOUALKA,CITRUS VOLKAMERIANA,302340,IMG-00004-43.jpg,106,87,86,1,20,0.9885057471264368,0.8113207547169812
2022,KHOUALKA,CITRUS VOLKAMERIANA,302340,IMG-00005-43.jpg,105,86,86,0,19,1.0,0.819047619047619
2022,KHOUALKA,CITRUS VOLKAMERIANA,302340,IMG-00011-43.jpg,75,67,67,0,8,1.0,0.8933333333333333
2022,KHOUALKA,CITRUS VOLKAMERIANA,302340,IMG-00015-43.jpg,92,83,81,2,11,0.9759036144578314,0.8804347826086957
2022,KHOUALKA,CITRUS VOLKAMERIANA,302350,IMG-00008-43.jpg,33,31,30,1,3,0.967741935483871,0.9090909090909092
2022,KHOUALKA,CITRUS VOLKAMERIANA,302350,IMG-00013-43.jpg,80,73,71,2,9,0.9726027397260274,0.8875
2022,KHOUALKA,CITRUS VOLKAMERIANA,302350,IMG-00014-43.jpg,76,70,67,3,9,0.9571428571428572,0.881578947368421
2022,KHOUALKA,CITRUS VOLKAMERIANA,302350,IMG-00018-43.jpg,44,44,42,2,2,0.9545454545454546,0.9545454545454546
2022,KHOUALKA,CITRUS VOLKAMERIANA,302360,IMG-00005-43.jpg,97,95,93,2,4,0.9789473684210528,0.9587628865979382
2022,KHOUALKA,CITRUS VOLKAMERIANA,302360,IMG-00006-43.jpg,118,110,109,1,9,0.990909090909091,0.923728813559322
2022,KHOUALKA,CITRUS VOLKAMERIANA,302360,IMG-00016-43.jpg,67,62,62,0,5,1.0,0.9253731343283582
2022,KHOUALKA,CITRUS VOLKAMERIANA,302360,IMG-00021-43.jpg,65,65,64,1,1,0.9846153846153848,0.9846153846153848
2022,KHOUALKA,CITRUS VOLKAMERIANA,302510,IMG-00001.jpg,73,64,63,1,10,0.984375,0.863013698630137
2022,KHOUALKA,CITRUS VOLKAMERIANA,302510,IMG-00002-43.jpg,44,39,38,1,6,0.9743589743589745,0.8636363636363636
2022,KHOUALKA,CITRUS VOLKAMERIANA,302510,IMG-00003-43.jpg,78,75,74,1,4,0.9866666666666668,0.9487179487179488
2022,KHOUALKA,CITRUS VOLKAMERIANA,302510,IMG-00015-43.jpg,49,35,35,0,14,1.0,0.7142857142857143
2022,KHOUALKA,BIGARADIER,401410,IMG-00093-43.jpg,35,26,25,1,10,0.9615384615384616,0.7142857142857143
2022,KHOUALKA,BIGARADIER,401410,IMG-00099-43.jpg,6,5,5,0,1,1.0,0.8333333333333334
2022,KHOUALKA,BIGARADIER,401410,IMG-00102-43.jpg,78,66,66,0,12,1.0,0.8461538461538461
2022,KHOUALKA,BIGARADIER,401410,IMG-00104-43.jpg,81,65,61,4,20,0.9384615384615383,0.7530864197530864
2022,ONAGRI,CITRANGE C35,401660,IMG-00001.jpg,56,58,54,4,2,0.9310344827586208,0.9642857142857144
2022,ONAGRI,CITRANGE C35,401660,IMG-00008-44.jpg,42,38,38,0,4,1.0,0.9047619047619048
2022,ONAGRI,CITRANGE C35,401660,IMG-00010-44.jpg,29,25,25,0,4,1.0,0.8620689655172413
2022,ONAGRI,CITRANGE C35,401660,IMG-00016-44.jpg,64,62,59,3,5,0.9516129032258064,0.921875
2022,ONAGRI,CITRANGE C35,401710,IMG-00003-44.jpg,51,42,42,0,9,1.0,0.8235294117647058
2022,ONAGRI,CITRANGE C35,401710,IMG-00012-44.jpg,19,19,19,0,0,1.0,1.0
2022,ONAGRI,CITRANGE C35,401710,IMG-00013-44.jpg,33,28,27,1,6,0.9642857142857144,0.8181818181818182
2022,ONAGRI,CITRANGE C35,401710,IMG-00019-44.jpg,76,72,72,0,4,1.0,0.9473684210526316
2022,ONAGRI,CITRANGE C35,401720,IMG-00007-44.jpg,93,99,93,6,0,0.9393939393939394,1.0
2022,ONAGRI,CITRANGE C35,401720,IMG-00008-44.jpg,38,39,36,3,2,0.9230769230769232,0.9473684210526316
2022,ONAGRI,CITRANGE C35,401720,IMG-00010-44.jpg,50,45,45,0,5,1.0,0.9
2022,ONAGRI,CITRANGE C35,401720,IMG-00017-44.jpg,68,63,61,2,7,0.9682539682539684,0.8970588235294118
2022,ONAGRI,CITRANGE C35,401730,IMG-00001.jpg,19,19,19,0,0,1.0,1.0
2022,ONAGRI,CITRANGE C35,401730,IMG-00010-44.jpg,50,50,50,0,0,1.0,1.0
2022,ONAGRI,CITRANGE C35,401730,IMG-00013-44.jpg,75,69,68,1,7,0.9855072463768116,0.9066666666666666
2022,ONAGRI,CITRANGE C35,401730,IMG-00016-44.jpg,36,34,34,0,2,1.0,0.9444444444444444
2022,ONAGRI,CITRANGE C35,401750,IMG-00005-44.jpg,88,72,71,1,17,0.9861111111111112,0.8068181818181818
2022,ONAGRI,CITRANGE C35,401750,IMG-00009-44.jpg,127,113,109,4,18,0.9646017699115044,0.8582677165354331
2022,ONAGRI,CITRANGE C35,401750,IMG-00016-44.jpg,107,94,91,3,16,0.9680851063829788,0.8504672897196262
2022,ONAGRI,CITRANGE C35,401750,IMG-00024-44.jpg,50,42,39,3,11,0.9285714285714286,0.78
2022,ONAGRI,CITRUMELO SACCATON,401770,IMG-00003-44.jpg,24,26,24,2,0,0.9230769230769232,1.0
2022,ONAGRI,CITRUMELO SACCATON,401770,IMG-00008-44.jpg,72,74,70,4,2,0.945945945945946,0.9722222222222222
2022,ONAGRI,CITRUMELO SACCATON,401770,IMG-00009-44.jpg,14,13,13,0,1,1.0,0.9285714285714286
2022,ONAGRI,CITRUMELO SACCATON,401770,IMG-00017-44.jpg,20,16,16,0,4,1.0,0.8
2022,KHOUALKA,BIGARADIER,402440,IMG-00005-43.jpg,17,14,14,0,3,1.0,0.8235294117647058
2022,KHOUALKA,BIGARADIER,402440,IMG-00012-43.jpg,46,38,38,0,8,1.0,0.8260869565217391
2022,KHOUALKA,BIGARADIER,402440,IMG-00014-43.jpg,11,10,10,0,1,1.0,0.9090909090909092
2022,KHOUALKA,BIGARADIER,402440,IMG-00015-43.jpg,22,12,12,0,10,1.0,0.5454545454545454
2022,KHOUALKA,BIGARADIER,402590,IMG-00007-43.jpg,104,89,88,1,16,0.9887640449438202,0.8461538461538461
2022,KHOUALKA,BIGARADIER,402590,IMG-00012-43.jpg,45,44,43,1,2,0.9772727272727272,0.9555555555555556
2022,KHOUALKA,BIGARADIER,402590,IMG-00015-43.jpg,58,58,54,4,4,0.9310344827586208,0.9310344827586208
2022,KHOUALKA,BIGARADIER,402590,IMG-00019-43.jpg,64,64,64,0,0,1.0,1.0
2022,KHOUALKA,CITRUS VOLKAMERIANA,501520,IMG-00004-43.jpg,39,37,36,1,3,0.972972972972973,0.9230769230769232
2022,KHOUALKA,CITRUS VOLKAMERIANA,501520,IMG-00007-43.jpg,43,38,38,0,5,1.0,0.8837209302325582
2022,KHOUALKA,CITRUS VOLKAMERIANA,501520,IMG-00015-43.jpg,18,9,9,0,9,1.0,0.5
2022,KHOUALKA,CITRUS VOLKAMERIANA,501520,IMG-00020-43.jpg,48,43,43,0,5,1.0,0.8958333333333334
2022,KHOUALKA,CITRUS VOLKAMERIANA,501540,IMG-00006-43.jpg,38,35,35,0,3,1.0,0.9210526315789472
2022,KHOUALKA,CITRUS VOLKAMERIANA,501540,IMG-00012-43.jpg,102,99,95,4,7,0.9595959595959596,0.931372549019608
2022,KHOUALKA,CITRUS VOLKAMERIANA,501540,IMG-00017-43.jpg,138,128,124,4,14,0.96875,0.8985507246376812
2022,KHOUALKA,CITRUS VOLKAMERIANA,501540,IMG-00018-43.jpg,51,50,49,1,2,0.98,0.9607843137254902
2022,KHOUALKA,CITRUS VOLKAMERIANA,501660,IMG-00006-43.jpg,60,60,58,2,2,0.9666666666666668,0.9666666666666668
2022,KHOUALKA,CITRUS VOLKAMERIANA,501660,IMG-00016-43.jpg,63,57,56,1,7,0.9824561403508772,0.8888888888888888
2022,KHOUALKA,CITRUS VOLKAMERIANA,501660,IMG-00018-43.jpg,112,95,91,4,21,0.9578947368421052,0.8125
2022,KHOUALKA,CITRUS VOLKAMERIANA,501660,IMG-00021-43.jpg,90,90,88,2,2,0.9777777777777776,0.9777777777777776
2022,KHOUALKA,CITRUS VOLKAMERIANA,501680,IMG-00005-43.jpg,179,168,167,1,12,0.9940476190476192,0.9329608938547486
2022,KHOUALKA,CITRUS VOLKAMERIANA,501680,IMG-00011-43.jpg,101,85,84,1,17,0.9882352941176472,0.8316831683168316
2022,KHOUALKA,CITRUS VOLKAMERIANA,501680,IMG-00012-43.jpg,76,67,66,1,10,0.9850746268656716,0.868421052631579
2022,KHOUALKA,CITRUS VOLKAMERIANA,501680,IMG-00016-43.jpg,113,100,99,1,14,0.99,0.8761061946902655
2022,KHOUALKA,CITRUS VOLKAMERIANA,501690,IMG-00032-43.jpg,34,31,30,1,4,0.967741935483871,0.8823529411764706
2022,KHOUALKA,CITRUS VOLKAMERIANA,501690,IMG-00039-43.jpg,186,175,172,3,14,0.9828571428571428,0.9247311827956988
2022,KHOUALKA,CITRUS VOLKAMERIANA,501690,IMG-00047-43.jpg,103,88,87,1,16,0.9886363636363636,0.8446601941747572
2022,KHOUALKA,CITRUS VOLKAMERIANA,501690,IMG-00049-43.jpg,166,154,154,0,12,1.0,0.927710843373494
2022,KHOUALKA,CITRUS VOLKAMERIANA,501760,IMG-00001.jpg,94,74,73,1,21,0.9864864864864864,0.776595744680851
2022,KHOUALKA,CITRUS VOLKAMERIANA,501760,IMG-00034-43.jpg,45,36,34,2,11,0.9444444444444444,0.7555555555555555
2022,KHOUALKA,CITRUS VOLKAMERIANA,501760,IMG-00036-43.jpg,40,31,31,0,9,1.0,0.775
2022,KHOUALKA,CITRUS VOLKAMERIANA,501760,IMG-00051-43.jpg,92,81,79,2,13,0.9753086419753086,0.8586956521739131
2022,ONAGRI,CITRUMELO SACCATON,510910,IMG-00004-44.jpg,73,70,67,3,6,0.9571428571428572,0.9178082191780822
2022,ONAGRI,CITRUMELO SACCATON,510910,IMG-00008-44.jpg,152,135,134,1,18,0.9925925925925926,0.881578947368421
2022,ONAGRI,CITRUMELO SACCATON,510910,IMG-00010-44.jpg,107,96,94,2,13,0.9791666666666666,0.8785046728971962
2022,ONAGRI,CITRUMELO SACCATON,510910,IMG-00011-44.jpg,92,89,86,3,6,0.9662921348314608,0.9347826086956522
2022,ONAGRI,CITRUMELO SACCATON,510950,IMG-00006-44.jpg,70,66,66,0,4,1.0,0.9428571428571428
2022,ONAGRI,CITRUMELO SACCATON,510950,IMG-00008-44.jpg,75,71,68,3,7,0.9577464788732394,0.9066666666666666
2022,ONAGRI,CITRUMELO SACCATON,510950,IMG-00009-44.jpg,85,77,76,1,9,0.987012987012987,0.8941176470588236
2022,ONAGRI,CITRUMELO SACCATON,510950,IMG-00011-44.jpg,135,122,121,1,14,0.9918032786885246,0.8962962962962963
2022,ONAGRI,MC PONSIRUCE TRIFOLIATA,510980,IMG-00014-44.jpg,67,66,62,4,5,0.9393939393939394,0.9253731343283582
2022,ONAGRI,MC PONSIRUCE TRIFOLIATA,510980,IMG-00015-44.jpg,51,51,49,2,2,0.9607843137254902,0.9607843137254902
2022,ONAGRI,MC PONSIRUCE TRIFOLIATA,510980,IMG-00016-44.jpg,99,91,89,2,10,0.978021978021978,0.898989898989899
2022,ONAGRI,MC PONSIRUCE TRIFOLIATA,510980,IMG-00019-44.jpg,102,91,89,2,13,0.978021978021978,0.8725490196078431
2022,ONAGRI,MC PONSIRUCE TRIFOLIATA,510990,IMG-00006-44.jpg,135,115,115,0,20,1.0,0.8518518518518519
2022,ONAGRI,MC PONSIRUCE TRIFOLIATA,510990,IMG-00008-44.jpg,110,107,104,3,6,0.97196261682243,0.9454545454545454
2022,ONAGRI,MC PONSIRUCE TRIFOLIATA,510990,IMG-00009-44.jpg,85,70,70,0,15,1.0,0.8235294117647058
2022,ONAGRI,MC PONSIRUCE TRIFOLIATA,510990,IMG-00024-44.jpg,65,61,59,2,6,0.9672131147540984,0.9076923076923076
2022,ONAGRI,MC PONSIRUCE TRIFOLIATA,511030,IMG-00007-44.jpg,100,88,87,1,13,0.9886363636363636,0.87
2022,ONAGRI,MC PONSIRUCE TRIFOLIATA,511030,IMG-00016-44.jpg,63,60,57,3,6,0.95,0.9047619047619048
2022,ONAGRI,MC PONSIRUCE TRIFOLIATA,511030,IMG-00022-44.jpg,98,93,89,4,9,0.956989247311828,0.9081632653061223
2022,ONAGRI,MC PONSIRUCE TRIFOLIATA,511030,IMG-00027-44.jpg,82,78,77,1,5,0.9871794871794872,0.9390243902439024
2022,ONAGRI,MS PONSIRUCE TRIFOLIATA,511040,IMG-00004-44.jpg,77,69,68,1,9,0.9855072463768116,0.8831168831168831
2022,ONAGRI,MS PONSIRUCE TRIFOLIATA,511040,IMG-00014-44.jpg,48,43,40,3,8,0.9302325581395348,0.8333333333333334
2022,ONAGRI,MS PONSIRUCE TRIFOLIATA,511040,IMG-00016-44.jpg,71,70,67,3,4,0.9571428571428572,0.943661971830986
2022,ONAGRI,MS PONSIRUCE TRIFOLIATA,511040,IMG-00025-44.jpg,56,49,46,3,10,0.9387755102040816,0.8214285714285714
2022,ONAGRI,FUZHU,511050,IMG-00004-44.jpg,109,104,99,5,10,0.9519230769230768,0.908256880733945
2022,ONAGRI,FUZHU,511050,IMG-00006-44.jpg,142,125,121,4,21,0.968,0.852112676056338
2022,ONAGRI,FUZHU,511050,IMG-00011-44.jpg,172,164,162,2,10,0.9878048780487804,0.9418604651162792
2022,ONAGRI,FUZHU,511050,IMG-00022-44.jpg,194,173,172,1,22,0.9942196531791908,0.8865979381443299
2022,ONAGRI,MS PONSIRUCE TRIFOLIATA,511060,IMG-00007-44.jpg,115,111,110,1,5,0.990990990990991,0.9565217391304348
2022,ONAGRI,MS PONSIRUCE TRIFOLIATA,511060,IMG-00016-44.jpg,102,93,91,2,11,0.978494623655914,0.8921568627450981
2022,ONAGRI,MS PONSIRUCE TRIFOLIATA,511060,IMG-00017-44.jpg,59,57,57,0,2,1.0,0.9661016949152542
2022,ONAGRI,MS PONSIRUCE TRIFOLIATA,511060,IMG-00019-44.jpg,108,95,94,1,14,0.9894736842105264,0.8703703703703703
2022,ONAGRI,FUZHU,511070,IMG-00006-44.jpg,82,82,79,3,3,0.9634146341463414,0.9634146341463414
2022,ONAGRI,FUZHU,511070,IMG-00016-44.jpg,96,89,84,5,12,0.9438202247191012,0.875
2022,ONAGRI,FUZHU,511070,IMG-00018-44.jpg,93,91,89,2,4,0.978021978021978,0.956989247311828
2022,ONAGRI,FUZHU,511070,IMG-00019-44.jpg,142,132,128,4,14,0.9696969696969696,0.9014084507042254
