compagnie,Domaine,Porte-greffe,parcelle,Filename,True_count,detect_count,TP,FP,FN,Precision,Recall
2022,SAOUDA,BIGARADIER,10010,IMG-00011-45.jpg,28,39,28,11,0,0.717948717948718,1.0
2022,SAOUDA,BIGARADIER,10010,IMG-00012-45.jpg,27,34,26,8,1,0.7647058823529411,0.9629629629629628
2022,SAOUDA,BIGARADIER,10010,IMG-00014-45.jpg,50,58,48,10,2,0.8275862068965517,0.96
2022,SAOUDA,BIGARADIER,10010,IMG-00018-45.jpg,30,37,29,8,1,0.7837837837837838,0.9666666666666668
2022,SAOUDA,BIGARADIER,10010,IMG-00020-45.jpg,31,42,31,11,0,0.7380952380952381,1.0
2024,SAOUDA,BIGARADIER,10010,IMG-23410.jpg,85,68,63,5,22,0.9264705882352942,0.7411764705882353
2024,SAOUDA,BIGARADIER,10010,IMG-23417.jpg,86,63,63,0,23,1.0,0.7325581395348837
2024,SAOUDA,BIGARADIER,10010,IMG-23430.jpg,74,62,62,0,12,1.0,0.8378378378378378
2024,SAOUDA,BIGARADIER,10010,IMG-23647.jpg,95,84,82,2,13,0.9761904761904762,0.8631578947368421
2024,SAOUDA,BIGARADIER,10010,IMG-23672.jpg,47,22,22,0,25,1.0,0.4680851063829787
2024,SAOUDA,BIGARADIER,10010,IMG-23707.jpg,30,25,25,0,5,1.0,0.8333333333333334
2024,SAOUDA,BIGARADIER,10010,IMG-23709.jpg,31,24,24,0,7,1.0,0.7741935483870968
2024,SAOUDA,BIGARADIER,10010,IMG-23711.jpg,79,58,55,3,24,0.9482758620689656,0.6962025316455697
2022,SAOUDA,MACROPHYLLA,10030,IMG-00158-45.jpg,101,133,100,33,1,0.7518796992481203,0.99009900990099
2022,SAOUDA,MACROPHYLLA,10030,IMG-00159-45.jpg,155,192,153,39,2,0.796875,0.9870967741935484
2022,SAOUDA,MACROPHYLLA,10030,IMG-00162-45.jpg,119,149,118,31,1,0.7919463087248322,0.9915966386554622
2022,SAOUDA,MACROPHYLLA,10030,IMG-00169-45.jpg,72,97,71,26,1,0.7319587628865979,0.9861111111111112
2022,SAOUDA,MACROPHYLLA,10031,IMG-00002-45.jpg,46,56,45,11,1,0.8035714285714286,0.9782608695652174
2022,SAOUDA,MACROPHYLLA,10031,IMG-00084-45.jpg,41,56,41,15,0,0.7321428571428571,1.0
2022,SAOUDA,MACROPHYLLA,10031,IMG-00450-45.jpg,27,41,26,15,1,0.6341463414634146,0.9629629629629628
2022,SAOUDA,MACROPHYLLA,10031,IMG-00451-45.jpg,34,44,33,11,1,0.75,0.9705882352941176
2022,SAOUDA,MACROPHYLLA,10031,IMG-00464-45.jpg,33,41,32,9,1,0.7804878048780488,0.9696969696969696
2022,ONAGRI,CITRUS VOLKAMERIANA,10101,IMG-00003-39.jpg,120,123,113,10,7,0.91869918699187,0.9416666666666668
2022,ONAGRI,CITRUS VOLKAMERIANA,10101,IMG-00010-39.jpg,85,83,77,6,8,0.927710843373494,0.9058823529411764
2024,ONAGRI,CITRUS VOLKAMERIANA,10101,IMG-10523.jpg,288,222,222,0,66,1.0,0.7708333333333334
2024,ONAGRI,CITRUS VOLKAMERIANA,10101,IMG-10545.jpg,98,77,76,1,22,0.987012987012987,0.7755102040816326
2024,ONAGRI,CITRUS VOLKAMERIANA,10101,IMG-10558.jpg,143,99,97,2,46,0.9797979797979798,0.6783216783216783
2022,ONAGRI,CITRUS VOLKAMERIANA,10102,IMG-00003-39.jpg,48,43,42,1,6,0.9767441860465116,0.875
2024,ONAGRI,CITRUS VOLKAMERIANA,10102,IMG-10637.jpg,140,117,117,0,23,1.0,0.8357142857142857
2024,ONAGRI,CITRUS VOLKAMERIANA,10102,IMG-10658.jpg,163,137,134,3,29,0.978102189781022,0.8220858895705522
2022,ONAGRI,CITRUS VOLKAMERIANA,10103,IMG-00003-39.jpg,215,200,191,9,24,0.955,0.8883720930232558
2022,ONAGRI,CITRUS VOLKAMERIANA,10103,IMG-00008-39.jpg,195,192,180,12,15,0.9375,0.9230769230769232
2024,ONAGRI,CITRUS VOLKAMERIANA,10103,IMG-10614.jpg,134,120,118,2,16,0.9833333333333332,0.8805970149253731
2024,ONAGRI,CITRUS VOLKAMERIANA,10103,IMG-10630.jpg,213,177,175,2,38,0.9887005649717514,0.8215962441314554
2024,ONAGRI,CITRUS VOLKAMERIANA,10103,IMG-10631.jpg,134,102,102,0,32,1.0,0.7611940298507462
2022,ONAGRI,CITRUS VOLKAMERIANA,10104,IMG-00004-39.jpg,65,62,58,4,7,0.935483870967742,0.8923076923076924
2022,ONAGRI,CITRUS VOLKAMERIANA,10104,IMG-00008-39.jpg,69,65,58,7,11,0.8923076923076924,0.8405797101449275
2024,ONAGRI,CITRUS VOLKAMERIANA,10104,IMG-11267.jpg,22,13,13,0,9,1.0,0.5909090909090909
2024,ONAGRI,CITRUS VOLKAMERIANA,10104,IMG-11327.jpg,128,99,96,3,32,0.9696969696969696,0.75
2024,ONAGRI,CITRUS VOLKAMERIANA,10104,IMG-11347.jpg,118,87,87,0,31,1.0,0.7372881355932204
2024,ONAGRI,CITRUS VOLKAMERIANA,10104,IMG-11366.jpg,351,244,240,4,111,0.9836065573770492,0.6837606837606838
2024,ONAGRI,CITRUS VOLKAMERIANA,10104,IMG-11386.jpg,99,71,71,0,28,1.0,0.7171717171717171
2022,ONAGRI,CITRUS VOLKAMERIANA,10105,IMG-00004-39.jpg,17,16,13,3,4,0.8125,0.7647058823529411
2022,ONAGRI,CITRUS VOLKAMERIANA,10105,IMG-00005-39.jpg,68,71,63,8,5,0.8873239436619719,0.9264705882352942
2022,ONAGRI,CITRUS VOLKAMERIANA,10108,IMG-00003-39.jpg,61,55,52,3,9,0.9454545454545454,0.8524590163934426
2022,ONAGRI,CITRUS VOLKAMERIANA,10108,IMG-00007-39.jpg,69,60,59,1,10,0.9833333333333332,0.855072463768116
2022,ONAGRI,CITRUS VOLKAMERIANA,10109,IMG-00003-39.jpg,4,4,4,0,0,1.0,1.0
2022,ONAGRI,CITRUS VOLKAMERIANA,10109,IMG-00008-39.jpg,105,103,97,6,8,0.941747572815534,0.923809523809524
2022,KHOUALKA,CITRANGE CARRIZO,10213,IMG-00001.jpg,77,89,75,14,2,0.8426966292134831,0.974025974025974
2022,KHOUALKA,CITRANGE CARRIZO,10213,IMG-00005-40.jpg,73,85,71,14,2,0.8352941176470589,0.9726027397260274
2022,KHOUALKA,CITRANGE CARRIZO,10213,IMG-00009-40.jpg,14,19,14,5,0,0.7368421052631579,1.0
2022,KHOUALKA,CITRANGE CARRIZO,10213,IMG-00014-40.jpg,21,24,20,4,1,0.8333333333333334,0.9523809523809524
2022,KHOUALKA,CITRANGE CARRIZO,10213,IMG-00028-40.jpg,47,49,45,4,2,0.9183673469387756,0.9574468085106383
2022,KHOUALKA,CITRANGE CARRIZO,10213,IMG-00034-40.jpg,48,51,47,4,1,0.9215686274509804,0.9791666666666666
2022,KHOUALKA,CITRANGE CARRIZO,10213,IMG-00035-40.jpg,37,42,37,5,0,0.8809523809523809,1.0
2022,KHOUALKA,CITRANGE CARRIZO,10213,IMG-00036-40.jpg,47,54,46,8,1,0.8518518518518519,0.9787234042553192
2022,KHOUALKA,CITRANGE CARRIZO,10213,IMG-00042-40.jpg,22,25,22,3,0,0.88,1.0
2022,KHOUALKA,CITRANGE CARRIZO,10213,IMG-00047-40.jpg,70,73,69,4,1,0.9452054794520548,0.9857142857142858
2022,KHOUALKA,CITRANGE CARRIZO,10213,IMG-00054-40.jpg,33,36,32,4,1,0.8888888888888888,0.9696969696969696
2022,KHOUALKA,CITRANGE CARRIZO,10213,IMG-00055-40.jpg,93,94,89,5,4,0.946808510638298,0.956989247311828
2022,KHOUALKA,CITRANGE CARRIZO,10213,IMG-00061-40.jpg,113,123,109,14,4,0.8861788617886179,0.9646017699115044
2022,KHOUALKA,CITRANGE CARRIZO,10213,IMG-00066-40.jpg,48,50,39,11,9,0.78,0.8125
2022,OUARGHA,MACROPHYLLA,11010,IMG-00001.jpg,40,42,39,3,1,0.9285714285714286,0.975
2022,OUARGHA,MACROPHYLLA,11010,IMG-00015-41.jpg,24,25,21,4,3,0.84,0.875
2022,OUARGHA,MACROPHYLLA,11010,IMG-00019-41.jpg,20,34,20,14,0,0.5882352941176471,1.0
2022,OUARGHA,MACROPHYLLA,11010,IMG-00024-41.jpg,21,25,21,4,0,0.84,1.0
2022,OUARGHA,MACROPHYLLA,11020,IMG-00017-41.jpg,51,59,51,8,0,0.864406779661017,1.0
2022,OUARGHA,MACROPHYLLA,11020,IMG-00018-41.jpg,13,13,13,0,0,1.0,1.0
2022,OUARGHA,CITRANGE CARRIZO,13010,IMG-00067-41.jpg,55,70,54,16,1,0.7714285714285715,0.9818181818181818
2022,OUARGHA,CITRANGE CARRIZO,13010,IMG-00086-41.jpg,49,60,49,11,0,0.8166666666666667,1.0
2022,OUARGHA,CITRANGE CARRIZO,13010,IMG-00194-41.jpg,33,39,33,6,0,0.8461538461538461,1.0
2022,OUARGHA,CITRANGE CARRIZO,13020,IMG-00023-41.jpg,31,37,31,6,0,0.8378378378378378,1.0
2022,OUARGHA,CITRANGE CARRIZO,13020,IMG-00024-41.jpg,18,26,18,8,0,0.6923076923076923,1.0
2022,OUARGHA,CITRANGE CARRIZO,13020,IMG-00039-41.jpg,4,9,4,5,0,0.4444444444444444,1.0
2022,OUARGHA,CITRANGE CARRIZO,13020,IMG-00040-41.jpg,6,13,6,7,0,0.4615384615384616,1.0
2022,OUARGHA,CITRUS VOLKAMERIANA,13030,IMG-00009-41.jpg,18,27,18,9,0,0.6666666666666666,1.0
2022,OUARGHA,CITRUS VOLKAMERIANA,13030,IMG-00013-41.jpg,46,65,46,19,0,0.7076923076923077,1.0
2022,OUARGHA,CITRUS VOLKAMERIANA,13030,IMG-00027-41.jpg,12,27,12,15,0,0.4444444444444444,1.0
2022,OUARGHA,CITRUS VOLKAMERIANA,13030,IMG-00029-41.jpg,18,30,18,12,0,0.6,1.0
2022,OUARGHA,CITRUS VOLKAMERIANA,13030,IMG-00036-41.jpg,16,38,16,22,0,0.4210526315789473,1.0
2022,OUARGHA,CITRUS VOLKAMERIANA,14010,IMG-00008-41.jpg,40,48,40,8,0,0.8333333333333334,1.0
2022,OUARGHA,CITRUS VOLKAMERIANA,14010,IMG-00010-41.jpg,49,54,47,7,2,0.8703703703703703,0.9591836734693876
2022,OUARGHA,CITRUS VOLKAMERIANA,14010,IMG-00011-41.jpg,47,61,47,14,0,0.7704918032786885,1.0
2022,OUARGHA,CITRUS VOLKAMERIANA,14010,IMG-00018-41.jpg,44,58,44,14,0,0.7586206896551724,1.0
2022,KHOUALKA,MACROPHYLLA,20118,IMG-00007-40.jpg,44,47,43,4,1,0.9148936170212766,0.9772727272727272
2022,KHOUALKA,MACROPHYLLA,20118,IMG-00008-40.jpg,115,127,113,14,2,0.889763779527559,0.982608695652174
2022,KHOUALKA,MACROPHYLLA,20118,IMG-00022-40.jpg,113,115,109,6,4,0.9478260869565216,0.9646017699115044
2022,KHOUALKA,MACROPHYLLA,20118,IMG-00033-40.jpg,58,65,57,8,1,0.8769230769230769,0.9827586206896552
2022,KHOUALKA,MACROPHYLLA,20118,IMG-00037-40.jpg,29,32,28,4,1,0.875,0.9655172413793104
2022,KHOUALKA,MACROPHYLLA,20118,IMG-00042-40.jpg,137,149,134,15,3,0.8993288590604027,0.978102189781022
2022,KHOUALKA,MACROPHYLLA,20118,IMG-00046-40.jpg,45,51,45,6,0,0.8823529411764706,1.0
2022,KHOUALKA,MACROPHYLLA,20118,IMG-00050-40.jpg,48,48,44,4,4,0.9166666666666666,0.9166666666666666
2022,KHOUALKA,MACROPHYLLA,20118,IMG-00055-40.jpg,52,58,50,8,2,0.8620689655172413,0.9615384615384616
2022,KHOUALKA,MACROPHYLLA,20118,IMG-00061-40.jpg,120,135,114,21,6,0.8444444444444444,0.95
2022,KHOUALKA,MACROPHYLLA,20118,IMG-00062-40.jpg,63,65,59,6,4,0.9076923076923076,0.9365079365079364
2022,KHOUALKA,MACROPHYLLA,20118,IMG-00063-40.jpg,47,52,43,9,4,0.8269230769230769,0.9148936170212766
2022,KHOUALKA,MACROPHYLLA,20118,IMG-00066-40.jpg,84,88,82,6,2,0.9318181818181818,0.9761904761904762
2024,KHOUALKA,MACROPHYLLA,20118,IMG-12691.jpg,22,14,14,0,8,1.0,0.6363636363636364
2024,KHOUALKA,MACROPHYLLA,20118,IMG-12729.jpg,56,43,43,0,13,1.0,0.7678571428571429
2024,KHOUALKA,MACROPHYLLA,20118,IMG-12735.jpg,88,65,65,0,23,1.0,0.7386363636363636
2024,KHOUALKA,MACROPHYLLA,20118,IMG-12748.jpg,107,73,73,0,34,1.0,0.6822429906542056
2024,KHOUALKA,MACROPHYLLA,20118,IMG-12764.jpg,111,92,90,2,21,0.9782608695652174,0.8108108108108109
2024,KHOUALKA,MACROPHYLLA,20118,IMG-12808.jpg,113,81,78,3,35,0.9629629629629628,0.6902654867256637
2024,KHOUALKA,MACROPHYLLA,20118,IMG-12851.jpg,24,14,14,0,10,1.0,0.5833333333333334
2022,KHOUALKA,MACROPHYLLA,20119,IMG-00005-40.jpg,106,113,102,11,4,0.9026548672566372,0.9622641509433962
2022,KHOUALKA,MACROPHYLLA,20119,IMG-00008-40.jpg,142,157,137,20,5,0.8726114649681529,0.9647887323943662
2022,KHOUALKA,MACROPHYLLA,20119,IMG-00014-40.jpg,132,141,129,12,3,0.9148936170212766,0.9772727272727272
2022,KHOUALKA,BIGARADIER,20132,IMG-00004-40.jpg,181,186,176,10,5,0.946236559139785,0.9723756906077348
2022,KHOUALKA,BIGARADIER,20132,IMG-00025-40.jpg,91,102,89,13,2,0.8725490196078431,0.978021978021978
2022,KHOUALKA,BIGARADIER,20132,IMG-00028-40.jpg,49,52,47,5,2,0.903846153846154,0.9591836734693876
2022,KHOUALKA,BIGARADIER,20132,IMG-00035-40.jpg,103,118,102,16,1,0.864406779661017,0.9902912621359224
2022,KHOUALKA,BIGARADIER,20132,IMG-00039-40.jpg,119,132,116,16,3,0.8787878787878788,0.9747899159663864
2022,KHOUALKA,BIGARADIER,20132,IMG-00046-40.jpg,156,165,152,13,4,0.9212121212121211,0.9743589743589745
2022,KHOUALKA,BIGARADIER,20132,IMG-00051-40.jpg,108,111,104,7,4,0.9369369369369368,0.9629629629629628
2022,KHOUALKA,BIGARADIER,20132,IMG-00055-40.jpg,67,63,61,2,6,0.9682539682539684,0.9104477611940298
2022,KHOUALKA,BIGARADIER,20132,IMG-00058-40.jpg,89,87,85,2,4,0.9770114942528736,0.9550561797752808
2022,KHOUALKA,BIGARADIER,20132,IMG-00059-40.jpg,139,137,129,8,10,0.9416058394160584,0.9280575539568344
2022,KHOUALKA,BIGARADIER,20132,IMG-00060-40.jpg,57,56,52,4,5,0.9285714285714286,0.912280701754386
2022,KHOUALKA,BIGARADIER,20132,IMG-00064-40.jpg,117,127,115,12,2,0.905511811023622,0.9829059829059827
2022,KHOUALKA,BIGARADIER,20132,IMG-00075-40.jpg,69,76,69,7,0,0.9078947368421052,1.0
2022,ONAGRI,BIGARADIER,20139,IMG-00021-39.jpg,93,88,85,3,8,0.9659090909090908,0.913978494623656
2024,KHOUALKA,CITRUS VOLKAMERIANA,20205,IMG-12040.jpg,123,89,86,3,37,0.9662921348314608,0.6991869918699187
2024,KHOUALKA,CITRUS VOLKAMERIANA,20205,IMG-12058.jpg,116,110,109,1,7,0.990909090909091,0.9396551724137931
2022,SAOUDA,CITRUS VOLKAMERIANA,21020,IMG-00033-45.jpg,67,84,66,18,1,0.7857142857142857,0.9850746268656716
2022,SAOUDA,CITRUS VOLKAMERIANA,21020,IMG-00087-45.jpg,21,27,21,6,0,0.7777777777777778,1.0
2022,SAOUDA,CITRUS VOLKAMERIANA,21020,IMG-00138-45.jpg,40,44,39,5,1,0.8863636363636364,0.975
2022,SAOUDA,CITRUS VOLKAMERIANA,21020,IMG-00145-45.jpg,37,43,37,6,0,0.8604651162790697,1.0
2022,SAOUDA,CITRUS VOLKAMERIANA,21020,IMG-00155-45.jpg,38,55,37,18,1,0.6727272727272727,0.9736842105263158
2022,SAOUDA,CITRUS VOLKAMERIANA,21030,IMG-00521-45.jpg,31,42,31,11,0,0.7380952380952381,1.0
2022,SAOUDA,CITRUS VOLKAMERIANA,21030,IMG-00524-45.jpg,71,87,70,17,1,0.8045977011494253,0.9859154929577464
2022,SAOUDA,CITRUS VOLKAMERIANA,21030,IMG-00536-45.jpg,41,62,40,22,1,0.6451612903225806,0.975609756097561
2022,SAOUDA,CITRUS VOLKAMERIANA,21030,IMG-00537-45.jpg,52,67,50,17,2,0.746268656716418,0.9615384615384616
2022,SAOUDA,CITRUS VOLKAMERIANA,22020,IMG-00053-45.jpg,39,55,39,16,0,0.7090909090909091,1.0
2022,SAOUDA,CITRUS VOLKAMERIANA,22020,IMG-00059-45.jpg,46,55,45,10,1,0.8181818181818182,0.9782608695652174
2022,SAOUDA,CITRUS VOLKAMERIANA,22020,IMG-00060-45.jpg,48,56,47,9,1,0.8392857142857143,0.9791666666666666
2022,SAOUDA,CITRUS VOLKAMERIANA,22020,IMG-00062-45.jpg,50,67,50,17,0,0.746268656716418,1.0
2022,SAOUDA,CITRUS VOLKAMERIANA,22030,IMG-00062-45.jpg,62,71,62,9,0,0.8732394366197183,1.0
2022,SAOUDA,CITRUS VOLKAMERIANA,22030,IMG-00063-45.jpg,83,101,82,19,1,0.8118811881188119,0.9879518072289156
2022,SAOUDA,CITRUS VOLKAMERIANA,22030,IMG-00065-45.jpg,58,64,55,9,3,0.859375,0.9482758620689656
2022,SAOUDA,CITRUS VOLKAMERIANA,22030,IMG-00068-45.jpg,66,78,65,13,1,0.8333333333333334,0.9848484848484848
2022,SAOUDA,CITRUS VOLKAMERIANA,23020,IMG-00024-45.jpg,47,57,45,12,2,0.7894736842105263,0.9574468085106383
2022,SAOUDA,CITRUS VOLKAMERIANA,23020,IMG-00032-45.jpg,33,37,33,4,0,0.8918918918918919,1.0
2022,SAOUDA,CITRUS VOLKAMERIANA,23020,IMG-00074-45.jpg,28,32,26,6,2,0.8125,0.9285714285714286
2022,SAOUDA,CITRUS VOLKAMERIANA,23020,IMG-00079-45.jpg,28,41,28,13,0,0.6829268292682927,1.0
2022,SAOUDA,CITRUS VOLKAMERIANA,23030,IMG-00014-45.jpg,25,39,25,14,0,0.6410256410256411,1.0
2022,SAOUDA,CITRUS VOLKAMERIANA,23030,IMG-00034-45.jpg,43,57,41,16,2,0.7192982456140351,0.9534883720930232
2022,SAOUDA,CITRUS VOLKAMERIANA,23030,IMG-00069-45.jpg,28,51,27,24,1,0.5294117647058824,0.9642857142857144
2022,SAOUDA,CITRUS VOLKAMERIANA,23030,IMG-00079-45.jpg,50,75,49,26,1,0.6533333333333333,0.98
2022,SAOUDA,CITRANGE CARRIZO,24010,IMG-00097-45.jpg,59,73,57,16,2,0.7808219178082192,0.9661016949152542
2022,SAOUDA,CITRANGE CARRIZO,24010,IMG-00101-45.jpg,27,35,27,8,0,0.7714285714285715,1.0
2022,SAOUDA,CITRANGE CARRIZO,24010,IMG-00111-45.jpg,54,59,53,6,1,0.8983050847457628,0.9814814814814816
2022,SAOUDA,CITRANGE CARRIZO,24010,IMG-00112-45.jpg,40,53,40,13,0,0.7547169811320755,1.0
2022,SAOUDA,CITRANGE CARRIZO,25010,IMG-00006-45.jpg,55,69,54,15,1,0.782608695652174,0.9818181818181818
2022,SAOUDA,CITRANGE CARRIZO,25010,IMG-00007-45.jpg,77,97,77,20,0,0.7938144329896907,1.0
2022,SAOUDA,CITRANGE CARRIZO,25010,IMG-00010-45.jpg,53,71,53,18,0,0.7464788732394366,1.0
2022,SAOUDA,CITRANGE CARRIZO,25010,IMG-00011-45.jpg,26,31,26,5,0,0.8387096774193549,1.0
2022,SAOUDA,CITRANGE CARRIZO,26010,IMG-00008-45.jpg,39,41,39,2,0,0.951219512195122,1.0
2022,SAOUDA,CITRANGE CARRIZO,26010,IMG-00013-45.jpg,36,45,36,9,0,0.8,1.0
2022,SAOUDA,CITRANGE CARRIZO,26010,IMG-00018-45.jpg,43,53,43,10,0,0.8113207547169812,1.0
2022,SAOUDA,CITRANGE CARRIZO,26010,IMG-00020-45.jpg,44,48,43,5,1,0.8958333333333334,0.9772727272727272
2022,KHOUALKA,CITRANGE CARRIZO,30138,IMG-00002-40.jpg,39,41,38,3,1,0.926829268292683,0.9743589743589745
2022,KHOUALKA,CITRANGE CARRIZO,30138,IMG-00003-40.jpg,59,69,58,11,1,0.8405797101449275,0.9830508474576272
2022,KHOUALKA,CITRANGE CARRIZO,30138,IMG-00005-40.jpg,58,69,57,12,1,0.8260869565217391,0.9827586206896552
2022,KHOUALKA,CITRANGE CARRIZO,30138,IMG-00008-40.jpg,32,34,30,4,2,0.8823529411764706,0.9375
2022,KHOUALKA,CITRANGE CARRIZO,30138,IMG-00011-40.jpg,26,32,26,6,0,0.8125,1.0
2022,KHOUALKA,CITRANGE CARRIZO,30138,IMG-00019-40.jpg,2,2,2,0,0,1.0,1.0
2022,KHOUALKA,CITRANGE CARRIZO,30138,IMG-00037-40.jpg,30,33,27,6,3,0.8181818181818182,0.9
2022,KHOUALKA,CITRANGE CARRIZO,30138,IMG-00040-40.jpg,41,42,40,2,1,0.9523809523809524,0.975609756097561
2022,KHOUALKA,CITRANGE CARRIZO,30138,IMG-00043-40.jpg,28,34,27,7,1,0.7941176470588235,0.9642857142857144
2022,KHOUALKA,CITRANGE CARRIZO,30138,IMG-00044-40.jpg,99,100,96,4,3,0.96,0.9696969696969696
2022,KHOUALKA,CITRANGE CARRIZO,30138,IMG-00048-40.jpg,37,40,34,6,3,0.85,0.918918918918919
2022,KHOUALKA,CITRANGE CARRIZO,30138,IMG-00057-40.jpg,73,77,70,7,3,0.9090909090909092,0.958904109589041
2022,KHOUALKA,CITRANGE CARRIZO,30138,IMG-00063-40.jpg,89,82,79,3,10,0.9634146341463414,0.8876404494382022
2022,ONAGRI,CITRUS VOLKAMERIANA,30145,IMG-00018-39.jpg,219,204,198,6,21,0.9705882352941176,0.9041095890410958
2022,ONAGRI,CITRUS VOLKAMERIANA,30145,IMG-00043-39.jpg,64,64,60,4,4,0.9375,0.9375
2022,ONAGRI,CITRUS VOLKAMERIANA,30146,IMG-00008-39.jpg,262,259,244,15,18,0.942084942084942,0.931297709923664
2022,ONAGRI,CITRUS VOLKAMERIANA,30146,IMG-00045-39.jpg,190,191,179,12,11,0.93717277486911,0.9421052631578948
2022,ONAGRI,CITRUS VOLKAMERIANA,30147,IMG-00002-39.jpg,269,260,248,12,21,0.953846153846154,0.9219330855018588
2022,ONAGRI,CITRUS VOLKAMERIANA,30147,IMG-00008-39.jpg,172,170,163,7,9,0.9588235294117649,0.9476744186046512
2022,ONAGRI,CITRUS VOLKAMERIANA,30148,IMG-00016-40.jpg,88,87,84,3,4,0.9655172413793104,0.9545454545454546
2022,ONAGRI,CITRUS VOLKAMERIANA,30148,IMG-00047-40.jpg,34,33,33,0,1,1.0,0.9705882352941176
2022,ONAGRI,CITRUS VOLKAMERIANA,30149,IMG-00018-39.jpg,151,139,137,2,14,0.9856115107913668,0.9072847682119204
2022,ONAGRI,CITRUS VOLKAMERIANA,30149,IMG-00027-39.jpg,226,202,201,1,25,0.995049504950495,0.8893805309734514
2022,ONAGRI,CITRUS VOLKAMERIANA,30151,IMG-00012-39.jpg,185,164,161,3,24,0.9817073170731708,0.8702702702702703
2022,ONAGRI,CITRUS VOLKAMERIANA,30151,IMG-00033-39.jpg,214,203,194,9,20,0.955665024630542,0.9065420560747663
2024,ONAGRI,CITRUS VOLKAMERIANA,30151,IMG-21881.jpg,73,53,51,2,22,0.9622641509433962,0.6986301369863014
2024,ONAGRI,CITRUS VOLKAMERIANA,30151,IMG-21935.jpg,179,141,139,2,40,0.9858156028368794,0.776536312849162
2024,ONAGRI,CITRUS VOLKAMERIANA,30151,IMG-21936.jpg,93,74,74,0,19,1.0,0.7956989247311828
2022,ONAGRI,CITRUS VOLKAMERIANA,30152,IMG-00016-39.jpg,39,38,36,2,3,0.9473684210526316,0.9230769230769232
2022,ONAGRI,CITRUS VOLKAMERIANA,30152,IMG-00019-39.jpg,139,126,123,3,16,0.9761904761904762,0.8848920863309353
2022,ONAGRI,CITRUS VOLKAMERIANA,30153,IMG-00001.jpg,157,143,138,5,19,0.965034965034965,0.8789808917197452
2022,ONAGRI,CITRUS VOLKAMERIANA,30153,IMG-00007-39.jpg,127,116,112,4,15,0.9655172413793104,0.8818897637795275
2022,ONAGRI,CITRUS VOLKAMERIANA,30153,IMG-00013-39.jpg,159,148,145,3,14,0.9797297297297296,0.9119496855345912
2022,ONAGRI,CITRUS VOLKAMERIANA,30153,IMG-00040-39.jpg,153,141,136,5,17,0.9645390070921984,0.8888888888888888
2022,ONAGRI,CITRUS VOLKAMERIANA,30154,IMG-00017-39.jpg,160,160,154,6,6,0.9625,0.9625
2022,ONAGRI,CITRUS VOLKAMERIANA,30154,IMG-00027-39.jpg,220,220,213,7,7,0.968181818181818,0.968181818181818
2022,ONAGRI,CITRUS VOLKAMERIANA,30154,IMG-00033-39.jpg,51,50,49,1,2,0.98,0.9607843137254902
2022,ONAGRI,CITRUS VOLKAMERIANA,30154,IMG-00036-39.jpg,137,142,133,9,4,0.9366197183098592,0.9708029197080292
2022,ONAGRI,CITRUS VOLKAMERIANA,30154,IMG-00038-39.jpg,242,243,232,11,10,0.9547325102880658,0.9586776859504132
2022,ONAGRI,CITRUS VOLKAMERIANA,30154,IMG-00041-39.jpg,272,260,250,10,22,0.9615384615384616,0.9191176470588236
2022,ONAGRI,CITRUS VOLKAMERIANA,30154,IMG-00044-39.jpg,141,145,134,11,7,0.9241379310344828,0.950354609929078
2022,ONAGRI,BIGARADIER,30155,IMG-00002-39.jpg,139,146,136,10,3,0.9315068493150684,0.9784172661870504
2022,ONAGRI,BIGARADIER,30155,IMG-00003-39.jpg,115,114,107,7,8,0.9385964912280702,0.9304347826086956
2022,ONAGRI,BIGARADIER,30155,IMG-00006-39.jpg,44,45,40,5,4,0.8888888888888888,0.9090909090909092
2022,ONAGRI,BIGARADIER,30155,IMG-00011-39.jpg,100,97,94,3,6,0.9690721649484536,0.94
2022,ONAGRI,BIGARADIER,30155,IMG-00019-39.jpg,142,141,132,9,10,0.9361702127659576,0.9295774647887324
2022,ONAGRI,BIGARADIER,30155,IMG-00026-39.jpg,124,122,116,6,8,0.9508196721311476,0.935483870967742
2022,ONAGRI,BIGARADIER,30155,IMG-00032-39.jpg,81,79,75,4,6,0.9493670886075948,0.925925925925926
2022,ONAGRI,BIGARADIER,30155,IMG-00039-39.jpg,19,19,17,2,2,0.8947368421052632,0.8947368421052632
2022,ONAGRI,BIGARADIER,30155,IMG-00043-39.jpg,130,135,126,9,4,0.9333333333333332,0.9692307692307692
2022,ONAGRI,CITRUS VOLKAMERIANA,30157,IMG-00003-39.jpg,227,219,215,4,12,0.9817351598173516,0.947136563876652
2022,ONAGRI,CITRUS VOLKAMERIANA,30157,IMG-00012-39.jpg,283,275,260,15,23,0.9454545454545454,0.9187279151943464
2022,ONAGRI,CITRUS VOLKAMERIANA,30157,IMG-00032-39.jpg,64,69,61,8,3,0.8840579710144928,0.953125
2022,ONAGRI,CITRUS VOLKAMERIANA,30157,IMG-00035-39.jpg,159,150,144,6,15,0.96,0.9056603773584906
2022,KHOUALKA,CITRUS VOLKAMERIANA,30235,IMG-00001.jpg,93,96,91,5,2,0.9479166666666666,0.978494623655914
2022,KHOUALKA,CITRUS VOLKAMERIANA,30235,IMG-00003-40.jpg,37,41,37,4,0,0.902439024390244,1.0
2022,KHOUALKA,CITRUS VOLKAMERIANA,30235,IMG-00009-40.jpg,103,113,103,10,0,0.911504424778761,1.0
2022,KHOUALKA,CITRUS VOLKAMERIANA,30235,IMG-00013-40.jpg,90,99,89,10,1,0.898989898989899,0.9888888888888888
2022,KHOUALKA,CITRUS VOLKAMERIANA,30235,IMG-00026-40.jpg,122,129,119,10,3,0.9224806201550388,0.9754098360655736
2022,KHOUALKA,CITRUS VOLKAMERIANA,30235,IMG-00047-40.jpg,47,54,45,9,2,0.8333333333333334,0.9574468085106383
2022,KHOUALKA,CITRUS VOLKAMERIANA,30235,IMG-00048-40.jpg,90,99,87,12,3,0.8787878787878788,0.9666666666666668
2022,KHOUALKA,CITRUS VOLKAMERIANA,30235,IMG-00049-40.jpg,44,50,41,9,3,0.82,0.9318181818181818
2022,KHOUALKA,CITRUS VOLKAMERIANA,30235,IMG-00050-40.jpg,84,91,80,11,4,0.8791208791208791,0.9523809523809524
2022,KHOUALKA,CITRUS VOLKAMERIANA,30235,IMG-00052-40.jpg,98,108,98,10,0,0.9074074074074074,1.0
2022,KHOUALKA,CITRUS VOLKAMERIANA,30235,IMG-00057-40.jpg,80,82,74,8,6,0.902439024390244,0.925
2022,KHOUALKA,CITRUS VOLKAMERIANA,30235,IMG-00064-40.jpg,38,44,35,9,3,0.7954545454545454,0.9210526315789472
2022,KHOUALKA,CITRUS VOLKAMERIANA,30235,IMG-00067-40.jpg,107,107,101,6,6,0.9439252336448598,0.9439252336448598
2022,KHOUALKA,CITRUS VOLKAMERIANA,30235,IMG-00069-40.jpg,34,41,34,7,0,0.8292682926829268,1.0
2022,KHOUALKA,CITRUS VOLKAMERIANA,30235,IMG-00075-40.jpg,95,99,90,9,5,0.9090909090909092,0.9473684210526316
2022,KHOUALKA,BIGARADIER,40141,IMG-00006-40.jpg,7,9,6,3,1,0.6666666666666666,0.8571428571428571
2022,KHOUALKA,BIGARADIER,40141,IMG-00007-40.jpg,20,11,11,0,9,1.0,0.55
2022,KHOUALKA,BIGARADIER,40141,IMG-00008-40.jpg,15,16,13,3,2,0.8125,0.8666666666666667
2022,ONAGRI,CITRANGE C35,40166,IMG-00009-39.jpg,38,38,35,3,3,0.9210526315789472,0.9210526315789472
2022,ONAGRI,CITRANGE C35,40166,IMG-00011-39.jpg,173,177,167,10,6,0.943502824858757,0.9653179190751444
2022,ONAGRI,CITRANGE C35,40166,IMG-00014-39.jpg,179,177,171,6,8,0.9661016949152542,0.9553072625698324
2022,ONAGRI,CITRANGE C35,40166,IMG-00015-39.jpg,122,122,114,8,8,0.9344262295081968,0.9344262295081968
2022,ONAGRI,CITRANGE C35,40166,IMG-00041-39.jpg,102,102,100,2,2,0.9803921568627452,0.9803921568627452
2022,ONAGRI,CITRANGE C35,40167,IMG-00019-39.jpg,197,196,192,4,5,0.979591836734694,0.9746192893401016
2022,ONAGRI,CITRANGE C35,40167,IMG-00030-39.jpg,126,124,120,4,6,0.967741935483871,0.9523809523809524
2022,ONAGRI,CITRANGE C35,40167,IMG-00039-39.jpg,217,210,201,9,16,0.9571428571428572,0.9262672811059908
2022,ONAGRI,CITRANGE C35,40171,IMG-00008-39.jpg,109,105,104,1,5,0.9904761904761904,0.9541284403669724
2022,ONAGRI,CITRANGE C35,40171,IMG-00037-39.jpg,94,92,87,5,7,0.9456521739130436,0.925531914893617
2022,ONAGRI,CITRANGE C35,40171,IMG-00040-39.jpg,149,145,138,7,11,0.9517241379310344,0.9261744966442952
2022,ONAGRI,CITRANGE C35,40172,IMG-00012-39.jpg,89,84,82,2,7,0.9761904761904762,0.9213483146067416
2022,ONAGRI,CITRANGE C35,40172,IMG-00025-39.jpg,109,108,103,5,6,0.9537037037037036,0.944954128440367
2022,ONAGRI,CITRANGE C35,40172,IMG-00027-39.jpg,103,94,91,3,12,0.9680851063829788,0.883495145631068
2022,ONAGRI,CITRANGE C35,40173,IMG-00004-39.jpg,133,122,119,3,14,0.9754098360655736,0.8947368421052632
2022,ONAGRI,CITRANGE C35,40173,IMG-00008-39.jpg,57,47,46,1,11,0.9787234042553192,0.8070175438596491
2022,ONAGRI,CITRANGE C35,40173,IMG-00010-39.jpg,53,59,52,7,1,0.8813559322033898,0.981132075471698
2022,ONAGRI,CITRANGE C35,40175,IMG-00005-39.jpg,95,85,83,2,12,0.976470588235294,0.8736842105263158
2022,ONAGRI,CITRANGE C35,40175,IMG-00006-39.jpg,64,64,60,4,4,0.9375,0.9375
2022,ONAGRI,CITRANGE C35,40176,IMG-00004-39.jpg,79,85,74,11,5,0.8705882352941177,0.9367088607594936
2022,ONAGRI,CITRANGE C35,40176,IMG-00012-39.jpg,105,117,103,14,2,0.8803418803418803,0.9809523809523808
2022,ONAGRI,CITRANGE C35,40176,IMG-00014-39.jpg,91,98,85,13,6,0.8673469387755102,0.934065934065934
2022,ONAGRI,CITRUMELO SACCATON,40177,IMG-00012-39.jpg,89,104,87,17,2,0.8365384615384616,0.9775280898876404
2022,ONAGRI,CITRUMELO SACCATON,40177,IMG-00015-39.jpg,213,220,208,12,5,0.9454545454545454,0.976525821596244
2022,ONAGRI,CITRUMELO SACCATON,40177,IMG-00037-39.jpg,95,100,93,7,2,0.93,0.9789473684210528
2022,ONAGRI,CITRANGE C35,40178,IMG-00013-39.jpg,76,77,75,2,1,0.974025974025974,0.986842105263158
2022,ONAGRI,CITRANGE C35,40178,IMG-00027-39.jpg,56,58,55,3,1,0.9482758620689656,0.9821428571428572
2022,ONAGRI,CITRANGE C35,40178,IMG-00031-39.jpg,30,32,30,2,0,0.9375,1.0
2022,ONAGRI,CITRANGE C35,40178,IMG-00032-39.jpg,27,31,27,4,0,0.8709677419354839,1.0
2022,ONAGRI,CITRANGE C35,40178,IMG-00033-39.jpg,34,36,34,2,0,0.9444444444444444,1.0
2022,ONAGRI,CITRANGE C35,40179,IMG-00001.jpg,83,86,80,6,3,0.9302325581395348,0.963855421686747
2022,ONAGRI,CITRANGE C35,40179,IMG-00010-39.jpg,161,161,153,8,8,0.9503105590062112,0.9503105590062112
2022,ONAGRI,CITRANGE C35,40179,IMG-00011-39.jpg,102,102,98,4,4,0.9607843137254902,0.9607843137254902
2022,ONAGRI,CITRANGE C35,40179,IMG-00018-39.jpg,9,11,9,2,0,0.8181818181818182,1.0
2022,ONAGRI,CITRUMELO SACCATON,40182,IMG-00004-39.jpg,35,38,35,3,0,0.9210526315789472,1.0
2022,ONAGRI,CITRUMELO SACCATON,40182,IMG-00010-39.jpg,52,53,50,3,2,0.9433962264150944,0.9615384615384616
2022,ONAGRI,CITRUMELO SACCATON,40182,IMG-00015-39.jpg,85,88,80,8,5,0.9090909090909092,0.9411764705882352
2022,ONAGRI,CITRUMELO SACCATON,40183,IMG-00005-39.jpg,68,69,66,3,2,0.9565217391304348,0.9705882352941176
2022,ONAGRI,CITRUMELO SACCATON,40183,IMG-00009-39.jpg,57,62,56,6,1,0.9032258064516128,0.9824561403508772
2022,ONAGRI,CITRUMELO SACCATON,40183,IMG-00010-39.jpg,48,49,46,3,2,0.9387755102040816,0.9583333333333334
2024,KHOUALKA,CITRUS VOLKAMERIANA,50152,IMG-17274.jpg,170,120,119,1,51,0.9916666666666668,0.7
2024,KHOUALKA,CITRUS VOLKAMERIANA,50152,IMG-17306.jpg,105,88,88,0,17,1.0,0.8380952380952381
2024,KHOUALKA,CITRUS VOLKAMERIANA,50152,IMG-17330.jpg,41,30,30,0,11,1.0,0.7317073170731707
2024,KHOUALKA,CITRUS VOLKAMERIANA,50152,IMG-17335.jpg,44,32,32,0,12,1.0,0.7272727272727273
2024,KHOUALKA,CITRUS VOLKAMERIANA,50152,IMG-17340.jpg,108,71,70,1,38,0.9859154929577464,0.6481481481481481
2024,KHOUALKA,CITRUS VOLKAMERIANA,50152,IMG-17356.jpg,60,42,40,2,20,0.9523809523809524,0.6666666666666666
2024,KHOUALKA,CITRUS VOLKAMERIANA,50152,IMG-17384.jpg,53,33,33,0,20,1.0,0.6226415094339622
2024,KHOUALKA,CITRUS VOLKAMERIANA,50154,IMG-17440.jpg,76,64,64,0,12,1.0,0.8421052631578947
2024,KHOUALKA,CITRUS VOLKAMERIANA,50154,IMG-17490.jpg,107,72,72,0,35,1.0,0.6728971962616822
2024,KHOUALKA,CITRUS VOLKAMERIANA,50154,IMG-17543.jpg,100,68,68,0,32,1.0,0.68
2024,KHOUALKA,CITRUS VOLKAMERIANA,50154,IMG-17545.jpg,94,64,64,0,30,1.0,0.6808510638297872
2024,KHOUALKA,CITRUS VOLKAMERIANA,50154,IMG-17562.jpg,129,106,106,0,23,1.0,0.8217054263565892
2024,KHOUALKA,CITRUS VOLKAMERIANA,50154,IMG-17576.jpg,121,96,96,0,25,1.0,0.7933884297520661
2024,KHOUALKA,CITRUS VOLKAMERIANA,50154,IMG-17585.jpg,171,125,124,1,47,0.992,0.7251461988304093
2024,KHOUALKA,CITRUS VOLKAMERIANA,50168,IMG-13980.jpg,174,135,135,0,39,1.0,0.7758620689655172
2024,KHOUALKA,CITRUS VOLKAMERIANA,50168,IMG-15749.jpg,147,115,115,0,32,1.0,0.782312925170068
2024,KHOUALKA,CITRUS VOLKAMERIANA,50168,IMG-15758.jpg,163,123,122,1,41,0.991869918699187,0.7484662576687117
2024,KHOUALKA,CITRUS VOLKAMERIANA,50168,IMG-15981.jpg,210,156,155,1,55,0.9935897435897436,0.7380952380952381
2024,KHOUALKA,CITRUS VOLKAMERIANA,50168,IMG-15983.jpg,120,88,88,0,32,1.0,0.7333333333333333
2024,KHOUALKA,CITRUS VOLKAMERIANA,50176,IMG-16025.jpg,81,60,60,0,21,1.0,0.7407407407407407
2024,KHOUALKA,CITRUS VOLKAMERIANA,50176,IMG-16051.jpg,85,60,60,0,25,1.0,0.7058823529411765
2024,KHOUALKA,CITRUS VOLKAMERIANA,50176,IMG-16079.jpg,161,119,118,1,43,0.9915966386554622,0.7329192546583851
2024,KHOUALKA,CITRUS VOLKAMERIANA,50176,IMG-16095.jpg,101,67,67,0,34,1.0,0.6633663366336634
2024,KHOUALKA,CITRUS VOLKAMERIANA,50176,IMG-16105.jpg,43,27,27,0,16,1.0,0.627906976744186
2022,ONAGRI,CITRUMELO SACCATON,50193,IMG-00007-39.jpg,218,230,217,13,1,0.9434782608695652,0.9954128440366972
2022,ONAGRI,CITRUMELO SACCATON,50193,IMG-00016-39.jpg,64,74,62,12,2,0.8378378378378378,0.96875
2022,ONAGRI,CITRUMELO SACCATON,50193,IMG-00018-39.jpg,115,121,114,7,1,0.9421487603305784,0.991304347826087
2022,ONAGRI,CITRUMELO SACCATON,50193,IMG-00021-39.jpg,62,62,59,3,3,0.9516129032258064,0.9516129032258064
2022,ONAGRI,CITRUMELO SACCATON,50193,IMG-00023-39.jpg,113,127,112,15,1,0.8818897637795275,0.991150442477876
2022,ONAGRI,CITRUMELO SACCATON,50194,IMG-00032-39.jpg,162,172,155,17,7,0.9011627906976744,0.9567901234567902
2022,ONAGRI,CITRUMELO SACCATON,50194,IMG-00034-39.jpg,105,110,104,6,1,0.9454545454545454,0.9904761904761904
2022,ONAGRI,CITRUMELO SACCATON,50194,IMG-00036-39.jpg,161,179,151,28,10,0.8435754189944135,0.937888198757764
2022,ONAGRI,CITRUMELO SACCATON,50194,IMG-00038-39.jpg,100,110,97,13,3,0.8818181818181818,0.97
2022,ONAGRI,CITRUMELO SACCATON,50194,IMG-00039-39.jpg,65,69,64,5,1,0.927536231884058,0.9846153846153848
2022,ONAGRI,CITRUMELO SACCATON,50194,IMG-00041-39.jpg,153,160,149,11,4,0.93125,0.9738562091503268
2022,ONAGRI,CITRUMELO SACCATON,50194,IMG-00051-39.jpg,137,144,132,12,5,0.9166666666666666,0.9635036496350364
2022,ONAGRI,CITRUMELO SACCATON,50194,IMG-00054-39.jpg,111,113,106,7,5,0.9380530973451328,0.954954954954955
2022,ONAGRI,CITRUMELO SACCATON,51091,IMG-00015-39.jpg,85,97,84,13,1,0.865979381443299,0.9882352941176472
2022,ONAGRI,CITRUMELO SACCATON,51091,IMG-00016-39.jpg,170,180,169,11,1,0.9388888888888888,0.9941176470588236
2022,ONAGRI,CITRUMELO SACCATON,51091,IMG-00018-39.jpg,185,207,182,25,3,0.8792270531400966,0.9837837837837838
2022,ONAGRI,CITRUMELO SACCATON,51091,IMG-00022-39.jpg,135,155,133,22,2,0.8580645161290322,0.9851851851851852
2022,ONAGRI,CITRUMELO SACCATON,51091,IMG-00023-39.jpg,140,143,134,9,6,0.9370629370629372,0.9571428571428572
2022,ONAGRI,CITRUMELO SACCATON,51091,IMG-00026-39.jpg,149,149,141,8,8,0.9463087248322148,0.9463087248322148
2022,ONAGRI,CITRUMELO SACCATON,51091,IMG-00044-39.jpg,168,176,165,11,3,0.9375,0.9821428571428572
2022,ONAGRI,CITRUMELO SACCATON,51095,IMG-00004-39.jpg,201,221,199,22,2,0.9004524886877828,0.9900497512437813
2022,ONAGRI,CITRUMELO SACCATON,51095,IMG-00013-39.jpg,154,160,148,12,6,0.925,0.961038961038961
2022,ONAGRI,CITRUMELO SACCATON,51095,IMG-00014-39.jpg,140,151,134,17,6,0.8874172185430463,0.9571428571428572
2022,ONAGRI,CITRUMELO SACCATON,51095,IMG-00015-39.jpg,196,199,193,6,3,0.9698492462311558,0.9846938775510204
2022,ONAGRI,CITRUMELO SACCATON,51095,IMG-00024-39.jpg,234,245,228,17,6,0.9306122448979592,0.9743589743589745
2022,ONAGRI,CITRUMELO SACCATON,51095,IMG-00025-39.jpg,198,214,196,18,2,0.9158878504672896,0.98989898989899
2022,ONAGRI,CITRUMELO SACCATON,51096,IMG-00009-39.jpg,219,227,210,17,9,0.9251101321585904,0.958904109589041
2022,ONAGRI,CITRUMELO SACCATON,51096,IMG-00011-39.jpg,145,156,140,16,5,0.8974358974358975,0.9655172413793104
2022,ONAGRI,CITRUMELO SACCATON,51096,IMG-00012-39.jpg,114,113,107,6,7,0.9469026548672568,0.9385964912280702
2022,ONAGRI,CITRUMELO SACCATON,51096,IMG-00055-39.jpg,217,214,203,11,14,0.9485981308411215,0.935483870967742
2022,ONAGRI,MC PONSIRUCE TRIFOLIATA,51097,IMG-00025-39.jpg,121,131,116,15,5,0.8854961832061069,0.9586776859504132
2022,ONAGRI,MC PONSIRUCE TRIFOLIATA,51097,IMG-00029-39.jpg,106,118,104,14,2,0.8813559322033898,0.981132075471698
2022,ONAGRI,MC PONSIRUCE TRIFOLIATA,51097,IMG-00044-39.jpg,182,192,175,17,7,0.9114583333333334,0.9615384615384616
2022,ONAGRI,MC PONSIRUCE TRIFOLIATA,51098,IMG-00003-39.jpg,65,70,63,7,2,0.9,0.9692307692307692
2022,ONAGRI,MC PONSIRUCE TRIFOLIATA,51098,IMG-00010-39.jpg,184,188,178,10,6,0.946808510638298,0.967391304347826
2022,ONAGRI,MC PONSIRUCE TRIFOLIATA,51098,IMG-00015-39.jpg,162,175,162,13,0,0.9257142857142856,1.0
2022,ONAGRI,MC PONSIRUCE TRIFOLIATA,51099,IMG-00012-39.jpg,133,147,131,16,2,0.891156462585034,0.9849624060150376
2024,ONAGRI,MC PONSIRUCE TRIFOLIATA,51101,IMG-12118.jpg,177,135,135,0,42,1.0,0.7627118644067796
2024,ONAGRI,MC PONSIRUCE TRIFOLIATA,51101,IMG-14223.jpg,153,120,120,0,33,1.0,0.7843137254901961
2024,ONAGRI,MC PONSIRUCE TRIFOLIATA,51101,IMG-14226.jpg,151,130,130,0,21,1.0,0.8609271523178808
2024,ONAGRI,MC PONSIRUCE TRIFOLIATA,51101,IMG-14255.jpg,189,156,155,1,34,0.9935897435897436,0.8201058201058201
2024,ONAGRI,MC PONSIRUCE TRIFOLIATA,51101,IMG-14281.jpg,150,128,128,0,22,1.0,0.8533333333333334
2022,ONAGRI,CITRUS VOLKAMERIANA,101020,IMG-00001.jpg,6,7,6,1,0,0.8571428571428571,1.0
2022,ONAGRI,CITRUS VOLKAMERIANA,101020,IMG-00004-44.jpg,53,50,48,2,5,0.96,0.9056603773584906
2022,ONAGRI,CITRUS VOLKAMERIANA,101030,IMG-00003-44.jpg,29,31,29,2,0,0.935483870967742,1.0
2022,ONAGRI,CITRUS VOLKAMERIANA,101030,IMG-00004-44.jpg,110,103,101,2,9,0.9805825242718448,0.9181818181818182
2022,ONAGRI,CITRUS VOLKAMERIANA,101030,IMG-00005-44.jpg,134,127,123,4,11,0.968503937007874,0.917910447761194
2022,ONAGRI,CITRUS VOLKAMERIANA,101030,IMG-00017-44.jpg,79,73,72,1,7,0.9863013698630136,0.9113924050632912
2022,ONAGRI,CITRUS VOLKAMERIANA,101040,IMG-00005-44.jpg,172,158,155,3,17,0.981012658227848,0.9011627906976744
2022,ONAGRI,CITRUS VOLKAMERIANA,101040,IMG-00009-44.jpg,131,139,127,12,4,0.9136690647482014,0.9694656488549618
2022,ONAGRI,CITRUS VOLKAMERIANA,101040,IMG-00011-44.jpg,64,68,63,5,1,0.9264705882352942,0.984375
2022,ONAGRI,CITRUS VOLKAMERIANA,101040,IMG-00012-44.jpg,139,132,126,6,13,0.9545454545454546,0.9064748201438848
2022,ONAGRI,CITRUS VOLKAMERIANA,101050,IMG-00002-44.jpg,95,92,87,5,8,0.9456521739130436,0.9157894736842104
2022,ONAGRI,CITRUS VOLKAMERIANA,101050,IMG-00005-44.jpg,59,56,56,0,3,1.0,0.9491525423728814
2022,ONAGRI,CITRUS VOLKAMERIANA,101050,IMG-00011-44.jpg,46,42,42,0,4,1.0,0.9130434782608696
2022,ONAGRI,CITRUS VOLKAMERIANA,101050,IMG-00024-44.jpg,40,42,39,3,1,0.9285714285714286,0.975
2022,ONAGRI,CITRUS VOLKAMERIANA,101080,IMG-00005-44.jpg,42,35,33,2,9,0.9428571428571428,0.7857142857142857
2022,ONAGRI,CITRUS VOLKAMERIANA,101080,IMG-00006-44.jpg,79,70,68,2,11,0.9714285714285714,0.8607594936708861
2022,ONAGRI,CITRUS VOLKAMERIANA,101080,IMG-00023-44.jpg,7,7,7,0,0,1.0,1.0
2022,ONAGRI,CITRUS VOLKAMERIANA,101080,IMG-00024-44.jpg,27,25,24,1,3,0.96,0.8888888888888888
2022,ONAGRI,CITRUS VOLKAMERIANA,101090,IMG-00003-44.jpg,66,64,62,2,4,0.96875,0.9393939393939394
2022,ONAGRI,CITRUS VOLKAMERIANA,101090,IMG-00006-44.jpg,41,39,38,1,3,0.9743589743589745,0.926829268292683
2022,ONAGRI,CITRUS VOLKAMERIANA,101090,IMG-00019-44.jpg,35,36,34,2,1,0.9444444444444444,0.9714285714285714
2022,ONAGRI,CITRUS VOLKAMERIANA,101090,IMG-00020-44.jpg,42,40,40,0,2,1.0,0.9523809523809524
2022,KHOUALKA,CITRANGE CARRIZO,102130,IMG-00001.jpg,5,4,4,0,1,1.0,0.8
2022,KHOUALKA,CITRANGE CARRIZO,102130,IMG-00004-43.jpg,24,17,17,0,7,1.0,0.7083333333333334
2022,KHOUALKA,CITRANGE CARRIZO,102130,IMG-00019-43.jpg,33,29,29,0,4,1.0,0.8787878787878788
2022,KHOUALKA,CITRANGE CARRIZO,102130,IMG-00020-43.jpg,18,22,15,7,3,0.6818181818181818,0.8333333333333334
2022,KHOUALKA,MACROPHYLLA,201180,IMG-00007-43.jpg,38,44,38,6,0,0.8636363636363636,1.0
2022,KHOUALKA,MACROPHYLLA,201180,IMG-00011-43.jpg,64,58,57,1,7,0.9827586206896552,0.890625
2022,KHOUALKA,MACROPHYLLA,201180,IMG-00019-43.jpg,64,60,58,2,6,0.9666666666666668,0.90625
2022,KHOUALKA,MACROPHYLLA,201180,IMG-00020-43.jpg,43,39,36,3,7,0.9230769230769232,0.8372093023255814
2022,KHOUALKA,MACROPHYLLA,201190,IMG-00004-43.jpg,101,79,77,2,24,0.9746835443037974,0.7623762376237624
2022,KHOUALKA,MACROPHYLLA,201190,IMG-00010-43.jpg,90,74,74,0,16,1.0,0.8222222222222222
2022,KHOUALKA,MACROPHYLLA,201190,IMG-00011-43.jpg,134,109,106,3,28,0.9724770642201837,0.7910447761194029
2022,KHOUALKA,MACROPHYLLA,201190,IMG-00020-43.jpg,95,75,72,3,23,0.96,0.7578947368421053
2022,KHOUALKA,CITRUS VOLKAMERIANA,201210,IMG-00011-43.jpg,103,101,100,1,3,0.99009900990099,0.970873786407767
2022,KHOUALKA,CITRUS VOLKAMERIANA,201210,IMG-00012-43.jpg,42,40,40,0,2,1.0,0.9523809523809524
2022,KHOUALKA,CITRUS VOLKAMERIANA,201210,IMG-00015-43.jpg,77,69,69,0,8,1.0,0.8961038961038961
2022,KHOUALKA,CITRUS VOLKAMERIANA,201210,IMG-00019-43.jpg,31,31,31,0,0,1.0,1.0
2022,KHOUALKA,BIGARADIER,201320,IMG-00006-43.jpg,87,75,74,1,13,0.9866666666666668,0.8505747126436781
2022,KHOUALKA,BIGARADIER,201320,IMG-00016-43.jpg,97,93,90,3,7,0.967741935483871,0.9278350515463918
2022,KHOUALKA,BIGARADIER,201320,IMG-00017-43.jpg,49,48,46,2,3,0.9583333333333334,0.9387755102040816
2022,KHOUALKA,BIGARADIER,201320,IMG-00020-43.jpg,88,88,87,1,1,0.9886363636363636,0.9886363636363636
2022,ONAGRI,BIGARADIER,201390,IMG-00008-44.jpg,62,62,59,3,3,0.9516129032258064,0.9516129032258064
2022,ONAGRI,BIGARADIER,201390,IMG-00011-44.jpg,90,86,83,3,7,0.9651162790697676,0.9222222222222224
2022,ONAGRI,BIGARADIER,201390,IMG-00013-44.jpg,77,68,65,3,12,0.9558823529411764,0.8441558441558441
2022,ONAGRI,BIGARADIER,201390,IMG-00016-44.jpg,69,62,59,3,10,0.9516129032258064,0.855072463768116
2022,KHOUALKA,CITRUS VOLKAMERIANA,202050,IMG-00006-43.jpg,89,87,86,1,3,0.9885057471264368,0.9662921348314608
2022,KHOUALKA,CITRUS VOLKAMERIANA,202050,IMG-00010-43.jpg,94,89,89,0,5,1.0,0.946808510638298
2022,KHOUALKA,CITRUS VOLKAMERIANA,202050,IMG-00011-43.jpg,151,153,148,5,3,0.9673202614379084,0.9801324503311258
2022,KHOUALKA,CITRUS VOLKAMERIANA,202050,IMG-00020-43.jpg,129,121,121,0,8,1.0,0.937984496124031
2022,KHOUALKA,CITRUS VOLKAMERIANA,202070,IMG-00006-43.jpg,68,66,65,1,3,0.9848484848484848,0.9558823529411764
2022,KHOUALKA,CITRUS VOLKAMERIANA,202070,IMG-00009-43.jpg,120,116,116,0,4,1.0,0.9666666666666668
2022,KHOUALKA,CITRUS VOLKAMERIANA,202070,IMG-00013-43.jpg,95,87,85,2,10,0.9770114942528736,0.8947368421052632
2022,KHOUALKA,CITRUS VOLKAMERIANA,202070,IMG-00019-43.jpg,57,56,56,0,1,1.0,0.9824561403508772
2022,KHOUALKA,CITRUS VOLKAMERIANA,202080,IMG-00005-43.jpg,65,62,62,0,3,1.0,0.953846153846154
2022,KHOUALKA,CITRUS VOLKAMERIANA,202080,IMG-00008-43.jpg,31,29,29,0,2,1.0,0.935483870967742
2022,KHOUALKA,CITRUS VOLKAMERIANA,202080,IMG-00015-43.jpg,220,218,215,3,5,0.9862385321100916,0.9772727272727272
2022,KHOUALKA,CITRUS VOLKAMERIANA,202080,IMG-00016-43.jpg,131,129,127,2,4,0.9844961240310076,0.9694656488549618
2022,KHOUALKA,CITRANGE CARRIZO,301380,IMG-00007-43.jpg,30,26,25,1,5,0.9615384615384616,0.8333333333333334
2022,KHOUALKA,CITRANGE CARRIZO,301380,IMG-00011-43.jpg,53,56,52,4,1,0.9285714285714286,0.981132075471698
2022,KHOUALKA,CITRANGE CARRIZO,301380,IMG-00014-43.jpg,7,6,5,1,2,0.8333333333333334,0.7142857142857143
2022,KHOUALKA,CITRANGE CARRIZO,301380,IMG-00020-43.jpg,91,93,87,6,4,0.935483870967742,0.956043956043956
2022,ONAGRI,CITRUS VOLKAMERIANA,301470,IMG-00003-44.jpg,148,151,141,10,7,0.933774834437086,0.9527027027027029
2022,ONAGRI,CITRUS VOLKAMERIANA,301470,IMG-00004-44.jpg,163,162,147,15,16,0.9074074074074074,0.901840490797546
2022,ONAGRI,CITRUS VOLKAMERIANA,301470,IMG-00005-44.jpg,160,142,136,6,24,0.9577464788732394,0.85
2022,ONAGRI,CITRUS VOLKAMERIANA,301480,IMG-00001.jpg,92,70,70,0,22,1.0,0.7608695652173914
2022,ONAGRI,CITRUS VOLKAMERIANA,301480,IMG-00003-43.jpg,26,18,18,0,8,1.0,0.6923076923076923
2022,ONAGRI,CITRUS VOLKAMERIANA,301480,IMG-00012-43.jpg,50,38,38,0,12,1.0,0.76
2022,ONAGRI,CITRUS VOLKAMERIANA,301480,IMG-00014-43.jpg,77,68,68,0,9,1.0,0.8831168831168831
2022,ONAGRI,CITRUS VOLKAMERIANA,301490,IMG-00005-44.jpg,108,89,86,3,22,0.9662921348314608,0.7962962962962963
2022,ONAGRI,CITRUS VOLKAMERIANA,301490,IMG-00009-44.jpg,185,169,160,9,25,0.9467455621301776,0.8648648648648649
2022,ONAGRI,CITRUS VOLKAMERIANA,301490,IMG-00012-44.jpg,162,154,147,7,15,0.9545454545454546,0.9074074074074074
2022,ONAGRI,CITRUS VOLKAMERIANA,301490,IMG-00015-44.jpg,109,104,96,8,13,0.9230769230769232,0.8807339449541285
2022,ONAGRI,CITRUS VOLKAMERIANA,301510,IMG-00001.jpg,252,233,224,9,28,0.96137339055794,0.8888888888888888
2022,ONAGRI,CITRUS VOLKAMERIANA,301510,IMG-00006-44.jpg,137,132,126,6,11,0.9545454545454546,0.9197080291970804
2022,ONAGRI,CITRUS VOLKAMERIANA,301510,IMG-00007-44.jpg,115,116,102,14,13,0.8793103448275862,0.8869565217391304
2022,ONAGRI,CITRUS VOLKAMERIANA,301510,IMG-00008-44.jpg,150,134,126,8,24,0.9402985074626866,0.84
2022,ONAGRI,BIGARADIER,301550,IMG-00008-44.jpg,144,142,135,7,9,0.9507042253521126,0.9375
2022,ONAGRI,BIGARADIER,301550,IMG-00011-44.jpg,40,41,39,2,1,0.951219512195122,0.975
2022,ONAGRI,BIGARADIER,301550,IMG-00013-44.jpg,76,73,68,5,8,0.9315068493150684,0.8947368421052632
2022,ONAGRI,BIGARADIER,301550,IMG-00014-44.jpg,80,85,78,7,2,0.9176470588235294,0.975
2022,ONAGRI,CITRUS VOLKAMERIANA,301570,IMG-00004-44.jpg,158,149,143,6,15,0.959731543624161,0.9050632911392406
2022,ONAGRI,CITRUS VOLKAMERIANA,301570,IMG-00007-44.jpg,152,137,131,6,21,0.9562043795620438,0.8618421052631579
2022,ONAGRI,CITRUS VOLKAMERIANA,301570,IMG-00008-44.jpg,103,92,85,7,18,0.9239130434782608,0.8252427184466019
2022,ONAGRI,CITRUS VOLKAMERIANA,301570,IMG-00017-44.jpg,218,198,192,6,26,0.9696969696969696,0.8807339449541285
2022,KHOUALKA,CITRUS VOLKAMERIANA,302340,IMG-00004-43.jpg,106,84,84,0,22,1.0,0.7924528301886793
2022,KHOUALKA,CITRUS VOLKAMERIANA,302340,IMG-00005-43.jpg,105,82,80,2,25,0.975609756097561,0.7619047619047619
2022,KHOUALKA,CITRUS VOLKAMERIANA,302340,IMG-00011-43.jpg,75,61,61,0,14,1.0,0.8133333333333334
2022,KHOUALKA,CITRUS VOLKAMERIANA,302340,IMG-00015-43.jpg,92,76,73,3,19,0.9605263157894736,0.7934782608695652
2022,KHOUALKA,CITRUS VOLKAMERIANA,302350,IMG-00008-43.jpg,33,30,29,1,4,0.9666666666666668,0.8787878787878788
2022,KHOUALKA,CITRUS VOLKAMERIANA,302350,IMG-00013-43.jpg,80,80,75,5,5,0.9375,0.9375
2022,KHOUALKA,CITRUS VOLKAMERIANA,302350,IMG-00014-43.jpg,76,71,64,7,12,0.9014084507042254,0.8421052631578947
2022,KHOUALKA,CITRUS VOLKAMERIANA,302350,IMG-00018-43.jpg,44,43,41,2,3,0.9534883720930232,0.9318181818181818
2022,KHOUALKA,CITRUS VOLKAMERIANA,302360,IMG-00005-43.jpg,97,85,84,1,13,0.9882352941176472,0.865979381443299
2022,KHOUALKA,CITRUS VOLKAMERIANA,302360,IMG-00006-43.jpg,118,102,100,2,18,0.9803921568627452,0.847457627118644
2022,KHOUALKA,CITRUS VOLKAMERIANA,302360,IMG-00016-43.jpg,67,58,58,0,9,1.0,0.8656716417910447
2022,KHOUALKA,CITRUS VOLKAMERIANA,302360,IMG-00021-43.jpg,65,64,59,5,6,0.921875,0.9076923076923076
2022,KHOUALKA,CITRUS VOLKAMERIANA,302510,IMG-00001.jpg,73,55,55,0,18,1.0,0.7534246575342466
2022,KHOUALKA,CITRUS VOLKAMERIANA,302510,IMG-00002-43.jpg,44,35,33,2,11,0.9428571428571428,0.75
2022,KHOUALKA,CITRUS VOLKAMERIANA,302510,IMG-00003-43.jpg,78,70,70,0,8,1.0,0.8974358974358975
2022,KHOUALKA,CITRUS VOLKAMERIANA,302510,IMG-00015-43.jpg,49,31,31,0,18,1.0,0.6326530612244898
2022,KHOUALKA,BIGARADIER,401410,IMG-00093-43.jpg,35,22,22,0,13,1.0,0.6285714285714286
2022,KHOUALKA,BIGARADIER,401410,IMG-00099-43.jpg,6,4,4,0,2,1.0,0.6666666666666666
2022,KHOUALKA,BIGARADIER,401410,IMG-00102-43.jpg,78,60,60,0,18,1.0,0.7692307692307693
2022,KHOUALKA,BIGARADIER,401410,IMG-00104-43.jpg,81,63,61,2,20,0.9682539682539684,0.7530864197530864
2022,ONAGRI,CITRANGE C35,401660,IMG-00001.jpg,56,58,54,4,2,0.9310344827586208,0.9642857142857144
2022,ONAGRI,CITRANGE C35,401660,IMG-00008-44.jpg,42,42,41,1,1,0.9761904761904762,0.9761904761904762
2022,ONAGRI,CITRANGE C35,401660,IMG-00010-44.jpg,29,27,26,1,3,0.9629629629629628,0.896551724137931
2022,ONAGRI,CITRANGE C35,401660,IMG-00016-44.jpg,64,61,59,2,5,0.9672131147540984,0.921875
2022,ONAGRI,CITRANGE C35,401710,IMG-00003-44.jpg,51,45,45,0,6,1.0,0.8823529411764706
2022,ONAGRI,CITRANGE C35,401710,IMG-00012-44.jpg,19,18,18,0,1,1.0,0.9473684210526316
2022,ONAGRI,CITRANGE C35,401710,IMG-00013-44.jpg,33,32,30,2,3,0.9375,0.9090909090909092
2022,ONAGRI,CITRANGE C35,401710,IMG-00019-44.jpg,76,73,71,2,5,0.9726027397260274,0.9342105263157896
2022,ONAGRI,CITRANGE C35,401720,IMG-00007-44.jpg,93,90,88,2,5,0.9777777777777776,0.946236559139785
2022,ONAGRI,CITRANGE C35,401720,IMG-00008-44.jpg,38,34,33,1,5,0.9705882352941176,0.868421052631579
2022,ONAGRI,CITRANGE C35,401720,IMG-00010-44.jpg,50,37,37,0,13,1.0,0.74
2022,ONAGRI,CITRANGE C35,401720,IMG-00017-44.jpg,68,55,54,1,14,0.9818181818181818,0.7941176470588235
2022,ONAGRI,CITRANGE C35,401730,IMG-00001.jpg,19,19,18,1,1,0.9473684210526316,0.9473684210526316
2022,ONAGRI,CITRANGE C35,401730,IMG-00010-44.jpg,50,47,47,0,3,1.0,0.94
2022,ONAGRI,CITRANGE C35,401730,IMG-00013-44.jpg,75,67,66,1,9,0.9850746268656716,0.88
2022,ONAGRI,CITRANGE C35,401730,IMG-00016-44.jpg,36,31,31,0,5,1.0,0.8611111111111112
2022,ONAGRI,CITRANGE C35,401750,IMG-00005-44.jpg,88,70,64,6,24,0.9142857142857144,0.7272727272727273
2022,ONAGRI,CITRANGE C35,401750,IMG-00009-44.jpg,127,109,106,3,21,0.9724770642201837,0.8346456692913385
2022,ONAGRI,CITRANGE C35,401750,IMG-00016-44.jpg,107,88,86,2,21,0.9772727272727272,0.8037383177570093
2022,ONAGRI,CITRANGE C35,401750,IMG-00024-44.jpg,50,43,39,4,11,0.9069767441860463,0.78
2022,ONAGRI,CITRUMELO SACCATON,401770,IMG-00003-44.jpg,24,22,21,1,3,0.9545454545454546,0.875
2022,ONAGRI,CITRUMELO SACCATON,401770,IMG-00008-44.jpg,72,72,68,4,4,0.9444444444444444,0.9444444444444444
2022,ONAGRI,CITRUMELO SACCATON,401770,IMG-00009-44.jpg,14,13,12,1,2,0.9230769230769232,0.8571428571428571
2022,ONAGRI,CITRUMELO SACCATON,401770,IMG-00017-44.jpg,20,16,15,1,5,0.9375,0.75
2022,KHOUALKA,BIGARADIER,402440,IMG-00005-43.jpg,17,9,8,1,9,0.8888888888888888,0.4705882352941176
2022,KHOUALKA,BIGARADIER,402440,IMG-00012-43.jpg,46,32,31,1,15,0.96875,0.6739130434782609
2022,KHOUALKA,BIGARADIER,402440,IMG-00014-43.jpg,11,5,5,0,6,1.0,0.4545454545454545
2022,KHOUALKA,BIGARADIER,402440,IMG-00015-43.jpg,22,9,9,0,13,1.0,0.4090909090909091
2022,KHOUALKA,BIGARADIER,402590,IMG-00007-43.jpg,104,75,74,1,30,0.9866666666666668,0.7115384615384616
2022,KHOUALKA,BIGARADIER,402590,IMG-00012-43.jpg,45,41,40,1,5,0.975609756097561,0.8888888888888888
2022,KHOUALKA,BIGARADIER,402590,IMG-00015-43.jpg,58,50,49,1,9,0.98,0.8448275862068966
2022,KHOUALKA,BIGARADIER,402590,IMG-00019-43.jpg,64,57,57,0,7,1.0,0.890625
2022,KHOUALKA,CITRUS VOLKAMERIANA,501520,IMG-00004-43.jpg,39,32,31,1,8,0.96875,0.7948717948717948
2022,KHOUALKA,CITRUS VOLKAMERIANA,501520,IMG-00007-43.jpg,43,32,32,0,11,1.0,0.7441860465116279
2022,KHOUALKA,CITRUS VOLKAMERIANA,501520,IMG-00015-43.jpg,18,10,10,0,8,1.0,0.5555555555555556
2022,KHOUALKA,CITRUS VOLKAMERIANA,501520,IMG-00020-43.jpg,48,42,42,0,6,1.0,0.875
2022,KHOUALKA,CITRUS VOLKAMERIANA,501540,IMG-00006-43.jpg,38,29,29,0,9,1.0,0.7631578947368421
2022,KHOUALKA,CITRUS VOLKAMERIANA,501540,IMG-00012-43.jpg,102,93,92,1,10,0.989247311827957,0.9019607843137256
2022,KHOUALKA,CITRUS VOLKAMERIANA,501540,IMG-00017-43.jpg,138,122,120,2,18,0.9836065573770492,0.8695652173913043
2022,KHOUALKA,CITRUS VOLKAMERIANA,501540,IMG-00018-43.jpg,51,43,42,1,9,0.9767441860465116,0.8235294117647058
2022,KHOUALKA,CITRUS VOLKAMERIANA,501660,IMG-00006-43.jpg,60,53,51,2,9,0.9622641509433962,0.85
2022,KHOUALKA,CITRUS VOLKAMERIANA,501660,IMG-00016-43.jpg,63,51,48,3,15,0.9411764705882352,0.7619047619047619
2022,KHOUALKA,CITRUS VOLKAMERIANA,501660,IMG-00018-43.jpg,112,84,82,2,30,0.9761904761904762,0.7321428571428571
2022,KHOUALKA,CITRUS VOLKAMERIANA,501660,IMG-00021-43.jpg,90,85,83,2,7,0.976470588235294,0.9222222222222224
2022,KHOUALKA,CITRUS VOLKAMERIANA,501680,IMG-00005-43.jpg,179,151,149,2,30,0.9867549668874172,0.8324022346368715
2022,KHOUALKA,CITRUS VOLKAMERIANA,501680,IMG-00011-43.jpg,101,75,75,0,26,1.0,0.7425742574257426
2022,KHOUALKA,CITRUS VOLKAMERIANA,501680,IMG-00012-43.jpg,76,52,49,3,27,0.9423076923076924,0.6447368421052632
2022,KHOUALKA,CITRUS VOLKAMERIANA,501680,IMG-00016-43.jpg,113,90,89,1,24,0.9888888888888888,0.7876106194690266
2022,KHOUALKA,CITRUS VOLKAMERIANA,501690,IMG-00032-43.jpg,34,25,24,1,10,0.96,0.7058823529411765
2022,KHOUALKA,CITRUS VOLKAMERIANA,501690,IMG-00039-43.jpg,186,138,137,1,49,0.9927536231884058,0.7365591397849462
2022,KHOUALKA,CITRUS VOLKAMERIANA,501690,IMG-00047-43.jpg,103,76,76,0,27,1.0,0.7378640776699029
2022,KHOUALKA,CITRUS VOLKAMERIANA,501690,IMG-00049-43.jpg,166,141,137,4,29,0.9716312056737588,0.8253012048192772
2022,KHOUALKA,CITRUS VOLKAMERIANA,501760,IMG-00001.jpg,94,51,50,1,44,0.9803921568627452,0.5319148936170213
2022,KHOUALKA,CITRUS VOLKAMERIANA,501760,IMG-00034-43.jpg,45,24,24,0,21,1.0,0.5333333333333333
2022,KHOUALKA,CITRUS VOLKAMERIANA,501760,IMG-00036-43.jpg,40,26,26,0,14,1.0,0.65
2022,KHOUALKA,CITRUS VOLKAMERIANA,501760,IMG-00051-43.jpg,92,68,67,1,25,0.9852941176470588,0.7282608695652174
2022,ONAGRI,CITRUMELO SACCATON,510910,IMG-00004-44.jpg,73,63,62,1,11,0.984126984126984,0.8493150684931506
2022,ONAGRI,CITRUMELO SACCATON,510910,IMG-00008-44.jpg,152,109,108,1,44,0.9908256880733946,0.7105263157894737
2022,ONAGRI,CITRUMELO SACCATON,510910,IMG-00010-44.jpg,107,89,87,2,20,0.9775280898876404,0.8130841121495327
2022,ONAGRI,CITRUMELO SACCATON,510910,IMG-00011-44.jpg,92,75,75,0,17,1.0,0.8152173913043478
2022,ONAGRI,CITRUMELO SACCATON,510950,IMG-00006-44.jpg,70,59,58,1,12,0.9830508474576272,0.8285714285714286
2022,ONAGRI,CITRUMELO SACCATON,510950,IMG-00008-44.jpg,75,61,59,2,16,0.9672131147540984,0.7866666666666666
2022,ONAGRI,CITRUMELO SACCATON,510950,IMG-00009-44.jpg,85,68,66,2,19,0.9705882352941176,0.7764705882352941
2022,ONAGRI,CITRUMELO SACCATON,510950,IMG-00011-44.jpg,135,109,107,2,28,0.981651376146789,0.7925925925925926
2022,ONAGRI,MC PONSIRUCE TRIFOLIATA,510980,IMG-00014-44.jpg,67,56,54,2,13,0.9642857142857144,0.8059701492537313
2022,ONAGRI,MC PONSIRUCE TRIFOLIATA,510980,IMG-00015-44.jpg,51,45,45,0,6,1.0,0.8823529411764706
2022,ONAGRI,MC PONSIRUCE TRIFOLIATA,510980,IMG-00016-44.jpg,99,85,82,3,17,0.9647058823529412,0.8282828282828283
2022,ONAGRI,MC PONSIRUCE TRIFOLIATA,510980,IMG-00019-44.jpg,102,85,82,3,20,0.9647058823529412,0.803921568627451
2022,ONAGRI,MC PONSIRUCE TRIFOLIATA,510990,IMG-00006-44.jpg,135,109,108,1,27,0.9908256880733946,0.8
2022,ONAGRI,MC PONSIRUCE TRIFOLIATA,510990,IMG-00008-44.jpg,110,101,100,1,10,0.99009900990099,0.9090909090909092
2022,ONAGRI,MC PONSIRUCE TRIFOLIATA,510990,IMG-00009-44.jpg,85,73,71,2,14,0.9726027397260274,0.8352941176470589
2022,ONAGRI,MC PONSIRUCE TRIFOLIATA,510990,IMG-00024-44.jpg,65,57,56,1,9,0.9824561403508772,0.8615384615384616
2022,ONAGRI,MC PONSIRUCE TRIFOLIATA,511030,IMG-00007-44.jpg,100,82,82,0,18,1.0,0.82
2022,ONAGRI,MC PONSIRUCE TRIFOLIATA,511030,IMG-00016-44.jpg,63,56,55,1,8,0.9821428571428572,0.873015873015873
2022,ONAGRI,MC PONSIRUCE TRIFOLIATA,511030,IMG-00022-44.jpg,98,86,82,4,16,0.9534883720930232,0.8367346938775511
2022,ONAGRI,MC PONSIRUCE TRIFOLIATA,511030,IMG-00027-44.jpg,82,74,73,1,9,0.9864864864864864,0.8902439024390244
2022,ONAGRI,MS PONSIRUCE TRIFOLIATA,511040,IMG-00004-44.jpg,77,68,67,1,10,0.9852941176470588,0.8701298701298701
2022,ONAGRI,MS PONSIRUCE TRIFOLIATA,511040,IMG-00014-44.jpg,48,40,39,1,9,0.975,0.8125
2022,ONAGRI,MS PONSIRUCE TRIFOLIATA,511040,IMG-00016-44.jpg,71,67,64,3,7,0.9552238805970148,0.9014084507042254
2022,ONAGRI,MS PONSIRUCE TRIFOLIATA,511040,IMG-00025-44.jpg,56,46,44,2,12,0.9565217391304348,0.7857142857142857
2022,ONAGRI,FUZHU,511050,IMG-00004-44.jpg,109,97,92,5,17,0.9484536082474226,0.8440366972477065
2022,ONAGRI,FUZHU,511050,IMG-00006-44.jpg,142,127,120,7,22,0.9448818897637796,0.8450704225352113
2022,ONAGRI,FUZHU,511050,IMG-00011-44.jpg,172,159,154,5,18,0.9685534591194968,0.8953488372093024
2022,ONAGRI,FUZHU,511050,IMG-00022-44.jpg,194,176,172,4,22,0.9772727272727272,0.8865979381443299
2022,ONAGRI,MS PONSIRUCE TRIFOLIATA,511060,IMG-00007-44.jpg,115,105,102,3,13,0.9714285714285714,0.8869565217391304
2022,ONAGRI,MS PONSIRUCE TRIFOLIATA,511060,IMG-00016-44.jpg,102,84,81,3,21,0.9642857142857144,0.7941176470588235
2022,ONAGRI,MS PONSIRUCE TRIFOLIATA,511060,IMG-00017-44.jpg,59,43,43,0,16,1.0,0.7288135593220338
2022,ONAGRI,MS PONSIRUCE TRIFOLIATA,511060,IMG-00019-44.jpg,108,88,85,3,23,0.9659090909090908,0.7870370370370371
2022,ONAGRI,FUZHU,511070,IMG-00006-44.jpg,82,75,72,3,10,0.96,0.8780487804878049
2022,ONAGRI,FUZHU,511070,IMG-00016-44.jpg,96,79,77,2,19,0.9746835443037974,0.8020833333333334
2022,ONAGRI,FUZHU,511070,IMG-00018-44.jpg,93,77,75,2,18,0.974025974025974,0.8064516129032258
2022,ONAGRI,FUZHU,511070,IMG-00019-44.jpg,142,124,122,2,20,0.9838709677419356,0.8591549295774648
