compagnie,Domaine,Porte-greffe,parcelle,Filename,True_count,detect_count,TP,FP,FN,Precision,Recall
2022,SAOUDA,BIGARADIER,10010,IMG-00011-45.jpg,28,28,27,1,1,0.9642857142857144,0.9642857142857144
2022,SAOUDA,BIGARADIER,10010,IMG-00012-45.jpg,27,29,27,2,0,0.9310344827586208,1.0
2022,SAOUDA,BIGARADIER,10010,IMG-00014-45.jpg,50,51,47,4,3,0.9215686274509804,0.94
2022,SAOUDA,BIGARADIER,10010,IMG-00018-45.jpg,30,27,27,0,3,1.0,0.9
2022,SAOUDA,BIGARADIER,10010,IMG-00020-45.jpg,31,28,25,3,6,0.8928571428571429,0.8064516129032258
2024,SAOUDA,BIGARADIER,10010,IMG-23410.jpg,85,9,9,0,76,1.0,0.1058823529411765
2024,SAOUDA,BIGARADIER,10010,IMG-23417.jpg,86,17,17,0,69,1.0,0.1976744186046512
2024,SAOUDA,BIGARADIER,10010,IMG-23430.jpg,74,23,23,0,51,1.0,0.3108108108108108
2024,SAOUDA,BIGARADIER,10010,IMG-23647.jpg,95,20,20,0,75,1.0,0.2105263157894737
2024,SAOUDA,BIGARADIER,10010,IMG-23672.jpg,47,5,5,0,42,1.0,0.1063829787234043
2024,SAOUDA,BIGARADIER,10010,IMG-23707.jpg,30,12,12,0,18,1.0,0.4
2024,SAOUDA,BIGARADIER,10010,IMG-23709.jpg,31,5,5,0,26,1.0,0.1612903225806452
2024,SAOUDA,BIGARADIER,10010,IMG-23711.jpg,79,16,16,0,63,1.0,0.2025316455696203
2022,SAOUDA,MACROPHYLLA,10030,IMG-00158-45.jpg,101,100,91,9,10,0.91,0.900990099009901
2022,SAOUDA,MACROPHYLLA,10030,IMG-00159-45.jpg,155,150,141,9,14,0.94,0.9096774193548388
2022,SAOUDA,MACROPHYLLA,10030,IMG-00162-45.jpg,119,118,110,8,9,0.9322033898305084,0.9243697478991596
2022,SAOUDA,MACROPHYLLA,10030,IMG-00169-45.jpg,72,68,65,3,7,0.9558823529411764,0.9027777777777778
2022,SAOUDA,MACROPHYLLA,10031,IMG-00002-45.jpg,46,47,41,6,5,0.8723404255319149,0.8913043478260869
2022,SAOUDA,MACROPHYLLA,10031,IMG-00084-45.jpg,41,38,35,3,6,0.9210526315789472,0.8536585365853658
2022,SAOUDA,MACROPHYLLA,10031,IMG-00450-45.jpg,27,26,25,1,2,0.9615384615384616,0.925925925925926
2022,SAOUDA,MACROPHYLLA,10031,IMG-00451-45.jpg,34,30,27,3,7,0.9,0.7941176470588235
2022,SAOUDA,MACROPHYLLA,10031,IMG-00464-45.jpg,33,30,29,1,4,0.9666666666666668,0.8787878787878788
2022,ONAGRI,CITRUS VOLKAMERIANA,10101,IMG-00003-39.jpg,120,124,115,9,5,0.9274193548387096,0.9583333333333334
2022,ONAGRI,CITRUS VOLKAMERIANA,10101,IMG-00010-39.jpg,85,84,78,6,7,0.9285714285714286,0.9176470588235294
2024,ONAGRI,CITRUS VOLKAMERIANA,10101,IMG-10523.jpg,288,215,215,0,73,1.0,0.7465277777777778
2024,ONAGRI,CITRUS VOLKAMERIANA,10101,IMG-10545.jpg,98,77,76,1,22,0.987012987012987,0.7755102040816326
2024,ONAGRI,CITRUS VOLKAMERIANA,10101,IMG-10558.jpg,143,105,101,4,42,0.961904761904762,0.7062937062937062
2022,ONAGRI,CITRUS VOLKAMERIANA,10102,IMG-00003-39.jpg,48,43,42,1,6,0.9767441860465116,0.875
2024,ONAGRI,CITRUS VOLKAMERIANA,10102,IMG-10637.jpg,140,106,104,2,36,0.981132075471698,0.7428571428571429
2024,ONAGRI,CITRUS VOLKAMERIANA,10102,IMG-10658.jpg,163,127,124,3,39,0.9763779527559056,0.7607361963190185
2022,ONAGRI,CITRUS VOLKAMERIANA,10103,IMG-00003-39.jpg,215,207,200,7,15,0.966183574879227,0.9302325581395348
2022,ONAGRI,CITRUS VOLKAMERIANA,10103,IMG-00008-39.jpg,195,195,175,20,20,0.8974358974358975,0.8974358974358975
2024,ONAGRI,CITRUS VOLKAMERIANA,10103,IMG-10614.jpg,134,108,105,3,29,0.9722222222222222,0.7835820895522388
2024,ONAGRI,CITRUS VOLKAMERIANA,10103,IMG-10630.jpg,213,172,169,3,44,0.9825581395348836,0.7934272300469484
2024,ONAGRI,CITRUS VOLKAMERIANA,10103,IMG-10631.jpg,134,94,93,1,41,0.9893617021276596,0.6940298507462687
2022,ONAGRI,CITRUS VOLKAMERIANA,10104,IMG-00004-39.jpg,65,70,63,7,2,0.9,0.9692307692307692
2022,ONAGRI,CITRUS VOLKAMERIANA,10104,IMG-00008-39.jpg,69,67,61,6,8,0.9104477611940298,0.8840579710144928
2024,ONAGRI,CITRUS VOLKAMERIANA,10104,IMG-11267.jpg,22,12,12,0,10,1.0,0.5454545454545454
2024,ONAGRI,CITRUS VOLKAMERIANA,10104,IMG-11327.jpg,128,98,95,3,33,0.9693877551020408,0.7421875
2024,ONAGRI,CITRUS VOLKAMERIANA,10104,IMG-11347.jpg,118,87,86,1,32,0.9885057471264368,0.7288135593220338
2024,ONAGRI,CITRUS VOLKAMERIANA,10104,IMG-11366.jpg,351,224,219,5,132,0.9776785714285714,0.6239316239316239
2024,ONAGRI,CITRUS VOLKAMERIANA,10104,IMG-11386.jpg,99,72,71,1,28,0.9861111111111112,0.7171717171717171
2022,ONAGRI,CITRUS VOLKAMERIANA,10105,IMG-00004-39.jpg,17,19,15,4,2,0.7894736842105263,0.8823529411764706
2022,ONAGRI,CITRUS VOLKAMERIANA,10105,IMG-00005-39.jpg,68,70,65,5,3,0.9285714285714286,0.9558823529411764
2022,ONAGRI,CITRUS VOLKAMERIANA,10108,IMG-00003-39.jpg,61,63,58,5,3,0.9206349206349206,0.9508196721311476
2022,ONAGRI,CITRUS VOLKAMERIANA,10108,IMG-00007-39.jpg,69,57,56,1,13,0.9824561403508772,0.8115942028985508
2022,ONAGRI,CITRUS VOLKAMERIANA,10109,IMG-00003-39.jpg,4,4,4,0,0,1.0,1.0
2022,ONAGRI,CITRUS VOLKAMERIANA,10109,IMG-00008-39.jpg,105,110,96,14,9,0.8727272727272727,0.9142857142857144
2022,KHOUALKA,CITRANGE CARRIZO,10213,IMG-00001.jpg,77,76,76,0,1,1.0,0.987012987012987
2022,KHOUALKA,CITRANGE CARRIZO,10213,IMG-00005-40.jpg,73,70,70,0,3,1.0,0.958904109589041
2022,KHOUALKA,CITRANGE CARRIZO,10213,IMG-00009-40.jpg,14,14,13,1,1,0.9285714285714286,0.9285714285714286
2022,KHOUALKA,CITRANGE CARRIZO,10213,IMG-00014-40.jpg,21,20,20,0,1,1.0,0.9523809523809524
2022,KHOUALKA,CITRANGE CARRIZO,10213,IMG-00028-40.jpg,47,47,46,1,1,0.9787234042553192,0.9787234042553192
2022,KHOUALKA,CITRANGE CARRIZO,10213,IMG-00034-40.jpg,48,47,47,0,1,1.0,0.9791666666666666
2022,KHOUALKA,CITRANGE CARRIZO,10213,IMG-00035-40.jpg,37,35,35,0,2,1.0,0.945945945945946
2022,KHOUALKA,CITRANGE CARRIZO,10213,IMG-00036-40.jpg,47,47,47,0,0,1.0,1.0
2022,KHOUALKA,CITRANGE CARRIZO,10213,IMG-00042-40.jpg,22,22,22,0,0,1.0,1.0
2022,KHOUALKA,CITRANGE CARRIZO,10213,IMG-00047-40.jpg,70,69,69,0,1,1.0,0.9857142857142858
2022,KHOUALKA,CITRANGE CARRIZO,10213,IMG-00054-40.jpg,33,33,33,0,0,1.0,1.0
2022,KHOUALKA,CITRANGE CARRIZO,10213,IMG-00055-40.jpg,93,89,89,0,4,1.0,0.956989247311828
2022,KHOUALKA,CITRANGE CARRIZO,10213,IMG-00061-40.jpg,113,111,110,1,3,0.990990990990991,0.9734513274336284
2022,KHOUALKA,CITRANGE CARRIZO,10213,IMG-00066-40.jpg,48,52,48,4,0,0.9230769230769232,1.0
2022,OUARGHA,MACROPHYLLA,11010,IMG-00001.jpg,40,38,37,1,3,0.9736842105263158,0.925
2022,OUARGHA,MACROPHYLLA,11010,IMG-00015-41.jpg,24,22,20,2,4,0.9090909090909092,0.8333333333333334
2022,OUARGHA,MACROPHYLLA,11010,IMG-00019-41.jpg,20,19,18,1,2,0.9473684210526316,0.9
2022,OUARGHA,MACROPHYLLA,11010,IMG-00024-41.jpg,21,20,19,1,2,0.95,0.9047619047619048
2022,OUARGHA,MACROPHYLLA,11020,IMG-00017-41.jpg,51,54,50,4,1,0.925925925925926,0.9803921568627452
2022,OUARGHA,MACROPHYLLA,11020,IMG-00018-41.jpg,13,11,11,0,2,1.0,0.8461538461538461
2022,OUARGHA,CITRANGE CARRIZO,13010,IMG-00067-41.jpg,55,54,52,2,3,0.9629629629629628,0.9454545454545454
2022,OUARGHA,CITRANGE CARRIZO,13010,IMG-00086-41.jpg,49,46,44,2,5,0.9565217391304348,0.8979591836734694
2022,OUARGHA,CITRANGE CARRIZO,13010,IMG-00194-41.jpg,33,32,32,0,1,1.0,0.9696969696969696
2022,OUARGHA,CITRANGE CARRIZO,13020,IMG-00023-41.jpg,31,28,27,1,4,0.9642857142857144,0.8709677419354839
2022,OUARGHA,CITRANGE CARRIZO,13020,IMG-00024-41.jpg,18,17,17,0,1,1.0,0.9444444444444444
2022,OUARGHA,CITRANGE CARRIZO,13020,IMG-00039-41.jpg,4,4,3,1,1,0.75,0.75
2022,OUARGHA,CITRANGE CARRIZO,13020,IMG-00040-41.jpg,6,7,5,2,1,0.7142857142857143,0.8333333333333334
2022,OUARGHA,CITRUS VOLKAMERIANA,13030,IMG-00009-41.jpg,18,12,12,0,6,1.0,0.6666666666666666
2022,OUARGHA,CITRUS VOLKAMERIANA,13030,IMG-00013-41.jpg,46,44,42,2,4,0.9545454545454546,0.9130434782608696
2022,OUARGHA,CITRUS VOLKAMERIANA,13030,IMG-00027-41.jpg,12,11,10,1,2,0.9090909090909092,0.8333333333333334
2022,OUARGHA,CITRUS VOLKAMERIANA,13030,IMG-00029-41.jpg,18,18,16,2,2,0.8888888888888888,0.8888888888888888
2022,OUARGHA,CITRUS VOLKAMERIANA,13030,IMG-00036-41.jpg,16,19,13,6,3,0.6842105263157895,0.8125
2022,OUARGHA,CITRUS VOLKAMERIANA,14010,IMG-00008-41.jpg,40,35,34,1,6,0.9714285714285714,0.85
2022,OUARGHA,CITRUS VOLKAMERIANA,14010,IMG-00010-41.jpg,49,45,43,2,6,0.9555555555555556,0.8775510204081632
2022,OUARGHA,CITRUS VOLKAMERIANA,14010,IMG-00011-41.jpg,47,46,42,4,5,0.9130434782608696,0.8936170212765957
2022,OUARGHA,CITRUS VOLKAMERIANA,14010,IMG-00018-41.jpg,44,46,40,6,4,0.8695652173913043,0.9090909090909092
2022,KHOUALKA,MACROPHYLLA,20118,IMG-00007-40.jpg,44,42,41,1,3,0.9761904761904762,0.9318181818181818
2022,KHOUALKA,MACROPHYLLA,20118,IMG-00008-40.jpg,115,113,108,5,7,0.9557522123893806,0.9391304347826088
2022,KHOUALKA,MACROPHYLLA,20118,IMG-00022-40.jpg,113,107,104,3,9,0.97196261682243,0.9203539823008848
2022,KHOUALKA,MACROPHYLLA,20118,IMG-00033-40.jpg,58,56,55,1,3,0.9821428571428572,0.9482758620689656
2022,KHOUALKA,MACROPHYLLA,20118,IMG-00037-40.jpg,29,28,26,2,3,0.9285714285714286,0.896551724137931
2022,KHOUALKA,MACROPHYLLA,20118,IMG-00042-40.jpg,137,131,124,7,13,0.9465648854961832,0.9051094890510948
2022,KHOUALKA,MACROPHYLLA,20118,IMG-00046-40.jpg,45,46,43,3,2,0.9347826086956522,0.9555555555555556
2022,KHOUALKA,MACROPHYLLA,20118,IMG-00050-40.jpg,48,42,41,1,7,0.9761904761904762,0.8541666666666666
2022,KHOUALKA,MACROPHYLLA,20118,IMG-00055-40.jpg,52,48,46,2,6,0.9583333333333334,0.8846153846153846
2022,KHOUALKA,MACROPHYLLA,20118,IMG-00061-40.jpg,120,116,104,12,16,0.896551724137931,0.8666666666666667
2022,KHOUALKA,MACROPHYLLA,20118,IMG-00062-40.jpg,63,60,54,6,9,0.9,0.8571428571428571
2022,KHOUALKA,MACROPHYLLA,20118,IMG-00063-40.jpg,47,46,42,4,5,0.9130434782608696,0.8936170212765957
2022,KHOUALKA,MACROPHYLLA,20118,IMG-00066-40.jpg,84,76,71,5,13,0.9342105263157896,0.8452380952380952
2024,KHOUALKA,MACROPHYLLA,20118,IMG-12691.jpg,22,14,14,0,8,1.0,0.6363636363636364
2024,KHOUALKA,MACROPHYLLA,20118,IMG-12729.jpg,56,40,39,1,17,0.975,0.6964285714285714
2024,KHOUALKA,MACROPHYLLA,20118,IMG-12735.jpg,88,58,58,0,30,1.0,0.6590909090909091
2024,KHOUALKA,MACROPHYLLA,20118,IMG-12748.jpg,107,72,72,0,35,1.0,0.6728971962616822
2024,KHOUALKA,MACROPHYLLA,20118,IMG-12764.jpg,111,90,89,1,22,0.9888888888888888,0.8018018018018018
2024,KHOUALKA,MACROPHYLLA,20118,IMG-12808.jpg,113,73,72,1,41,0.9863013698630136,0.6371681415929203
2024,KHOUALKA,MACROPHYLLA,20118,IMG-12851.jpg,24,10,10,0,14,1.0,0.4166666666666667
2022,KHOUALKA,MACROPHYLLA,20119,IMG-00005-40.jpg,106,98,94,4,12,0.9591836734693876,0.8867924528301887
2022,KHOUALKA,MACROPHYLLA,20119,IMG-00008-40.jpg,142,125,121,4,21,0.968,0.852112676056338
2022,KHOUALKA,MACROPHYLLA,20119,IMG-00014-40.jpg,132,122,120,2,12,0.9836065573770492,0.9090909090909092
2022,KHOUALKA,BIGARADIER,20132,IMG-00004-40.jpg,181,171,168,3,13,0.9824561403508772,0.9281767955801103
2022,KHOUALKA,BIGARADIER,20132,IMG-00025-40.jpg,91,83,80,3,11,0.963855421686747,0.8791208791208791
2022,KHOUALKA,BIGARADIER,20132,IMG-00028-40.jpg,49,49,45,4,4,0.9183673469387756,0.9183673469387756
2022,KHOUALKA,BIGARADIER,20132,IMG-00035-40.jpg,103,110,101,9,2,0.9181818181818182,0.9805825242718448
2022,KHOUALKA,BIGARADIER,20132,IMG-00039-40.jpg,119,117,110,7,9,0.9401709401709402,0.9243697478991596
2022,KHOUALKA,BIGARADIER,20132,IMG-00046-40.jpg,156,151,148,3,8,0.9801324503311258,0.9487179487179488
2022,KHOUALKA,BIGARADIER,20132,IMG-00051-40.jpg,108,98,96,2,12,0.979591836734694,0.8888888888888888
2022,KHOUALKA,BIGARADIER,20132,IMG-00055-40.jpg,67,63,60,3,7,0.9523809523809524,0.8955223880597015
2022,KHOUALKA,BIGARADIER,20132,IMG-00058-40.jpg,89,80,80,0,9,1.0,0.898876404494382
2022,KHOUALKA,BIGARADIER,20132,IMG-00059-40.jpg,139,128,124,4,15,0.96875,0.8920863309352518
2022,KHOUALKA,BIGARADIER,20132,IMG-00060-40.jpg,57,50,46,4,11,0.92,0.8070175438596491
2022,KHOUALKA,BIGARADIER,20132,IMG-00064-40.jpg,117,106,101,5,16,0.9528301886792452,0.8632478632478633
2022,KHOUALKA,BIGARADIER,20132,IMG-00075-40.jpg,69,66,64,2,5,0.9696969696969696,0.927536231884058
2022,ONAGRI,BIGARADIER,20139,IMG-00021-39.jpg,93,92,88,4,5,0.9565217391304348,0.946236559139785
2024,KHOUALKA,CITRUS VOLKAMERIANA,20205,IMG-12040.jpg,123,85,83,2,40,0.976470588235294,0.6747967479674797
2024,KHOUALKA,CITRUS VOLKAMERIANA,20205,IMG-12058.jpg,116,113,109,4,7,0.9646017699115044,0.9396551724137931
2022,SAOUDA,CITRUS VOLKAMERIANA,21020,IMG-00033-45.jpg,67,67,63,4,4,0.9402985074626866,0.9402985074626866
2022,SAOUDA,CITRUS VOLKAMERIANA,21020,IMG-00087-45.jpg,21,18,18,0,3,1.0,0.8571428571428571
2022,SAOUDA,CITRUS VOLKAMERIANA,21020,IMG-00138-45.jpg,40,39,36,3,4,0.9230769230769232,0.9
2022,SAOUDA,CITRUS VOLKAMERIANA,21020,IMG-00145-45.jpg,37,37,34,3,3,0.918918918918919,0.918918918918919
2022,SAOUDA,CITRUS VOLKAMERIANA,21020,IMG-00155-45.jpg,38,40,37,3,1,0.925,0.9736842105263158
2022,SAOUDA,CITRUS VOLKAMERIANA,21030,IMG-00521-45.jpg,31,34,30,4,1,0.8823529411764706,0.967741935483871
2022,SAOUDA,CITRUS VOLKAMERIANA,21030,IMG-00524-45.jpg,71,69,66,3,5,0.9565217391304348,0.9295774647887324
2022,SAOUDA,CITRUS VOLKAMERIANA,21030,IMG-00536-45.jpg,41,45,37,8,4,0.8222222222222222,0.902439024390244
2022,SAOUDA,CITRUS VOLKAMERIANA,21030,IMG-00537-45.jpg,52,51,43,8,9,0.8431372549019608,0.8269230769230769
2022,SAOUDA,CITRUS VOLKAMERIANA,22020,IMG-00053-45.jpg,39,39,35,4,4,0.8974358974358975,0.8974358974358975
2022,SAOUDA,CITRUS VOLKAMERIANA,22020,IMG-00059-45.jpg,46,44,41,3,5,0.9318181818181818,0.8913043478260869
2022,SAOUDA,CITRUS VOLKAMERIANA,22020,IMG-00060-45.jpg,48,46,44,2,4,0.9565217391304348,0.9166666666666666
2022,SAOUDA,CITRUS VOLKAMERIANA,22020,IMG-00062-45.jpg,50,51,49,2,1,0.9607843137254902,0.98
2022,SAOUDA,CITRUS VOLKAMERIANA,22030,IMG-00062-45.jpg,62,64,57,7,5,0.890625,0.9193548387096774
2022,SAOUDA,CITRUS VOLKAMERIANA,22030,IMG-00063-45.jpg,83,78,72,6,11,0.9230769230769232,0.8674698795180723
2022,SAOUDA,CITRUS VOLKAMERIANA,22030,IMG-00065-45.jpg,58,59,53,6,5,0.8983050847457628,0.913793103448276
2022,SAOUDA,CITRUS VOLKAMERIANA,22030,IMG-00068-45.jpg,66,60,58,2,8,0.9666666666666668,0.8787878787878788
2022,SAOUDA,CITRUS VOLKAMERIANA,23020,IMG-00024-45.jpg,47,52,43,9,4,0.8269230769230769,0.9148936170212766
2022,SAOUDA,CITRUS VOLKAMERIANA,23020,IMG-00032-45.jpg,33,33,32,1,1,0.9696969696969696,0.9696969696969696
2022,SAOUDA,CITRUS VOLKAMERIANA,23020,IMG-00074-45.jpg,28,31,25,6,3,0.8064516129032258,0.8928571428571429
2022,SAOUDA,CITRUS VOLKAMERIANA,23020,IMG-00079-45.jpg,28,28,25,3,3,0.8928571428571429,0.8928571428571429
2022,SAOUDA,CITRUS VOLKAMERIANA,23030,IMG-00014-45.jpg,25,23,21,2,4,0.9130434782608696,0.84
2022,SAOUDA,CITRUS VOLKAMERIANA,23030,IMG-00034-45.jpg,43,41,37,4,6,0.902439024390244,0.8604651162790697
2022,SAOUDA,CITRUS VOLKAMERIANA,23030,IMG-00069-45.jpg,28,30,25,5,3,0.8333333333333334,0.8928571428571429
2022,SAOUDA,CITRUS VOLKAMERIANA,23030,IMG-00079-45.jpg,50,57,48,9,2,0.8421052631578947,0.96
2022,SAOUDA,CITRANGE CARRIZO,24010,IMG-00097-45.jpg,59,55,54,1,5,0.9818181818181818,0.9152542372881356
2022,SAOUDA,CITRANGE CARRIZO,24010,IMG-00101-45.jpg,27,29,24,5,3,0.8275862068965517,0.8888888888888888
2022,SAOUDA,CITRANGE CARRIZO,24010,IMG-00111-45.jpg,54,52,51,1,3,0.9807692307692308,0.9444444444444444
2022,SAOUDA,CITRANGE CARRIZO,24010,IMG-00112-45.jpg,40,35,35,0,5,1.0,0.875
2022,SAOUDA,CITRANGE CARRIZO,25010,IMG-00006-45.jpg,55,51,47,4,8,0.9215686274509804,0.8545454545454545
2022,SAOUDA,CITRANGE CARRIZO,25010,IMG-00007-45.jpg,77,77,74,3,3,0.961038961038961,0.961038961038961
2022,SAOUDA,CITRANGE CARRIZO,25010,IMG-00010-45.jpg,53,54,49,5,4,0.9074074074074074,0.9245283018867924
2022,SAOUDA,CITRANGE CARRIZO,25010,IMG-00011-45.jpg,26,28,26,2,0,0.9285714285714286,1.0
2022,SAOUDA,CITRANGE CARRIZO,26010,IMG-00008-45.jpg,39,37,36,1,3,0.972972972972973,0.9230769230769232
2022,SAOUDA,CITRANGE CARRIZO,26010,IMG-00013-45.jpg,36,35,33,2,3,0.9428571428571428,0.9166666666666666
2022,SAOUDA,CITRANGE CARRIZO,26010,IMG-00018-45.jpg,43,44,42,2,1,0.9545454545454546,0.9767441860465116
2022,SAOUDA,CITRANGE CARRIZO,26010,IMG-00020-45.jpg,44,44,40,4,4,0.9090909090909092,0.9090909090909092
2022,KHOUALKA,CITRANGE CARRIZO,30138,IMG-00002-40.jpg,39,38,36,2,3,0.9473684210526316,0.9230769230769232
2022,KHOUALKA,CITRANGE CARRIZO,30138,IMG-00003-40.jpg,59,56,53,3,6,0.9464285714285714,0.8983050847457628
2022,KHOUALKA,CITRANGE CARRIZO,30138,IMG-00005-40.jpg,58,53,50,3,8,0.9433962264150944,0.8620689655172413
2022,KHOUALKA,CITRANGE CARRIZO,30138,IMG-00008-40.jpg,32,29,27,2,5,0.9310344827586208,0.84375
2022,KHOUALKA,CITRANGE CARRIZO,30138,IMG-00011-40.jpg,26,28,26,2,0,0.9285714285714286,1.0
2022,KHOUALKA,CITRANGE CARRIZO,30138,IMG-00019-40.jpg,2,2,2,0,0,1.0,1.0
2022,KHOUALKA,CITRANGE CARRIZO,30138,IMG-00037-40.jpg,30,32,29,3,1,0.90625,0.9666666666666668
2022,KHOUALKA,CITRANGE CARRIZO,30138,IMG-00040-40.jpg,41,41,41,0,0,1.0,1.0
2022,KHOUALKA,CITRANGE CARRIZO,30138,IMG-00043-40.jpg,28,26,23,3,5,0.8846153846153846,0.8214285714285714
2022,KHOUALKA,CITRANGE CARRIZO,30138,IMG-00044-40.jpg,99,91,90,1,9,0.989010989010989,0.9090909090909092
2022,KHOUALKA,CITRANGE CARRIZO,30138,IMG-00048-40.jpg,37,39,32,7,5,0.8205128205128205,0.8648648648648649
2022,KHOUALKA,CITRANGE CARRIZO,30138,IMG-00057-40.jpg,73,73,66,7,7,0.9041095890410958,0.9041095890410958
2022,KHOUALKA,CITRANGE CARRIZO,30138,IMG-00063-40.jpg,89,81,79,2,10,0.9753086419753086,0.8876404494382022
2022,ONAGRI,CITRUS VOLKAMERIANA,30145,IMG-00018-39.jpg,219,223,209,14,10,0.937219730941704,0.954337899543379
2022,ONAGRI,CITRUS VOLKAMERIANA,30145,IMG-00043-39.jpg,64,66,62,4,2,0.9393939393939394,0.96875
2022,ONAGRI,CITRUS VOLKAMERIANA,30146,IMG-00008-39.jpg,262,271,254,17,8,0.9372693726937268,0.9694656488549618
2022,ONAGRI,CITRUS VOLKAMERIANA,30146,IMG-00045-39.jpg,190,207,178,29,12,0.8599033816425121,0.936842105263158
2022,ONAGRI,CITRUS VOLKAMERIANA,30147,IMG-00002-39.jpg,269,283,263,20,6,0.9293286219081272,0.9776951672862454
2022,ONAGRI,CITRUS VOLKAMERIANA,30147,IMG-00008-39.jpg,172,184,164,20,8,0.8913043478260869,0.9534883720930232
2022,ONAGRI,CITRUS VOLKAMERIANA,30148,IMG-00016-40.jpg,88,84,83,1,5,0.988095238095238,0.9431818181818182
2022,ONAGRI,CITRUS VOLKAMERIANA,30148,IMG-00047-40.jpg,34,32,32,0,2,1.0,0.9411764705882352
2022,ONAGRI,CITRUS VOLKAMERIANA,30149,IMG-00018-39.jpg,151,148,142,6,9,0.9594594594594594,0.9403973509933776
2022,ONAGRI,CITRUS VOLKAMERIANA,30149,IMG-00027-39.jpg,226,212,202,10,24,0.9528301886792452,0.8938053097345132
2022,ONAGRI,CITRUS VOLKAMERIANA,30151,IMG-00012-39.jpg,185,186,171,15,14,0.9193548387096774,0.9243243243243244
2022,ONAGRI,CITRUS VOLKAMERIANA,30151,IMG-00033-39.jpg,214,209,194,15,20,0.9282296650717704,0.9065420560747663
2024,ONAGRI,CITRUS VOLKAMERIANA,30151,IMG-21881.jpg,73,47,47,0,26,1.0,0.6438356164383562
2024,ONAGRI,CITRUS VOLKAMERIANA,30151,IMG-21935.jpg,179,77,77,0,102,1.0,0.4301675977653631
2024,ONAGRI,CITRUS VOLKAMERIANA,30151,IMG-21936.jpg,93,48,48,0,45,1.0,0.5161290322580645
2022,ONAGRI,CITRUS VOLKAMERIANA,30152,IMG-00016-39.jpg,39,39,35,4,4,0.8974358974358975,0.8974358974358975
2022,ONAGRI,CITRUS VOLKAMERIANA,30152,IMG-00019-39.jpg,139,137,131,6,8,0.9562043795620438,0.9424460431654677
2022,ONAGRI,CITRUS VOLKAMERIANA,30153,IMG-00001.jpg,157,151,147,4,10,0.9735099337748344,0.9363057324840764
2022,ONAGRI,CITRUS VOLKAMERIANA,30153,IMG-00007-39.jpg,127,121,117,4,10,0.9669421487603306,0.9212598425196852
2022,ONAGRI,CITRUS VOLKAMERIANA,30153,IMG-00013-39.jpg,159,136,133,3,26,0.9779411764705882,0.8364779874213837
2022,ONAGRI,CITRUS VOLKAMERIANA,30153,IMG-00040-39.jpg,153,149,144,5,9,0.9664429530201344,0.9411764705882352
2022,ONAGRI,CITRUS VOLKAMERIANA,30154,IMG-00017-39.jpg,160,162,156,6,4,0.9629629629629628,0.975
2022,ONAGRI,CITRUS VOLKAMERIANA,30154,IMG-00027-39.jpg,220,221,216,5,4,0.9773755656108596,0.9818181818181818
2022,ONAGRI,CITRUS VOLKAMERIANA,30154,IMG-00033-39.jpg,51,50,50,0,1,1.0,0.9803921568627452
2022,ONAGRI,CITRUS VOLKAMERIANA,30154,IMG-00036-39.jpg,137,138,134,4,3,0.9710144927536232,0.978102189781022
2022,ONAGRI,CITRUS VOLKAMERIANA,30154,IMG-00038-39.jpg,242,244,239,5,3,0.9795081967213116,0.987603305785124
2022,ONAGRI,CITRUS VOLKAMERIANA,30154,IMG-00041-39.jpg,272,268,260,8,12,0.9701492537313432,0.9558823529411764
2022,ONAGRI,CITRUS VOLKAMERIANA,30154,IMG-00044-39.jpg,141,144,137,7,4,0.9513888888888888,0.9716312056737588
2022,ONAGRI,BIGARADIER,30155,IMG-00002-39.jpg,139,142,136,6,3,0.9577464788732394,0.9784172661870504
2022,ONAGRI,BIGARADIER,30155,IMG-00003-39.jpg,115,112,109,3,6,0.9732142857142856,0.9478260869565216
2022,ONAGRI,BIGARADIER,30155,IMG-00006-39.jpg,44,45,42,3,2,0.9333333333333332,0.9545454545454546
2022,ONAGRI,BIGARADIER,30155,IMG-00011-39.jpg,100,97,96,1,4,0.9896907216494846,0.96
2022,ONAGRI,BIGARADIER,30155,IMG-00019-39.jpg,142,135,130,5,12,0.9629629629629628,0.9154929577464788
2022,ONAGRI,BIGARADIER,30155,IMG-00026-39.jpg,124,116,113,3,11,0.9741379310344828,0.9112903225806452
2022,ONAGRI,BIGARADIER,30155,IMG-00032-39.jpg,81,78,75,3,6,0.9615384615384616,0.925925925925926
2022,ONAGRI,BIGARADIER,30155,IMG-00039-39.jpg,19,17,17,0,2,1.0,0.8947368421052632
2022,ONAGRI,BIGARADIER,30155,IMG-00043-39.jpg,130,131,125,6,5,0.9541984732824428,0.9615384615384616
2022,ONAGRI,CITRUS VOLKAMERIANA,30157,IMG-00003-39.jpg,227,213,204,9,23,0.9577464788732394,0.8986784140969163
2022,ONAGRI,CITRUS VOLKAMERIANA,30157,IMG-00012-39.jpg,283,283,274,9,9,0.9681978798586572,0.9681978798586572
2022,ONAGRI,CITRUS VOLKAMERIANA,30157,IMG-00032-39.jpg,64,66,60,6,4,0.9090909090909092,0.9375
2022,ONAGRI,CITRUS VOLKAMERIANA,30157,IMG-00035-39.jpg,159,159,155,4,4,0.9748427672955976,0.9748427672955976
2022,KHOUALKA,CITRUS VOLKAMERIANA,30235,IMG-00001.jpg,93,89,86,3,7,0.9662921348314608,0.9247311827956988
2022,KHOUALKA,CITRUS VOLKAMERIANA,30235,IMG-00003-40.jpg,37,37,34,3,3,0.918918918918919,0.918918918918919
2022,KHOUALKA,CITRUS VOLKAMERIANA,30235,IMG-00009-40.jpg,103,103,96,7,7,0.9320388349514565,0.9320388349514565
2022,KHOUALKA,CITRUS VOLKAMERIANA,30235,IMG-00013-40.jpg,90,95,85,10,5,0.8947368421052632,0.9444444444444444
2022,KHOUALKA,CITRUS VOLKAMERIANA,30235,IMG-00026-40.jpg,122,123,117,6,5,0.951219512195122,0.9590163934426228
2022,KHOUALKA,CITRUS VOLKAMERIANA,30235,IMG-00047-40.jpg,47,55,44,11,3,0.8,0.9361702127659576
2022,KHOUALKA,CITRUS VOLKAMERIANA,30235,IMG-00048-40.jpg,90,93,86,7,4,0.9247311827956988,0.9555555555555556
2022,KHOUALKA,CITRUS VOLKAMERIANA,30235,IMG-00049-40.jpg,44,43,40,3,4,0.9302325581395348,0.9090909090909092
2022,KHOUALKA,CITRUS VOLKAMERIANA,30235,IMG-00050-40.jpg,84,77,73,4,11,0.948051948051948,0.8690476190476191
2022,KHOUALKA,CITRUS VOLKAMERIANA,30235,IMG-00052-40.jpg,98,92,89,3,9,0.967391304347826,0.9081632653061223
2022,KHOUALKA,CITRUS VOLKAMERIANA,30235,IMG-00057-40.jpg,80,79,75,4,5,0.9493670886075948,0.9375
2022,KHOUALKA,CITRUS VOLKAMERIANA,30235,IMG-00064-40.jpg,38,46,36,10,2,0.782608695652174,0.9473684210526316
2022,KHOUALKA,CITRUS VOLKAMERIANA,30235,IMG-00067-40.jpg,107,94,91,3,16,0.9680851063829788,0.8504672897196262
2022,KHOUALKA,CITRUS VOLKAMERIANA,30235,IMG-00069-40.jpg,34,42,34,8,0,0.8095238095238095,1.0
2022,KHOUALKA,CITRUS VOLKAMERIANA,30235,IMG-00075-40.jpg,95,92,84,8,11,0.9130434782608696,0.8842105263157894
2022,KHOUALKA,BIGARADIER,40141,IMG-00006-40.jpg,7,7,6,1,1,0.8571428571428571,0.8571428571428571
2022,KHOUALKA,BIGARADIER,40141,IMG-00007-40.jpg,20,10,10,0,10,1.0,0.5
2022,KHOUALKA,BIGARADIER,40141,IMG-00008-40.jpg,15,13,13,0,2,1.0,0.8666666666666667
2022,ONAGRI,CITRANGE C35,40166,IMG-00009-39.jpg,38,36,34,2,4,0.9444444444444444,0.8947368421052632
2022,ONAGRI,CITRANGE C35,40166,IMG-00011-39.jpg,173,163,156,7,17,0.9570552147239264,0.9017341040462428
2022,ONAGRI,CITRANGE C35,40166,IMG-00014-39.jpg,179,177,168,9,11,0.9491525423728814,0.9385474860335196
2022,ONAGRI,CITRANGE C35,40166,IMG-00015-39.jpg,122,118,115,3,7,0.9745762711864406,0.9426229508196722
2022,ONAGRI,CITRANGE C35,40166,IMG-00041-39.jpg,102,99,98,1,4,0.98989898989899,0.9607843137254902
2022,ONAGRI,CITRANGE C35,40167,IMG-00019-39.jpg,197,186,184,2,13,0.989247311827957,0.934010152284264
2022,ONAGRI,CITRANGE C35,40167,IMG-00030-39.jpg,126,122,121,1,5,0.9918032786885246,0.9603174603174603
2022,ONAGRI,CITRANGE C35,40167,IMG-00039-39.jpg,217,190,182,8,35,0.9578947368421052,0.8387096774193549
2022,ONAGRI,CITRANGE C35,40171,IMG-00008-39.jpg,109,96,93,3,16,0.96875,0.8532110091743119
2022,ONAGRI,CITRANGE C35,40171,IMG-00037-39.jpg,94,84,80,4,14,0.9523809523809524,0.851063829787234
2022,ONAGRI,CITRANGE C35,40171,IMG-00040-39.jpg,149,136,130,6,19,0.9558823529411764,0.87248322147651
2022,ONAGRI,CITRANGE C35,40172,IMG-00012-39.jpg,89,84,83,1,6,0.988095238095238,0.9325842696629212
2022,ONAGRI,CITRANGE C35,40172,IMG-00025-39.jpg,109,100,100,0,9,1.0,0.9174311926605504
2022,ONAGRI,CITRANGE C35,40172,IMG-00027-39.jpg,103,97,94,3,9,0.9690721649484536,0.912621359223301
2022,ONAGRI,CITRANGE C35,40173,IMG-00004-39.jpg,133,110,108,2,25,0.9818181818181818,0.8120300751879699
2022,ONAGRI,CITRANGE C35,40173,IMG-00008-39.jpg,57,49,49,0,8,1.0,0.8596491228070176
2022,ONAGRI,CITRANGE C35,40173,IMG-00010-39.jpg,53,52,50,2,3,0.9615384615384616,0.9433962264150944
2022,ONAGRI,CITRANGE C35,40175,IMG-00005-39.jpg,95,88,85,3,10,0.9659090909090908,0.8947368421052632
2022,ONAGRI,CITRANGE C35,40175,IMG-00006-39.jpg,64,63,62,1,2,0.984126984126984,0.96875
2022,ONAGRI,CITRANGE C35,40176,IMG-00004-39.jpg,79,84,74,10,5,0.8809523809523809,0.9367088607594936
2022,ONAGRI,CITRANGE C35,40176,IMG-00012-39.jpg,105,107,102,5,3,0.9532710280373832,0.9714285714285714
2022,ONAGRI,CITRANGE C35,40176,IMG-00014-39.jpg,91,96,83,13,8,0.8645833333333334,0.912087912087912
2022,ONAGRI,CITRUMELO SACCATON,40177,IMG-00012-39.jpg,89,94,82,12,7,0.8723404255319149,0.9213483146067416
2022,ONAGRI,CITRUMELO SACCATON,40177,IMG-00015-39.jpg,213,224,211,13,2,0.9419642857142856,0.9906103286384976
2022,ONAGRI,CITRUMELO SACCATON,40177,IMG-00037-39.jpg,95,97,92,5,3,0.9484536082474226,0.968421052631579
2022,ONAGRI,CITRANGE C35,40178,IMG-00013-39.jpg,76,79,76,3,0,0.9620253164556962,1.0
2022,ONAGRI,CITRANGE C35,40178,IMG-00027-39.jpg,56,56,54,2,2,0.9642857142857144,0.9642857142857144
2022,ONAGRI,CITRANGE C35,40178,IMG-00031-39.jpg,30,32,30,2,0,0.9375,1.0
2022,ONAGRI,CITRANGE C35,40178,IMG-00032-39.jpg,27,27,26,1,1,0.9629629629629628,0.9629629629629628
2022,ONAGRI,CITRANGE C35,40178,IMG-00033-39.jpg,34,37,34,3,0,0.918918918918919,1.0
2022,ONAGRI,CITRANGE C35,40179,IMG-00001.jpg,83,86,82,4,1,0.9534883720930232,0.9879518072289156
2022,ONAGRI,CITRANGE C35,40179,IMG-00010-39.jpg,161,168,155,13,6,0.9226190476190476,0.9627329192546584
2022,ONAGRI,CITRANGE C35,40179,IMG-00011-39.jpg,102,108,100,8,2,0.925925925925926,0.9803921568627452
2022,ONAGRI,CITRANGE C35,40179,IMG-00018-39.jpg,9,9,9,0,0,1.0,1.0
2022,ONAGRI,CITRUMELO SACCATON,40182,IMG-00004-39.jpg,35,35,34,1,1,0.9714285714285714,0.9714285714285714
2022,ONAGRI,CITRUMELO SACCATON,40182,IMG-00010-39.jpg,52,51,49,2,3,0.9607843137254902,0.9423076923076924
2022,ONAGRI,CITRUMELO SACCATON,40182,IMG-00015-39.jpg,85,80,74,6,11,0.925,0.8705882352941177
2022,ONAGRI,CITRUMELO SACCATON,40183,IMG-00005-39.jpg,68,63,61,2,7,0.9682539682539684,0.8970588235294118
2022,ONAGRI,CITRUMELO SACCATON,40183,IMG-00009-39.jpg,57,57,56,1,1,0.9824561403508772,0.9824561403508772
2022,ONAGRI,CITRUMELO SACCATON,40183,IMG-00010-39.jpg,48,42,40,2,8,0.9523809523809524,0.8333333333333334
2024,KHOUALKA,CITRUS VOLKAMERIANA,50152,IMG-17274.jpg,170,127,124,3,46,0.9763779527559056,0.7294117647058823
2024,KHOUALKA,CITRUS VOLKAMERIANA,50152,IMG-17306.jpg,105,81,81,0,24,1.0,0.7714285714285715
2024,KHOUALKA,CITRUS VOLKAMERIANA,50152,IMG-17330.jpg,41,28,28,0,13,1.0,0.6829268292682927
2024,KHOUALKA,CITRUS VOLKAMERIANA,50152,IMG-17335.jpg,44,31,31,0,13,1.0,0.7045454545454546
2024,KHOUALKA,CITRUS VOLKAMERIANA,50152,IMG-17340.jpg,108,69,68,1,40,0.9855072463768116,0.6296296296296297
2024,KHOUALKA,CITRUS VOLKAMERIANA,50152,IMG-17356.jpg,60,41,41,0,19,1.0,0.6833333333333333
2024,KHOUALKA,CITRUS VOLKAMERIANA,50152,IMG-17384.jpg,53,30,30,0,23,1.0,0.5660377358490566
2024,KHOUALKA,CITRUS VOLKAMERIANA,50154,IMG-17440.jpg,76,63,63,0,13,1.0,0.8289473684210527
2024,KHOUALKA,CITRUS VOLKAMERIANA,50154,IMG-17490.jpg,107,71,71,0,36,1.0,0.6635514018691588
2024,KHOUALKA,CITRUS VOLKAMERIANA,50154,IMG-17543.jpg,100,67,67,0,33,1.0,0.67
2024,KHOUALKA,CITRUS VOLKAMERIANA,50154,IMG-17545.jpg,94,65,64,1,30,0.9846153846153848,0.6808510638297872
2024,KHOUALKA,CITRUS VOLKAMERIANA,50154,IMG-17562.jpg,129,100,100,0,29,1.0,0.7751937984496124
2024,KHOUALKA,CITRUS VOLKAMERIANA,50154,IMG-17576.jpg,121,95,95,0,26,1.0,0.7851239669421488
2024,KHOUALKA,CITRUS VOLKAMERIANA,50154,IMG-17585.jpg,171,120,118,2,53,0.9833333333333332,0.6900584795321637
2024,KHOUALKA,CITRUS VOLKAMERIANA,50168,IMG-13980.jpg,174,121,120,1,54,0.9917355371900828,0.6896551724137931
2024,KHOUALKA,CITRUS VOLKAMERIANA,50168,IMG-15749.jpg,147,109,108,1,39,0.9908256880733946,0.7346938775510204
2024,KHOUALKA,CITRUS VOLKAMERIANA,50168,IMG-15758.jpg,163,112,108,4,55,0.9642857142857144,0.6625766871165644
2024,KHOUALKA,CITRUS VOLKAMERIANA,50168,IMG-15981.jpg,210,153,153,0,57,1.0,0.7285714285714285
2024,KHOUALKA,CITRUS VOLKAMERIANA,50168,IMG-15983.jpg,120,82,82,0,38,1.0,0.6833333333333333
2024,KHOUALKA,CITRUS VOLKAMERIANA,50176,IMG-16025.jpg,81,61,59,2,22,0.9672131147540984,0.7283950617283951
2024,KHOUALKA,CITRUS VOLKAMERIANA,50176,IMG-16051.jpg,85,57,57,0,28,1.0,0.6705882352941176
2024,KHOUALKA,CITRUS VOLKAMERIANA,50176,IMG-16079.jpg,161,116,114,2,47,0.9827586206896552,0.7080745341614907
2024,KHOUALKA,CITRUS VOLKAMERIANA,50176,IMG-16095.jpg,101,63,62,1,39,0.984126984126984,0.6138613861386139
2024,KHOUALKA,CITRUS VOLKAMERIANA,50176,IMG-16105.jpg,43,31,31,0,12,1.0,0.7209302325581395
2022,ONAGRI,CITRUMELO SACCATON,50193,IMG-00007-39.jpg,218,207,207,0,11,1.0,0.9495412844036696
2022,ONAGRI,CITRUMELO SACCATON,50193,IMG-00016-39.jpg,64,63,61,2,3,0.9682539682539684,0.953125
2022,ONAGRI,CITRUMELO SACCATON,50193,IMG-00018-39.jpg,115,113,113,0,2,1.0,0.982608695652174
2022,ONAGRI,CITRUMELO SACCATON,50193,IMG-00021-39.jpg,62,60,60,0,2,1.0,0.967741935483871
2022,ONAGRI,CITRUMELO SACCATON,50193,IMG-00023-39.jpg,113,113,111,2,2,0.9823008849557522,0.9823008849557522
2022,ONAGRI,CITRUMELO SACCATON,50194,IMG-00032-39.jpg,162,153,150,3,12,0.9803921568627452,0.925925925925926
2022,ONAGRI,CITRUMELO SACCATON,50194,IMG-00034-39.jpg,105,105,104,1,1,0.9904761904761904,0.9904761904761904
2022,ONAGRI,CITRUMELO SACCATON,50194,IMG-00036-39.jpg,161,153,152,1,9,0.9934640522875816,0.9440993788819876
2022,ONAGRI,CITRUMELO SACCATON,50194,IMG-00038-39.jpg,100,98,96,2,4,0.979591836734694,0.96
2022,ONAGRI,CITRUMELO SACCATON,50194,IMG-00039-39.jpg,65,63,63,0,2,1.0,0.9692307692307692
2022,ONAGRI,CITRUMELO SACCATON,50194,IMG-00041-39.jpg,153,146,146,0,7,1.0,0.954248366013072
2022,ONAGRI,CITRUMELO SACCATON,50194,IMG-00051-39.jpg,137,132,132,0,5,1.0,0.9635036496350364
2022,ONAGRI,CITRUMELO SACCATON,50194,IMG-00054-39.jpg,111,104,103,1,8,0.9903846153846154,0.927927927927928
2022,ONAGRI,CITRUMELO SACCATON,51091,IMG-00015-39.jpg,85,79,78,1,7,0.9873417721518988,0.9176470588235294
2022,ONAGRI,CITRUMELO SACCATON,51091,IMG-00016-39.jpg,170,167,165,2,5,0.9880239520958084,0.9705882352941176
2022,ONAGRI,CITRUMELO SACCATON,51091,IMG-00018-39.jpg,185,180,179,1,6,0.9944444444444444,0.9675675675675676
2022,ONAGRI,CITRUMELO SACCATON,51091,IMG-00022-39.jpg,135,133,131,2,4,0.9849624060150376,0.9703703703703704
2022,ONAGRI,CITRUMELO SACCATON,51091,IMG-00023-39.jpg,140,132,132,0,8,1.0,0.9428571428571428
2022,ONAGRI,CITRUMELO SACCATON,51091,IMG-00026-39.jpg,149,140,140,0,9,1.0,0.9395973154362416
2022,ONAGRI,CITRUMELO SACCATON,51091,IMG-00044-39.jpg,168,164,163,1,5,0.9939024390243902,0.9702380952380952
2022,ONAGRI,CITRUMELO SACCATON,51095,IMG-00004-39.jpg,201,191,189,2,12,0.9895287958115184,0.9402985074626866
2022,ONAGRI,CITRUMELO SACCATON,51095,IMG-00013-39.jpg,154,150,149,1,5,0.9933333333333332,0.9675324675324676
2022,ONAGRI,CITRUMELO SACCATON,51095,IMG-00014-39.jpg,140,135,133,2,7,0.9851851851851852,0.95
2022,ONAGRI,CITRUMELO SACCATON,51095,IMG-00015-39.jpg,196,191,191,0,5,1.0,0.9744897959183674
2022,ONAGRI,CITRUMELO SACCATON,51095,IMG-00024-39.jpg,234,226,225,1,9,0.995575221238938,0.9615384615384616
2022,ONAGRI,CITRUMELO SACCATON,51095,IMG-00025-39.jpg,198,190,188,2,10,0.9894736842105264,0.9494949494949496
2022,ONAGRI,CITRUMELO SACCATON,51096,IMG-00009-39.jpg,219,210,210,0,9,1.0,0.958904109589041
2022,ONAGRI,CITRUMELO SACCATON,51096,IMG-00011-39.jpg,145,136,133,3,12,0.9779411764705882,0.9172413793103448
2022,ONAGRI,CITRUMELO SACCATON,51096,IMG-00012-39.jpg,114,106,106,0,8,1.0,0.9298245614035088
2022,ONAGRI,CITRUMELO SACCATON,51096,IMG-00055-39.jpg,217,208,208,0,9,1.0,0.9585253456221198
2022,ONAGRI,MC PONSIRUCE TRIFOLIATA,51097,IMG-00025-39.jpg,121,115,113,2,8,0.982608695652174,0.9338842975206612
2022,ONAGRI,MC PONSIRUCE TRIFOLIATA,51097,IMG-00029-39.jpg,106,103,101,2,5,0.9805825242718448,0.9528301886792452
2022,ONAGRI,MC PONSIRUCE TRIFOLIATA,51097,IMG-00044-39.jpg,182,177,174,3,8,0.9830508474576272,0.956043956043956
2022,ONAGRI,MC PONSIRUCE TRIFOLIATA,51098,IMG-00003-39.jpg,65,61,61,0,4,1.0,0.9384615384615383
2022,ONAGRI,MC PONSIRUCE TRIFOLIATA,51098,IMG-00010-39.jpg,184,179,178,1,6,0.994413407821229,0.967391304347826
2022,ONAGRI,MC PONSIRUCE TRIFOLIATA,51098,IMG-00015-39.jpg,162,157,156,1,6,0.9936305732484076,0.9629629629629628
2022,ONAGRI,MC PONSIRUCE TRIFOLIATA,51099,IMG-00012-39.jpg,133,127,127,0,6,1.0,0.9548872180451128
2024,ONAGRI,MC PONSIRUCE TRIFOLIATA,51101,IMG-12118.jpg,177,107,107,0,70,1.0,0.6045197740112994
2024,ONAGRI,MC PONSIRUCE TRIFOLIATA,51101,IMG-14223.jpg,153,107,107,0,46,1.0,0.6993464052287581
2024,ONAGRI,MC PONSIRUCE TRIFOLIATA,51101,IMG-14226.jpg,151,108,107,1,44,0.9907407407407408,0.7086092715231788
2024,ONAGRI,MC PONSIRUCE TRIFOLIATA,51101,IMG-14255.jpg,189,143,142,1,47,0.993006993006993,0.7513227513227513
2024,ONAGRI,MC PONSIRUCE TRIFOLIATA,51101,IMG-14281.jpg,150,114,114,0,36,1.0,0.76
2022,ONAGRI,CITRUS VOLKAMERIANA,101020,IMG-00001.jpg,6,5,5,0,1,1.0,0.8333333333333334
2022,ONAGRI,CITRUS VOLKAMERIANA,101020,IMG-00004-44.jpg,53,34,34,0,19,1.0,0.6415094339622641
2022,ONAGRI,CITRUS VOLKAMERIANA,101030,IMG-00003-44.jpg,29,26,24,2,5,0.9230769230769232,0.8275862068965517
2022,ONAGRI,CITRUS VOLKAMERIANA,101030,IMG-00004-44.jpg,110,83,83,0,27,1.0,0.7545454545454545
2022,ONAGRI,CITRUS VOLKAMERIANA,101030,IMG-00005-44.jpg,134,99,96,3,38,0.9696969696969696,0.7164179104477612
2022,ONAGRI,CITRUS VOLKAMERIANA,101030,IMG-00017-44.jpg,79,54,51,3,28,0.9444444444444444,0.6455696202531646
2022,ONAGRI,CITRUS VOLKAMERIANA,101040,IMG-00005-44.jpg,172,127,125,2,47,0.984251968503937,0.7267441860465116
2022,ONAGRI,CITRUS VOLKAMERIANA,101040,IMG-00009-44.jpg,131,102,101,1,30,0.9901960784313726,0.7709923664122137
2022,ONAGRI,CITRUS VOLKAMERIANA,101040,IMG-00011-44.jpg,64,39,38,1,26,0.9743589743589745,0.59375
2022,ONAGRI,CITRUS VOLKAMERIANA,101040,IMG-00012-44.jpg,139,84,80,4,59,0.9523809523809524,0.5755395683453237
2022,ONAGRI,CITRUS VOLKAMERIANA,101050,IMG-00002-44.jpg,95,65,64,1,31,0.9846153846153848,0.6736842105263158
2022,ONAGRI,CITRUS VOLKAMERIANA,101050,IMG-00005-44.jpg,59,43,43,0,16,1.0,0.7288135593220338
2022,ONAGRI,CITRUS VOLKAMERIANA,101050,IMG-00011-44.jpg,46,20,19,1,27,0.95,0.4130434782608696
2022,ONAGRI,CITRUS VOLKAMERIANA,101050,IMG-00024-44.jpg,40,29,29,0,11,1.0,0.725
2022,ONAGRI,CITRUS VOLKAMERIANA,101080,IMG-00005-44.jpg,42,28,26,2,16,0.9285714285714286,0.6190476190476191
2022,ONAGRI,CITRUS VOLKAMERIANA,101080,IMG-00006-44.jpg,79,54,53,1,26,0.9814814814814816,0.6708860759493671
2022,ONAGRI,CITRUS VOLKAMERIANA,101080,IMG-00023-44.jpg,7,6,6,0,1,1.0,0.8571428571428571
2022,ONAGRI,CITRUS VOLKAMERIANA,101080,IMG-00024-44.jpg,27,15,15,0,12,1.0,0.5555555555555556
2022,ONAGRI,CITRUS VOLKAMERIANA,101090,IMG-00003-44.jpg,66,53,51,2,15,0.9622641509433962,0.7727272727272727
2022,ONAGRI,CITRUS VOLKAMERIANA,101090,IMG-00006-44.jpg,41,27,25,2,16,0.925925925925926,0.6097560975609756
2022,ONAGRI,CITRUS VOLKAMERIANA,101090,IMG-00019-44.jpg,35,28,27,1,8,0.9642857142857144,0.7714285714285715
2022,ONAGRI,CITRUS VOLKAMERIANA,101090,IMG-00020-44.jpg,42,31,29,2,13,0.935483870967742,0.6904761904761905
2022,KHOUALKA,CITRANGE CARRIZO,102130,IMG-00001.jpg,5,1,1,0,4,1.0,0.2
2022,KHOUALKA,CITRANGE CARRIZO,102130,IMG-00004-43.jpg,24,9,9,0,15,1.0,0.375
2022,KHOUALKA,CITRANGE CARRIZO,102130,IMG-00019-43.jpg,33,24,23,1,10,0.9583333333333334,0.696969696969697
2022,KHOUALKA,CITRANGE CARRIZO,102130,IMG-00020-43.jpg,18,12,10,2,8,0.8333333333333334,0.5555555555555556
2022,KHOUALKA,MACROPHYLLA,201180,IMG-00007-43.jpg,38,33,32,1,6,0.9696969696969696,0.8421052631578947
2022,KHOUALKA,MACROPHYLLA,201180,IMG-00011-43.jpg,64,36,36,0,28,1.0,0.5625
2022,KHOUALKA,MACROPHYLLA,201180,IMG-00019-43.jpg,64,39,39,0,25,1.0,0.609375
2022,KHOUALKA,MACROPHYLLA,201180,IMG-00020-43.jpg,43,30,29,1,14,0.9666666666666668,0.6744186046511628
2022,KHOUALKA,MACROPHYLLA,201190,IMG-00004-43.jpg,101,53,52,1,49,0.981132075471698,0.5148514851485149
2022,KHOUALKA,MACROPHYLLA,201190,IMG-00010-43.jpg,90,30,28,2,62,0.9333333333333332,0.3111111111111111
2022,KHOUALKA,MACROPHYLLA,201190,IMG-00011-43.jpg,134,49,49,0,85,1.0,0.3656716417910448
2022,KHOUALKA,MACROPHYLLA,201190,IMG-00020-43.jpg,95,47,47,0,48,1.0,0.4947368421052631
2022,KHOUALKA,CITRUS VOLKAMERIANA,201210,IMG-00011-43.jpg,103,64,64,0,39,1.0,0.6213592233009708
2022,KHOUALKA,CITRUS VOLKAMERIANA,201210,IMG-00012-43.jpg,42,22,22,0,20,1.0,0.5238095238095238
2022,KHOUALKA,CITRUS VOLKAMERIANA,201210,IMG-00015-43.jpg,77,39,38,1,39,0.9743589743589745,0.4935064935064935
2022,KHOUALKA,CITRUS VOLKAMERIANA,201210,IMG-00019-43.jpg,31,19,19,0,12,1.0,0.6129032258064516
2022,KHOUALKA,BIGARADIER,201320,IMG-00006-43.jpg,87,42,42,0,45,1.0,0.4827586206896552
2022,KHOUALKA,BIGARADIER,201320,IMG-00016-43.jpg,97,65,64,1,33,0.9846153846153848,0.6597938144329897
2022,KHOUALKA,BIGARADIER,201320,IMG-00017-43.jpg,49,37,36,1,13,0.972972972972973,0.7346938775510204
2022,KHOUALKA,BIGARADIER,201320,IMG-00020-43.jpg,88,58,57,1,31,0.9827586206896552,0.6477272727272727
2022,ONAGRI,BIGARADIER,201390,IMG-00008-44.jpg,62,27,26,1,36,0.9629629629629628,0.4193548387096774
2022,ONAGRI,BIGARADIER,201390,IMG-00011-44.jpg,90,50,46,4,44,0.92,0.5111111111111111
2022,ONAGRI,BIGARADIER,201390,IMG-00013-44.jpg,77,27,27,0,50,1.0,0.3506493506493507
2022,ONAGRI,BIGARADIER,201390,IMG-00016-44.jpg,69,27,27,0,42,1.0,0.391304347826087
2022,KHOUALKA,CITRUS VOLKAMERIANA,202050,IMG-00006-43.jpg,89,45,44,1,45,0.9777777777777776,0.4943820224719101
2022,KHOUALKA,CITRUS VOLKAMERIANA,202050,IMG-00010-43.jpg,94,50,50,0,44,1.0,0.5319148936170213
2022,KHOUALKA,CITRUS VOLKAMERIANA,202050,IMG-00011-43.jpg,151,75,75,0,76,1.0,0.4966887417218543
2022,KHOUALKA,CITRUS VOLKAMERIANA,202050,IMG-00020-43.jpg,129,65,64,1,65,0.9846153846153848,0.4961240310077519
2022,KHOUALKA,CITRUS VOLKAMERIANA,202070,IMG-00006-43.jpg,68,35,34,1,34,0.9714285714285714,0.5
2022,KHOUALKA,CITRUS VOLKAMERIANA,202070,IMG-00009-43.jpg,120,62,62,0,58,1.0,0.5166666666666667
2022,KHOUALKA,CITRUS VOLKAMERIANA,202070,IMG-00013-43.jpg,95,41,41,0,54,1.0,0.4315789473684211
2022,KHOUALKA,CITRUS VOLKAMERIANA,202070,IMG-00019-43.jpg,57,30,30,0,27,1.0,0.5263157894736842
2022,KHOUALKA,CITRUS VOLKAMERIANA,202080,IMG-00005-43.jpg,65,45,44,1,21,0.9777777777777776,0.676923076923077
2022,KHOUALKA,CITRUS VOLKAMERIANA,202080,IMG-00008-43.jpg,31,21,21,0,10,1.0,0.6774193548387096
2022,KHOUALKA,CITRUS VOLKAMERIANA,202080,IMG-00015-43.jpg,220,91,91,0,129,1.0,0.4136363636363636
2022,KHOUALKA,CITRUS VOLKAMERIANA,202080,IMG-00016-43.jpg,131,62,62,0,69,1.0,0.4732824427480916
2022,KHOUALKA,CITRANGE CARRIZO,301380,IMG-00007-43.jpg,30,17,16,1,14,0.9411764705882352,0.5333333333333333
2022,KHOUALKA,CITRANGE CARRIZO,301380,IMG-00011-43.jpg,53,35,34,1,19,0.9714285714285714,0.6415094339622641
2022,KHOUALKA,CITRANGE CARRIZO,301380,IMG-00014-43.jpg,7,4,4,0,3,1.0,0.5714285714285714
2022,KHOUALKA,CITRANGE CARRIZO,301380,IMG-00020-43.jpg,91,45,44,1,47,0.9777777777777776,0.4835164835164835
2022,ONAGRI,CITRUS VOLKAMERIANA,301470,IMG-00003-44.jpg,148,92,91,1,57,0.9891304347826086,0.6148648648648649
2022,ONAGRI,CITRUS VOLKAMERIANA,301470,IMG-00004-44.jpg,163,72,72,0,91,1.0,0.4417177914110429
2022,ONAGRI,CITRUS VOLKAMERIANA,301470,IMG-00005-44.jpg,160,57,57,0,103,1.0,0.35625
2022,ONAGRI,CITRUS VOLKAMERIANA,301480,IMG-00001.jpg,92,40,40,0,52,1.0,0.4347826086956522
2022,ONAGRI,CITRUS VOLKAMERIANA,301480,IMG-00003-43.jpg,26,11,10,1,16,0.9090909090909092,0.3846153846153846
2022,ONAGRI,CITRUS VOLKAMERIANA,301480,IMG-00012-43.jpg,50,24,24,0,26,1.0,0.48
2022,ONAGRI,CITRUS VOLKAMERIANA,301480,IMG-00014-43.jpg,77,34,34,0,43,1.0,0.4415584415584415
2022,ONAGRI,CITRUS VOLKAMERIANA,301490,IMG-00005-44.jpg,108,48,46,2,62,0.9583333333333334,0.4259259259259259
2022,ONAGRI,CITRUS VOLKAMERIANA,301490,IMG-00009-44.jpg,185,72,70,2,115,0.9722222222222222,0.3783783783783784
2022,ONAGRI,CITRUS VOLKAMERIANA,301490,IMG-00012-44.jpg,162,65,64,1,98,0.9846153846153848,0.3950617283950617
2022,ONAGRI,CITRUS VOLKAMERIANA,301490,IMG-00015-44.jpg,109,38,38,0,71,1.0,0.3486238532110092
2022,ONAGRI,CITRUS VOLKAMERIANA,301510,IMG-00001.jpg,252,97,97,0,155,1.0,0.3849206349206349
2022,ONAGRI,CITRUS VOLKAMERIANA,301510,IMG-00006-44.jpg,137,59,59,0,78,1.0,0.4306569343065693
2022,ONAGRI,CITRUS VOLKAMERIANA,301510,IMG-00007-44.jpg,115,47,47,0,68,1.0,0.4086956521739131
2022,ONAGRI,CITRUS VOLKAMERIANA,301510,IMG-00008-44.jpg,150,73,72,1,78,0.9863013698630136,0.48
2022,ONAGRI,BIGARADIER,301550,IMG-00008-44.jpg,144,85,85,0,59,1.0,0.5902777777777778
2022,ONAGRI,BIGARADIER,301550,IMG-00011-44.jpg,40,19,18,1,22,0.9473684210526316,0.45
2022,ONAGRI,BIGARADIER,301550,IMG-00013-44.jpg,76,28,28,0,48,1.0,0.3684210526315789
2022,ONAGRI,BIGARADIER,301550,IMG-00014-44.jpg,80,32,28,4,52,0.875,0.35
2022,ONAGRI,CITRUS VOLKAMERIANA,301570,IMG-00004-44.jpg,158,68,67,1,91,0.9852941176470588,0.4240506329113924
2022,ONAGRI,CITRUS VOLKAMERIANA,301570,IMG-00007-44.jpg,152,66,65,1,87,0.9848484848484848,0.4276315789473684
2022,ONAGRI,CITRUS VOLKAMERIANA,301570,IMG-00008-44.jpg,103,34,32,2,71,0.9411764705882352,0.3106796116504854
2022,ONAGRI,CITRUS VOLKAMERIANA,301570,IMG-00017-44.jpg,218,91,89,2,129,0.978021978021978,0.4082568807339449
2022,KHOUALKA,CITRUS VOLKAMERIANA,302340,IMG-00004-43.jpg,106,52,52,0,54,1.0,0.4905660377358491
2022,KHOUALKA,CITRUS VOLKAMERIANA,302340,IMG-00005-43.jpg,105,54,52,2,53,0.9629629629629628,0.4952380952380953
2022,KHOUALKA,CITRUS VOLKAMERIANA,302340,IMG-00011-43.jpg,75,31,30,1,45,0.967741935483871,0.4
2022,KHOUALKA,CITRUS VOLKAMERIANA,302340,IMG-00015-43.jpg,92,26,25,1,67,0.9615384615384616,0.2717391304347826
2022,KHOUALKA,CITRUS VOLKAMERIANA,302350,IMG-00008-43.jpg,33,23,23,0,10,1.0,0.696969696969697
2022,KHOUALKA,CITRUS VOLKAMERIANA,302350,IMG-00013-43.jpg,80,44,42,2,38,0.9545454545454546,0.525
2022,KHOUALKA,CITRUS VOLKAMERIANA,302350,IMG-00014-43.jpg,76,36,36,0,40,1.0,0.4736842105263158
2022,KHOUALKA,CITRUS VOLKAMERIANA,302350,IMG-00018-43.jpg,44,29,29,0,15,1.0,0.6590909090909091
2022,KHOUALKA,CITRUS VOLKAMERIANA,302360,IMG-00005-43.jpg,97,33,33,0,64,1.0,0.3402061855670103
2022,KHOUALKA,CITRUS VOLKAMERIANA,302360,IMG-00006-43.jpg,118,37,37,0,81,1.0,0.3135593220338983
2022,KHOUALKA,CITRUS VOLKAMERIANA,302360,IMG-00016-43.jpg,67,27,27,0,40,1.0,0.4029850746268657
2022,KHOUALKA,CITRUS VOLKAMERIANA,302360,IMG-00021-43.jpg,65,37,33,4,32,0.8918918918918919,0.5076923076923077
2022,KHOUALKA,CITRUS VOLKAMERIANA,302510,IMG-00001.jpg,73,34,34,0,39,1.0,0.4657534246575342
2022,KHOUALKA,CITRUS VOLKAMERIANA,302510,IMG-00002-43.jpg,44,18,18,0,26,1.0,0.4090909090909091
2022,KHOUALKA,CITRUS VOLKAMERIANA,302510,IMG-00003-43.jpg,78,47,45,2,33,0.9574468085106383,0.5769230769230769
2022,KHOUALKA,CITRUS VOLKAMERIANA,302510,IMG-00015-43.jpg,49,24,23,1,26,0.9583333333333334,0.4693877551020408
2022,KHOUALKA,BIGARADIER,401410,IMG-00093-43.jpg,35,18,18,0,17,1.0,0.5142857142857142
2022,KHOUALKA,BIGARADIER,401410,IMG-00099-43.jpg,6,1,1,0,5,1.0,0.1666666666666667
2022,KHOUALKA,BIGARADIER,401410,IMG-00102-43.jpg,78,28,28,0,50,1.0,0.358974358974359
2022,KHOUALKA,BIGARADIER,401410,IMG-00104-43.jpg,81,33,33,0,48,1.0,0.4074074074074074
2022,ONAGRI,CITRANGE C35,401660,IMG-00001.jpg,56,34,34,0,22,1.0,0.6071428571428571
2022,ONAGRI,CITRANGE C35,401660,IMG-00008-44.jpg,42,23,23,0,19,1.0,0.5476190476190477
2022,ONAGRI,CITRANGE C35,401660,IMG-00010-44.jpg,29,21,19,2,10,0.9047619047619048,0.6551724137931034
2022,ONAGRI,CITRANGE C35,401660,IMG-00016-44.jpg,64,41,41,0,23,1.0,0.640625
2022,ONAGRI,CITRANGE C35,401710,IMG-00003-44.jpg,51,26,26,0,25,1.0,0.5098039215686274
2022,ONAGRI,CITRANGE C35,401710,IMG-00012-44.jpg,19,12,12,0,7,1.0,0.631578947368421
2022,ONAGRI,CITRANGE C35,401710,IMG-00013-44.jpg,33,23,22,1,11,0.9565217391304348,0.6666666666666666
2022,ONAGRI,CITRANGE C35,401710,IMG-00019-44.jpg,76,51,51,0,25,1.0,0.6710526315789473
2022,ONAGRI,CITRANGE C35,401720,IMG-00007-44.jpg,93,55,55,0,38,1.0,0.5913978494623656
2022,ONAGRI,CITRANGE C35,401720,IMG-00008-44.jpg,38,23,22,1,16,0.9565217391304348,0.5789473684210527
2022,ONAGRI,CITRANGE C35,401720,IMG-00010-44.jpg,50,20,20,0,30,1.0,0.4
2022,ONAGRI,CITRANGE C35,401720,IMG-00017-44.jpg,68,39,36,3,32,0.9230769230769232,0.5294117647058824
2022,ONAGRI,CITRANGE C35,401730,IMG-00001.jpg,19,7,7,0,12,1.0,0.3684210526315789
2022,ONAGRI,CITRANGE C35,401730,IMG-00010-44.jpg,50,30,29,1,21,0.9666666666666668,0.58
2022,ONAGRI,CITRANGE C35,401730,IMG-00013-44.jpg,75,59,58,1,17,0.9830508474576272,0.7733333333333333
2022,ONAGRI,CITRANGE C35,401730,IMG-00016-44.jpg,36,25,24,1,12,0.96,0.6666666666666666
2022,ONAGRI,CITRANGE C35,401750,IMG-00005-44.jpg,88,36,36,0,52,1.0,0.4090909090909091
2022,ONAGRI,CITRANGE C35,401750,IMG-00009-44.jpg,127,65,65,0,62,1.0,0.5118110236220472
2022,ONAGRI,CITRANGE C35,401750,IMG-00016-44.jpg,107,60,59,1,48,0.9833333333333332,0.5514018691588785
2022,ONAGRI,CITRANGE C35,401750,IMG-00024-44.jpg,50,28,28,0,22,1.0,0.56
2022,ONAGRI,CITRUMELO SACCATON,401770,IMG-00003-44.jpg,24,15,15,0,9,1.0,0.625
2022,ONAGRI,CITRUMELO SACCATON,401770,IMG-00008-44.jpg,72,37,36,1,36,0.972972972972973,0.5
2022,ONAGRI,CITRUMELO SACCATON,401770,IMG-00009-44.jpg,14,8,8,0,6,1.0,0.5714285714285714
2022,ONAGRI,CITRUMELO SACCATON,401770,IMG-00017-44.jpg,20,12,12,0,8,1.0,0.6
2022,KHOUALKA,BIGARADIER,402440,IMG-00005-43.jpg,17,3,3,0,14,1.0,0.1764705882352941
2022,KHOUALKA,BIGARADIER,402440,IMG-00012-43.jpg,46,24,24,0,22,1.0,0.5217391304347826
2022,KHOUALKA,BIGARADIER,402440,IMG-00014-43.jpg,11,2,2,0,9,1.0,0.1818181818181818
2022,KHOUALKA,BIGARADIER,402440,IMG-00015-43.jpg,22,5,5,0,17,1.0,0.2272727272727273
2022,KHOUALKA,BIGARADIER,402590,IMG-00007-43.jpg,104,47,44,3,60,0.9361702127659576,0.4230769230769231
2022,KHOUALKA,BIGARADIER,402590,IMG-00012-43.jpg,45,21,20,1,25,0.9523809523809524,0.4444444444444444
2022,KHOUALKA,BIGARADIER,402590,IMG-00015-43.jpg,58,32,29,3,29,0.90625,0.5
2022,KHOUALKA,BIGARADIER,402590,IMG-00019-43.jpg,64,38,37,1,27,0.9736842105263158,0.578125
2022,KHOUALKA,CITRUS VOLKAMERIANA,501520,IMG-00004-43.jpg,39,15,15,0,24,1.0,0.3846153846153846
2022,KHOUALKA,CITRUS VOLKAMERIANA,501520,IMG-00007-43.jpg,43,21,19,2,24,0.9047619047619048,0.4418604651162791
2022,KHOUALKA,CITRUS VOLKAMERIANA,501520,IMG-00015-43.jpg,18,8,8,0,10,1.0,0.4444444444444444
2022,KHOUALKA,CITRUS VOLKAMERIANA,501520,IMG-00020-43.jpg,48,27,27,0,21,1.0,0.5625
2022,KHOUALKA,CITRUS VOLKAMERIANA,501540,IMG-00006-43.jpg,38,28,26,2,12,0.9285714285714286,0.6842105263157895
2022,KHOUALKA,CITRUS VOLKAMERIANA,501540,IMG-00012-43.jpg,102,59,58,1,44,0.9830508474576272,0.5686274509803921
2022,KHOUALKA,CITRUS VOLKAMERIANA,501540,IMG-00017-43.jpg,138,42,42,0,96,1.0,0.3043478260869565
2022,KHOUALKA,CITRUS VOLKAMERIANA,501540,IMG-00018-43.jpg,51,25,24,1,27,0.96,0.4705882352941176
2022,KHOUALKA,CITRUS VOLKAMERIANA,501660,IMG-00006-43.jpg,60,31,29,2,31,0.935483870967742,0.4833333333333333
2022,KHOUALKA,CITRUS VOLKAMERIANA,501660,IMG-00016-43.jpg,63,38,38,0,25,1.0,0.6031746031746031
2022,KHOUALKA,CITRUS VOLKAMERIANA,501660,IMG-00018-43.jpg,112,49,49,0,63,1.0,0.4375
2022,KHOUALKA,CITRUS VOLKAMERIANA,501660,IMG-00021-43.jpg,90,43,42,1,48,0.9767441860465116,0.4666666666666667
2022,KHOUALKA,CITRUS VOLKAMERIANA,501680,IMG-00005-43.jpg,179,86,85,1,94,0.9883720930232558,0.4748603351955307
2022,KHOUALKA,CITRUS VOLKAMERIANA,501680,IMG-00011-43.jpg,101,38,38,0,63,1.0,0.3762376237623762
2022,KHOUALKA,CITRUS VOLKAMERIANA,501680,IMG-00012-43.jpg,76,27,26,1,50,0.9629629629629628,0.3421052631578947
2022,KHOUALKA,CITRUS VOLKAMERIANA,501680,IMG-00016-43.jpg,113,69,67,2,46,0.9710144927536232,0.5929203539823009
2022,KHOUALKA,CITRUS VOLKAMERIANA,501690,IMG-00032-43.jpg,34,11,10,1,24,0.9090909090909092,0.2941176470588235
2022,KHOUALKA,CITRUS VOLKAMERIANA,501690,IMG-00039-43.jpg,186,89,88,1,98,0.9887640449438202,0.4731182795698925
2022,KHOUALKA,CITRUS VOLKAMERIANA,501690,IMG-00047-43.jpg,103,37,37,0,66,1.0,0.3592233009708738
2022,KHOUALKA,CITRUS VOLKAMERIANA,501690,IMG-00049-43.jpg,166,65,65,0,101,1.0,0.3915662650602409
2022,KHOUALKA,CITRUS VOLKAMERIANA,501760,IMG-00001.jpg,94,28,26,2,68,0.9285714285714286,0.2765957446808511
2022,KHOUALKA,CITRUS VOLKAMERIANA,501760,IMG-00034-43.jpg,45,10,10,0,35,1.0,0.2222222222222222
2022,KHOUALKA,CITRUS VOLKAMERIANA,501760,IMG-00036-43.jpg,40,17,16,1,24,0.9411764705882352,0.4
2022,KHOUALKA,CITRUS VOLKAMERIANA,501760,IMG-00051-43.jpg,92,24,24,0,68,1.0,0.2608695652173913
2022,ONAGRI,CITRUMELO SACCATON,510910,IMG-00004-44.jpg,73,43,42,1,31,0.9767441860465116,0.5753424657534246
2022,ONAGRI,CITRUMELO SACCATON,510910,IMG-00008-44.jpg,152,79,79,0,73,1.0,0.5197368421052632
2022,ONAGRI,CITRUMELO SACCATON,510910,IMG-00010-44.jpg,107,57,55,2,52,0.9649122807017544,0.514018691588785
2022,ONAGRI,CITRUMELO SACCATON,510910,IMG-00011-44.jpg,92,59,57,2,35,0.9661016949152542,0.6195652173913043
2022,ONAGRI,CITRUMELO SACCATON,510950,IMG-00006-44.jpg,70,44,44,0,26,1.0,0.6285714285714286
2022,ONAGRI,CITRUMELO SACCATON,510950,IMG-00008-44.jpg,75,40,39,1,36,0.975,0.52
2022,ONAGRI,CITRUMELO SACCATON,510950,IMG-00009-44.jpg,85,46,46,0,39,1.0,0.5411764705882353
2022,ONAGRI,CITRUMELO SACCATON,510950,IMG-00011-44.jpg,135,81,81,0,54,1.0,0.6
2022,ONAGRI,MC PONSIRUCE TRIFOLIATA,510980,IMG-00014-44.jpg,67,35,35,0,32,1.0,0.5223880597014925
2022,ONAGRI,MC PONSIRUCE TRIFOLIATA,510980,IMG-00015-44.jpg,51,28,28,0,23,1.0,0.5490196078431373
2022,ONAGRI,MC PONSIRUCE TRIFOLIATA,510980,IMG-00016-44.jpg,99,47,47,0,52,1.0,0.4747474747474748
2022,ONAGRI,MC PONSIRUCE TRIFOLIATA,510980,IMG-00019-44.jpg,102,50,49,1,53,0.98,0.4803921568627451
2022,ONAGRI,MC PONSIRUCE TRIFOLIATA,510990,IMG-00006-44.jpg,135,76,76,0,59,1.0,0.562962962962963
2022,ONAGRI,MC PONSIRUCE TRIFOLIATA,510990,IMG-00008-44.jpg,110,70,69,1,41,0.9857142857142858,0.6272727272727273
2022,ONAGRI,MC PONSIRUCE TRIFOLIATA,510990,IMG-00009-44.jpg,85,54,52,2,33,0.9629629629629628,0.611764705882353
2022,ONAGRI,MC PONSIRUCE TRIFOLIATA,510990,IMG-00024-44.jpg,65,41,41,0,24,1.0,0.6307692307692307
2022,ONAGRI,MC PONSIRUCE TRIFOLIATA,511030,IMG-00007-44.jpg,100,74,71,3,29,0.9594594594594594,0.71
2022,ONAGRI,MC PONSIRUCE TRIFOLIATA,511030,IMG-00016-44.jpg,63,42,42,0,21,1.0,0.6666666666666666
2022,ONAGRI,MC PONSIRUCE TRIFOLIATA,511030,IMG-00022-44.jpg,98,75,74,1,24,0.9866666666666668,0.7551020408163265
2022,ONAGRI,MC PONSIRUCE TRIFOLIATA,511030,IMG-00027-44.jpg,82,64,63,1,19,0.984375,0.7682926829268293
2022,ONAGRI,MS PONSIRUCE TRIFOLIATA,511040,IMG-00004-44.jpg,77,58,57,1,20,0.9827586206896552,0.7402597402597403
2022,ONAGRI,MS PONSIRUCE TRIFOLIATA,511040,IMG-00014-44.jpg,48,31,30,1,18,0.967741935483871,0.625
2022,ONAGRI,MS PONSIRUCE TRIFOLIATA,511040,IMG-00016-44.jpg,71,45,44,1,27,0.9777777777777776,0.6197183098591549
2022,ONAGRI,MS PONSIRUCE TRIFOLIATA,511040,IMG-00025-44.jpg,56,31,31,0,25,1.0,0.5535714285714286
2022,ONAGRI,FUZHU,511050,IMG-00004-44.jpg,109,55,53,2,56,0.9636363636363636,0.4862385321100918
2022,ONAGRI,FUZHU,511050,IMG-00006-44.jpg,142,75,71,4,71,0.9466666666666668,0.5
2022,ONAGRI,FUZHU,511050,IMG-00011-44.jpg,172,118,115,3,57,0.9745762711864406,0.6686046511627907
2022,ONAGRI,FUZHU,511050,IMG-00022-44.jpg,194,117,114,3,80,0.9743589743589745,0.5876288659793815
2022,ONAGRI,MS PONSIRUCE TRIFOLIATA,511060,IMG-00007-44.jpg,115,67,67,0,48,1.0,0.5826086956521739
2022,ONAGRI,MS PONSIRUCE TRIFOLIATA,511060,IMG-00016-44.jpg,102,54,52,2,50,0.9629629629629628,0.5098039215686274
2022,ONAGRI,MS PONSIRUCE TRIFOLIATA,511060,IMG-00017-44.jpg,59,24,24,0,35,1.0,0.4067796610169492
2022,ONAGRI,MS PONSIRUCE TRIFOLIATA,511060,IMG-00019-44.jpg,108,55,53,2,55,0.9636363636363636,0.4907407407407408
2022,ONAGRI,FUZHU,511070,IMG-00006-44.jpg,82,64,63,1,19,0.984375,0.7682926829268293
2022,ONAGRI,FUZHU,511070,IMG-00016-44.jpg,96,58,57,1,39,0.9827586206896552,0.59375
2022,ONAGRI,FUZHU,511070,IMG-00018-44.jpg,93,57,55,2,38,0.9649122807017544,0.5913978494623656
2022,ONAGRI,FUZHU,511070,IMG-00019-44.jpg,142,80,79,1,63,0.9875,0.5563380281690141
