compagnie,Domaine,Porte-greffe,parcelle,Filename,True_count,detect_count,TP,FP,FN,Precision,Recall
2022,SAOUDA,BIGARADIER,10010,IMG-00011-45.jpg,28,27,27,0,1,1.0,0.9642857142857144
2022,SAOUDA,BIGARADIER,10010,IMG-00012-45.jpg,27,25,25,0,2,1.0,0.925925925925926
2022,SAOUDA,BIGARADIER,10010,IMG-00014-45.jpg,50,51,50,1,0,0.9803921568627452,1.0
2022,SAOUDA,BIGARADIER,10010,IMG-00018-45.jpg,30,29,29,0,1,1.0,0.9666666666666668
2022,SAOUDA,BIGARADIER,10010,IMG-00020-45.jpg,31,32,31,1,0,0.96875,1.0
2024,SAOUDA,BIGARADIER,10010,IMG-23410.jpg,85,11,11,0,74,1.0,0.1294117647058824
2024,SAOUDA,BIGARADIER,10010,IMG-23417.jpg,86,11,11,0,75,1.0,0.1279069767441861
2024,SAOUDA,BIGARADIER,10010,IMG-23430.jpg,74,21,21,0,53,1.0,0.2837837837837838
2024,SAOUDA,BIGARADIER,10010,IMG-23647.jpg,95,17,16,1,79,0.9411764705882352,0.1684210526315789
2024,SAOUDA,BIGARADIER,10010,IMG-23672.jpg,47,6,5,1,42,0.8333333333333334,0.1063829787234043
2024,SAOUDA,BIGARADIER,10010,IMG-23707.jpg,30,13,12,1,18,0.9230769230769232,0.4
2024,SAOUDA,BIGARADIER,10010,IMG-23709.jpg,31,5,5,0,26,1.0,0.1612903225806452
2024,SAOUDA,BIGARADIER,10010,IMG-23711.jpg,79,13,13,0,66,1.0,0.1645569620253164
2022,SAOUDA,MACROPHYLLA,10030,IMG-00158-45.jpg,101,98,96,2,5,0.979591836734694,0.9504950495049505
2022,SAOUDA,MACROPHYLLA,10030,IMG-00159-45.jpg,155,155,152,3,3,0.9806451612903224,0.9806451612903224
2022,SAOUDA,MACROPHYLLA,10030,IMG-00162-45.jpg,119,114,113,1,6,0.9912280701754386,0.9495798319327732
2022,SAOUDA,MACROPHYLLA,10030,IMG-00169-45.jpg,72,73,71,2,1,0.9726027397260274,0.9861111111111112
2022,SAOUDA,MACROPHYLLA,10031,IMG-00002-45.jpg,46,42,40,2,6,0.9523809523809524,0.8695652173913043
2022,SAOUDA,MACROPHYLLA,10031,IMG-00084-45.jpg,41,37,35,2,6,0.945945945945946,0.8536585365853658
2022,SAOUDA,MACROPHYLLA,10031,IMG-00450-45.jpg,27,28,26,2,1,0.9285714285714286,0.9629629629629628
2022,SAOUDA,MACROPHYLLA,10031,IMG-00451-45.jpg,34,33,27,6,7,0.8181818181818182,0.7941176470588235
2022,SAOUDA,MACROPHYLLA,10031,IMG-00464-45.jpg,33,34,32,2,1,0.9411764705882352,0.9696969696969696
2022,ONAGRI,CITRUS VOLKAMERIANA,10101,IMG-00003-39.jpg,120,124,114,10,6,0.9193548387096774,0.95
2022,ONAGRI,CITRUS VOLKAMERIANA,10101,IMG-00010-39.jpg,85,84,80,4,5,0.9523809523809524,0.9411764705882352
2024,ONAGRI,CITRUS VOLKAMERIANA,10101,IMG-10523.jpg,288,234,232,2,56,0.9914529914529916,0.8055555555555556
2024,ONAGRI,CITRUS VOLKAMERIANA,10101,IMG-10545.jpg,98,80,79,1,19,0.9875,0.8061224489795918
2024,ONAGRI,CITRUS VOLKAMERIANA,10101,IMG-10558.jpg,143,101,98,3,45,0.9702970297029704,0.6853146853146853
2022,ONAGRI,CITRUS VOLKAMERIANA,10102,IMG-00003-39.jpg,48,45,45,0,3,1.0,0.9375
2024,ONAGRI,CITRUS VOLKAMERIANA,10102,IMG-10637.jpg,140,113,111,2,29,0.9823008849557522,0.7928571428571428
2024,ONAGRI,CITRUS VOLKAMERIANA,10102,IMG-10658.jpg,163,127,125,2,38,0.984251968503937,0.7668711656441718
2022,ONAGRI,CITRUS VOLKAMERIANA,10103,IMG-00003-39.jpg,215,212,206,6,9,0.9716981132075472,0.958139534883721
2022,ONAGRI,CITRUS VOLKAMERIANA,10103,IMG-00008-39.jpg,195,204,187,17,8,0.9166666666666666,0.958974358974359
2024,ONAGRI,CITRUS VOLKAMERIANA,10103,IMG-10614.jpg,134,110,104,6,30,0.9454545454545454,0.7761194029850746
2024,ONAGRI,CITRUS VOLKAMERIANA,10103,IMG-10630.jpg,213,171,168,3,45,0.9824561403508772,0.7887323943661971
2024,ONAGRI,CITRUS VOLKAMERIANA,10103,IMG-10631.jpg,134,98,97,1,37,0.9897959183673468,0.7238805970149254
2022,ONAGRI,CITRUS VOLKAMERIANA,10104,IMG-00004-39.jpg,65,64,61,3,4,0.953125,0.9384615384615383
2022,ONAGRI,CITRUS VOLKAMERIANA,10104,IMG-00008-39.jpg,69,69,60,9,9,0.8695652173913043,0.8695652173913043
2024,ONAGRI,CITRUS VOLKAMERIANA,10104,IMG-11267.jpg,22,12,12,0,10,1.0,0.5454545454545454
2024,ONAGRI,CITRUS VOLKAMERIANA,10104,IMG-11327.jpg,128,96,94,2,34,0.9791666666666666,0.734375
2024,ONAGRI,CITRUS VOLKAMERIANA,10104,IMG-11347.jpg,118,97,95,2,23,0.979381443298969,0.8050847457627118
2024,ONAGRI,CITRUS VOLKAMERIANA,10104,IMG-11366.jpg,351,240,235,5,116,0.9791666666666666,0.6695156695156695
2024,ONAGRI,CITRUS VOLKAMERIANA,10104,IMG-11386.jpg,99,74,72,2,27,0.972972972972973,0.7272727272727273
2022,ONAGRI,CITRUS VOLKAMERIANA,10105,IMG-00004-39.jpg,17,19,15,4,2,0.7894736842105263,0.8823529411764706
2022,ONAGRI,CITRUS VOLKAMERIANA,10105,IMG-00005-39.jpg,68,69,63,6,5,0.9130434782608696,0.9264705882352942
2022,ONAGRI,CITRUS VOLKAMERIANA,10108,IMG-00003-39.jpg,61,57,56,1,5,0.9824561403508772,0.918032786885246
2022,ONAGRI,CITRUS VOLKAMERIANA,10108,IMG-00007-39.jpg,69,64,62,2,7,0.96875,0.8985507246376812
2022,ONAGRI,CITRUS VOLKAMERIANA,10109,IMG-00003-39.jpg,4,5,4,1,0,0.8,1.0
2022,ONAGRI,CITRUS VOLKAMERIANA,10109,IMG-00008-39.jpg,105,106,101,5,4,0.9528301886792452,0.961904761904762
2022,KHOUALKA,CITRANGE CARRIZO,10213,IMG-00001.jpg,77,90,75,15,2,0.8333333333333334,0.974025974025974
2022,KHOUALKA,CITRANGE CARRIZO,10213,IMG-00005-40.jpg,73,85,72,13,1,0.8470588235294118,0.9863013698630136
2022,KHOUALKA,CITRANGE CARRIZO,10213,IMG-00009-40.jpg,14,20,14,6,0,0.7,1.0
2022,KHOUALKA,CITRANGE CARRIZO,10213,IMG-00014-40.jpg,21,22,20,2,1,0.9090909090909092,0.9523809523809524
2022,KHOUALKA,CITRANGE CARRIZO,10213,IMG-00028-40.jpg,47,46,44,2,3,0.9565217391304348,0.9361702127659576
2022,KHOUALKA,CITRANGE CARRIZO,10213,IMG-00034-40.jpg,48,49,48,1,0,0.979591836734694,1.0
2022,KHOUALKA,CITRANGE CARRIZO,10213,IMG-00035-40.jpg,37,38,36,2,1,0.9473684210526316,0.972972972972973
2022,KHOUALKA,CITRANGE CARRIZO,10213,IMG-00036-40.jpg,47,53,46,7,1,0.8679245283018868,0.9787234042553192
2022,KHOUALKA,CITRANGE CARRIZO,10213,IMG-00042-40.jpg,22,27,22,5,0,0.8148148148148148,1.0
2022,KHOUALKA,CITRANGE CARRIZO,10213,IMG-00047-40.jpg,70,70,68,2,2,0.9714285714285714,0.9714285714285714
2022,KHOUALKA,CITRANGE CARRIZO,10213,IMG-00054-40.jpg,33,34,32,2,1,0.9411764705882352,0.9696969696969696
2022,KHOUALKA,CITRANGE CARRIZO,10213,IMG-00055-40.jpg,93,98,89,9,4,0.9081632653061223,0.956989247311828
2022,KHOUALKA,CITRANGE CARRIZO,10213,IMG-00061-40.jpg,113,122,110,12,3,0.9016393442622952,0.9734513274336284
2022,KHOUALKA,CITRANGE CARRIZO,10213,IMG-00066-40.jpg,48,50,44,6,4,0.88,0.9166666666666666
2024,KHOUALKA,CITRANGE CARRIZO,10213,IMG-12628.jpg,119,95,94,1,25,0.9894736842105264,0.7899159663865546
2024,KHOUALKA,CITRANGE CARRIZO,10213,IMG-12774.jpg,118,95,91,4,27,0.9578947368421052,0.7711864406779662
2024,KHOUALKA,CITRANGE CARRIZO,10213,IMG-12780.jpg,44,40,39,1,5,0.975,0.8863636363636364
2024,KHOUALKA,CITRANGE CARRIZO,10213,IMG-12791.jpg,166,121,119,2,47,0.9834710743801652,0.7168674698795181
2024,KHOUALKA,CITRANGE CARRIZO,10213,IMG-12834.jpg,57,44,41,3,16,0.9318181818181818,0.7192982456140351
2024,KHOUALKA,CITRANGE CARRIZO,10213,IMG-12945.jpg,130,111,110,1,20,0.990990990990991,0.8461538461538461
2022,OUARGHA,MACROPHYLLA,11010,IMG-00001.jpg,40,38,38,0,2,1.0,0.95
2022,OUARGHA,MACROPHYLLA,11010,IMG-00015-41.jpg,24,22,20,2,4,0.9090909090909092,0.8333333333333334
2022,OUARGHA,MACROPHYLLA,11010,IMG-00019-41.jpg,20,22,19,3,1,0.8636363636363636,0.95
2022,OUARGHA,MACROPHYLLA,11010,IMG-00024-41.jpg,21,21,20,1,1,0.9523809523809524,0.9523809523809524
2022,OUARGHA,MACROPHYLLA,11020,IMG-00017-41.jpg,51,54,50,4,1,0.925925925925926,0.9803921568627452
2022,OUARGHA,MACROPHYLLA,11020,IMG-00018-41.jpg,13,13,12,1,1,0.9230769230769232,0.9230769230769232
2022,OUARGHA,CITRANGE CARRIZO,13010,IMG-00067-41.jpg,55,51,49,2,6,0.9607843137254902,0.8909090909090909
2022,OUARGHA,CITRANGE CARRIZO,13010,IMG-00086-41.jpg,49,49,47,2,2,0.9591836734693876,0.9591836734693876
2022,OUARGHA,CITRANGE CARRIZO,13010,IMG-00194-41.jpg,33,35,32,3,1,0.9142857142857144,0.9696969696969696
2022,OUARGHA,CITRANGE CARRIZO,13020,IMG-00023-41.jpg,31,29,29,0,2,1.0,0.935483870967742
2022,OUARGHA,CITRANGE CARRIZO,13020,IMG-00024-41.jpg,18,19,17,2,1,0.8947368421052632,0.9444444444444444
2022,OUARGHA,CITRANGE CARRIZO,13020,IMG-00039-41.jpg,4,5,4,1,0,0.8,1.0
2022,OUARGHA,CITRANGE CARRIZO,13020,IMG-00040-41.jpg,6,5,5,0,1,1.0,0.8333333333333334
2022,OUARGHA,CITRUS VOLKAMERIANA,13030,IMG-00009-41.jpg,18,13,13,0,5,1.0,0.7222222222222222
2022,OUARGHA,CITRUS VOLKAMERIANA,13030,IMG-00013-41.jpg,46,44,43,1,3,0.9772727272727272,0.9347826086956522
2022,OUARGHA,CITRUS VOLKAMERIANA,13030,IMG-00027-41.jpg,12,11,10,1,2,0.9090909090909092,0.8333333333333334
2022,OUARGHA,CITRUS VOLKAMERIANA,13030,IMG-00029-41.jpg,18,18,17,1,1,0.9444444444444444,0.9444444444444444
2022,OUARGHA,CITRUS VOLKAMERIANA,13030,IMG-00036-41.jpg,16,17,12,5,4,0.7058823529411765,0.75
2022,OUARGHA,CITRUS VOLKAMERIANA,14010,IMG-00008-41.jpg,40,42,36,6,4,0.8571428571428571,0.9
2022,OUARGHA,CITRUS VOLKAMERIANA,14010,IMG-00010-41.jpg,49,50,48,2,1,0.96,0.979591836734694
2022,OUARGHA,CITRUS VOLKAMERIANA,14010,IMG-00011-41.jpg,47,46,43,3,4,0.9347826086956522,0.9148936170212766
2022,OUARGHA,CITRUS VOLKAMERIANA,14010,IMG-00018-41.jpg,44,44,40,4,4,0.9090909090909092,0.9090909090909092
2022,KHOUALKA,MACROPHYLLA,20118,IMG-00007-40.jpg,44,46,43,3,1,0.9347826086956522,0.9772727272727272
2022,KHOUALKA,MACROPHYLLA,20118,IMG-00008-40.jpg,115,127,115,12,0,0.905511811023622,1.0
2022,KHOUALKA,MACROPHYLLA,20118,IMG-00022-40.jpg,113,111,105,6,8,0.945945945945946,0.9292035398230089
2022,KHOUALKA,MACROPHYLLA,20118,IMG-00033-40.jpg,58,60,54,6,4,0.9,0.9310344827586208
2022,KHOUALKA,MACROPHYLLA,20118,IMG-00037-40.jpg,29,34,27,7,2,0.7941176470588235,0.9310344827586208
2022,KHOUALKA,MACROPHYLLA,20118,IMG-00042-40.jpg,137,142,132,10,5,0.9295774647887324,0.9635036496350364
2022,KHOUALKA,MACROPHYLLA,20118,IMG-00046-40.jpg,45,52,44,8,1,0.8461538461538461,0.9777777777777776
2022,KHOUALKA,MACROPHYLLA,20118,IMG-00050-40.jpg,48,48,45,3,3,0.9375,0.9375
2022,KHOUALKA,MACROPHYLLA,20118,IMG-00055-40.jpg,52,51,48,3,4,0.9411764705882352,0.9230769230769232
2022,KHOUALKA,MACROPHYLLA,20118,IMG-00061-40.jpg,120,126,112,14,8,0.8888888888888888,0.9333333333333332
2022,KHOUALKA,MACROPHYLLA,20118,IMG-00062-40.jpg,63,61,55,6,8,0.9016393442622952,0.873015873015873
2022,KHOUALKA,MACROPHYLLA,20118,IMG-00063-40.jpg,47,55,45,10,2,0.8181818181818182,0.9574468085106383
2022,KHOUALKA,MACROPHYLLA,20118,IMG-00066-40.jpg,84,86,79,7,5,0.9186046511627908,0.9404761904761904
2024,KHOUALKA,MACROPHYLLA,20118,IMG-12691.jpg,22,17,15,2,7,0.8823529411764706,0.6818181818181818
2024,KHOUALKA,MACROPHYLLA,20118,IMG-12729.jpg,56,43,41,2,15,0.9534883720930232,0.7321428571428571
2024,KHOUALKA,MACROPHYLLA,20118,IMG-12735.jpg,88,66,66,0,22,1.0,0.75
2024,KHOUALKA,MACROPHYLLA,20118,IMG-12748.jpg,107,77,76,1,31,0.987012987012987,0.7102803738317757
2024,KHOUALKA,MACROPHYLLA,20118,IMG-12764.jpg,111,93,89,4,22,0.956989247311828,0.8018018018018018
2024,KHOUALKA,MACROPHYLLA,20118,IMG-12808.jpg,113,79,77,2,36,0.9746835443037974,0.6814159292035398
2024,KHOUALKA,MACROPHYLLA,20118,IMG-12851.jpg,24,14,14,0,10,1.0,0.5833333333333334
2022,KHOUALKA,MACROPHYLLA,20119,IMG-00005-40.jpg,106,104,99,5,7,0.9519230769230768,0.9339622641509434
2022,KHOUALKA,MACROPHYLLA,20119,IMG-00008-40.jpg,142,147,136,11,6,0.9251700680272108,0.9577464788732394
2022,KHOUALKA,MACROPHYLLA,20119,IMG-00014-40.jpg,132,141,131,10,1,0.9290780141843972,0.9924242424242424
2022,KHOUALKA,BIGARADIER,20132,IMG-00004-40.jpg,181,180,174,6,7,0.9666666666666668,0.9613259668508288
2022,KHOUALKA,BIGARADIER,20132,IMG-00025-40.jpg,91,100,89,11,2,0.89,0.978021978021978
2022,KHOUALKA,BIGARADIER,20132,IMG-00028-40.jpg,49,53,49,4,0,0.9245283018867924,1.0
2022,KHOUALKA,BIGARADIER,20132,IMG-00035-40.jpg,103,121,102,19,1,0.8429752066115702,0.9902912621359224
2022,KHOUALKA,BIGARADIER,20132,IMG-00039-40.jpg,119,130,115,15,4,0.8846153846153846,0.9663865546218487
2022,KHOUALKA,BIGARADIER,20132,IMG-00046-40.jpg,156,167,153,14,3,0.9161676646706588,0.9807692307692308
2022,KHOUALKA,BIGARADIER,20132,IMG-00051-40.jpg,108,111,105,6,3,0.945945945945946,0.9722222222222222
2022,KHOUALKA,BIGARADIER,20132,IMG-00055-40.jpg,67,66,60,6,7,0.9090909090909092,0.8955223880597015
2022,KHOUALKA,BIGARADIER,20132,IMG-00058-40.jpg,89,89,86,3,3,0.9662921348314608,0.9662921348314608
2022,KHOUALKA,BIGARADIER,20132,IMG-00059-40.jpg,139,136,128,8,11,0.9411764705882352,0.920863309352518
2022,KHOUALKA,BIGARADIER,20132,IMG-00060-40.jpg,57,58,52,6,5,0.896551724137931,0.912280701754386
2022,KHOUALKA,BIGARADIER,20132,IMG-00064-40.jpg,117,122,110,12,7,0.9016393442622952,0.9401709401709402
2022,KHOUALKA,BIGARADIER,20132,IMG-00075-40.jpg,69,72,66,6,3,0.9166666666666666,0.9565217391304348
2022,ONAGRI,BIGARADIER,20139,IMG-00021-39.jpg,93,92,88,4,5,0.9565217391304348,0.946236559139785
2024,KHOUALKA,CITRUS VOLKAMERIANA,20205,IMG-12040.jpg,123,88,83,5,40,0.9431818181818182,0.6747967479674797
2024,KHOUALKA,CITRUS VOLKAMERIANA,20205,IMG-12058.jpg,116,117,111,6,5,0.9487179487179488,0.956896551724138
2024,KHOUALKA,CITRUS VOLKAMERIANA,20207,IMG-11892.jpg,94,78,71,7,23,0.9102564102564102,0.7553191489361702
2024,KHOUALKA,CITRUS VOLKAMERIANA,20207,IMG-11921.jpg,264,175,173,2,91,0.9885714285714284,0.6553030303030303
2024,KHOUALKA,CITRUS VOLKAMERIANA,20207,IMG-11927.jpg,195,140,139,1,56,0.9928571428571428,0.7128205128205128
2024,KHOUALKA,CITRUS VOLKAMERIANA,20207,IMG-11961.jpg,113,86,86,0,27,1.0,0.7610619469026548
2024,KHOUALKA,CITRUS VOLKAMERIANA,20207,IMG-11972.jpg,94,72,68,4,26,0.9444444444444444,0.723404255319149
2024,KHOUALKA,CITRUS VOLKAMERIANA,20207,IMG-11981.jpg,81,54,53,1,28,0.9814814814814816,0.654320987654321
2022,SAOUDA,CITRUS VOLKAMERIANA,21020,IMG-00033-45.jpg,67,68,66,2,1,0.9705882352941176,0.9850746268656716
2022,SAOUDA,CITRUS VOLKAMERIANA,21020,IMG-00087-45.jpg,21,22,21,1,0,0.9545454545454546,1.0
2022,SAOUDA,CITRUS VOLKAMERIANA,21020,IMG-00138-45.jpg,40,40,39,1,1,0.975,0.975
2022,SAOUDA,CITRUS VOLKAMERIANA,21020,IMG-00145-45.jpg,37,37,37,0,0,1.0,1.0
2022,SAOUDA,CITRUS VOLKAMERIANA,21020,IMG-00155-45.jpg,38,38,37,1,1,0.9736842105263158,0.9736842105263158
2022,SAOUDA,CITRUS VOLKAMERIANA,21030,IMG-00521-45.jpg,31,31,31,0,0,1.0,1.0
2022,SAOUDA,CITRUS VOLKAMERIANA,21030,IMG-00524-45.jpg,71,74,71,3,0,0.9594594594594594,1.0
2022,SAOUDA,CITRUS VOLKAMERIANA,21030,IMG-00536-45.jpg,41,44,40,4,1,0.9090909090909092,0.975609756097561
2022,SAOUDA,CITRUS VOLKAMERIANA,21030,IMG-00537-45.jpg,52,53,50,3,2,0.9433962264150944,0.9615384615384616
2022,SAOUDA,CITRUS VOLKAMERIANA,22020,IMG-00053-45.jpg,39,35,34,1,5,0.9714285714285714,0.8717948717948718
2022,SAOUDA,CITRUS VOLKAMERIANA,22020,IMG-00059-45.jpg,46,44,41,3,5,0.9318181818181818,0.8913043478260869
2022,SAOUDA,CITRUS VOLKAMERIANA,22020,IMG-00060-45.jpg,48,48,45,3,3,0.9375,0.9375
2022,SAOUDA,CITRUS VOLKAMERIANA,22020,IMG-00062-45.jpg,50,53,49,4,1,0.9245283018867924,0.98
2022,SAOUDA,CITRUS VOLKAMERIANA,22030,IMG-00062-45.jpg,62,62,57,5,5,0.9193548387096774,0.9193548387096774
2022,SAOUDA,CITRUS VOLKAMERIANA,22030,IMG-00063-45.jpg,83,78,74,4,9,0.9487179487179488,0.891566265060241
2022,SAOUDA,CITRUS VOLKAMERIANA,22030,IMG-00065-45.jpg,58,58,55,3,3,0.9482758620689656,0.9482758620689656
2022,SAOUDA,CITRUS VOLKAMERIANA,22030,IMG-00068-45.jpg,66,60,55,5,11,0.9166666666666666,0.8333333333333334
2022,SAOUDA,CITRUS VOLKAMERIANA,23020,IMG-00024-45.jpg,47,48,41,7,6,0.8541666666666666,0.8723404255319149
2022,SAOUDA,CITRUS VOLKAMERIANA,23020,IMG-00032-45.jpg,33,36,33,3,0,0.9166666666666666,1.0
2022,SAOUDA,CITRUS VOLKAMERIANA,23020,IMG-00074-45.jpg,28,28,25,3,3,0.8928571428571429,0.8928571428571429
2022,SAOUDA,CITRUS VOLKAMERIANA,23020,IMG-00079-45.jpg,28,32,27,5,1,0.84375,0.9642857142857144
2022,SAOUDA,CITRUS VOLKAMERIANA,23030,IMG-00014-45.jpg,25,27,22,5,3,0.8148148148148148,0.88
2022,SAOUDA,CITRUS VOLKAMERIANA,23030,IMG-00034-45.jpg,43,48,40,8,3,0.8333333333333334,0.9302325581395348
2022,SAOUDA,CITRUS VOLKAMERIANA,23030,IMG-00069-45.jpg,28,27,23,4,5,0.8518518518518519,0.8214285714285714
2022,SAOUDA,CITRUS VOLKAMERIANA,23030,IMG-00079-45.jpg,50,56,47,9,3,0.8392857142857143,0.94
2022,SAOUDA,CITRANGE CARRIZO,24010,IMG-00097-45.jpg,59,57,54,3,5,0.9473684210526316,0.9152542372881356
2022,SAOUDA,CITRANGE CARRIZO,24010,IMG-00101-45.jpg,27,31,25,6,2,0.8064516129032258,0.925925925925926
2022,SAOUDA,CITRANGE CARRIZO,24010,IMG-00111-45.jpg,54,54,51,3,3,0.9444444444444444,0.9444444444444444
2022,SAOUDA,CITRANGE CARRIZO,24010,IMG-00112-45.jpg,40,42,39,3,1,0.9285714285714286,0.975
2022,SAOUDA,CITRANGE CARRIZO,25010,IMG-00006-45.jpg,55,55,49,6,6,0.8909090909090909,0.8909090909090909
2022,SAOUDA,CITRANGE CARRIZO,25010,IMG-00007-45.jpg,77,82,74,8,3,0.902439024390244,0.961038961038961
2022,SAOUDA,CITRANGE CARRIZO,25010,IMG-00010-45.jpg,53,53,49,4,4,0.9245283018867924,0.9245283018867924
2022,SAOUDA,CITRANGE CARRIZO,25010,IMG-00011-45.jpg,26,27,26,1,0,0.9629629629629628,1.0
2022,SAOUDA,CITRANGE CARRIZO,26010,IMG-00008-45.jpg,39,39,39,0,0,1.0,1.0
2022,SAOUDA,CITRANGE CARRIZO,26010,IMG-00013-45.jpg,36,36,35,1,1,0.9722222222222222,0.9722222222222222
2022,SAOUDA,CITRANGE CARRIZO,26010,IMG-00018-45.jpg,43,43,43,0,0,1.0,1.0
2022,SAOUDA,CITRANGE CARRIZO,26010,IMG-00020-45.jpg,44,43,43,0,1,1.0,0.9772727272727272
2022,KHOUALKA,CITRANGE CARRIZO,30138,IMG-00002-40.jpg,39,39,36,3,3,0.9230769230769232,0.9230769230769232
2022,KHOUALKA,CITRANGE CARRIZO,30138,IMG-00003-40.jpg,59,63,57,6,2,0.9047619047619048,0.9661016949152542
2022,KHOUALKA,CITRANGE CARRIZO,30138,IMG-00005-40.jpg,58,60,57,3,1,0.95,0.9827586206896552
2022,KHOUALKA,CITRANGE CARRIZO,30138,IMG-00008-40.jpg,32,34,29,5,3,0.8529411764705882,0.90625
2022,KHOUALKA,CITRANGE CARRIZO,30138,IMG-00011-40.jpg,26,27,25,2,1,0.925925925925926,0.9615384615384616
2022,KHOUALKA,CITRANGE CARRIZO,30138,IMG-00019-40.jpg,2,3,2,1,0,0.6666666666666666,1.0
2022,KHOUALKA,CITRANGE CARRIZO,30138,IMG-00037-40.jpg,30,34,29,5,1,0.8529411764705882,0.9666666666666668
2022,KHOUALKA,CITRANGE CARRIZO,30138,IMG-00040-40.jpg,41,40,40,0,1,1.0,0.975609756097561
2022,KHOUALKA,CITRANGE CARRIZO,30138,IMG-00043-40.jpg,28,32,26,6,2,0.8125,0.9285714285714286
2022,KHOUALKA,CITRANGE CARRIZO,30138,IMG-00044-40.jpg,99,99,94,5,5,0.9494949494949496,0.9494949494949496
2022,KHOUALKA,CITRANGE CARRIZO,30138,IMG-00048-40.jpg,37,39,33,6,4,0.8461538461538461,0.8918918918918919
2022,KHOUALKA,CITRANGE CARRIZO,30138,IMG-00057-40.jpg,73,78,70,8,3,0.8974358974358975,0.958904109589041
2022,KHOUALKA,CITRANGE CARRIZO,30138,IMG-00063-40.jpg,89,85,80,5,9,0.9411764705882352,0.898876404494382
2022,ONAGRI,CITRUS VOLKAMERIANA,30145,IMG-00018-39.jpg,219,225,209,16,10,0.9288888888888888,0.954337899543379
2022,ONAGRI,CITRUS VOLKAMERIANA,30145,IMG-00043-39.jpg,64,66,63,3,1,0.9545454545454546,0.984375
2022,ONAGRI,CITRUS VOLKAMERIANA,30146,IMG-00008-39.jpg,262,264,248,16,14,0.9393939393939394,0.9465648854961832
2022,ONAGRI,CITRUS VOLKAMERIANA,30146,IMG-00045-39.jpg,190,193,180,13,10,0.932642487046632,0.9473684210526316
2022,ONAGRI,CITRUS VOLKAMERIANA,30147,IMG-00002-39.jpg,269,287,261,26,8,0.9094076655052264,0.9702602230483272
2022,ONAGRI,CITRUS VOLKAMERIANA,30147,IMG-00008-39.jpg,172,180,168,12,4,0.9333333333333332,0.9767441860465116
2022,ONAGRI,CITRUS VOLKAMERIANA,30148,IMG-00016-40.jpg,88,87,84,3,4,0.9655172413793104,0.9545454545454546
2022,ONAGRI,CITRUS VOLKAMERIANA,30148,IMG-00047-40.jpg,34,30,30,0,4,1.0,0.8823529411764706
2022,ONAGRI,CITRUS VOLKAMERIANA,30149,IMG-00018-39.jpg,151,148,142,6,9,0.9594594594594594,0.9403973509933776
2022,ONAGRI,CITRUS VOLKAMERIANA,30149,IMG-00027-39.jpg,226,216,210,6,16,0.9722222222222222,0.9292035398230089
2022,ONAGRI,CITRUS VOLKAMERIANA,30151,IMG-00012-39.jpg,185,186,166,20,19,0.8924731182795699,0.8972972972972973
2022,ONAGRI,CITRUS VOLKAMERIANA,30151,IMG-00033-39.jpg,214,214,201,13,13,0.9392523364485982,0.9392523364485982
2024,ONAGRI,CITRUS VOLKAMERIANA,30151,IMG-21881.jpg,73,49,48,1,25,0.979591836734694,0.6575342465753424
2024,ONAGRI,CITRUS VOLKAMERIANA,30151,IMG-21935.jpg,179,72,72,0,107,1.0,0.4022346368715084
2024,ONAGRI,CITRUS VOLKAMERIANA,30151,IMG-21936.jpg,93,53,53,0,40,1.0,0.5698924731182796
2022,ONAGRI,CITRUS VOLKAMERIANA,30152,IMG-00016-39.jpg,39,36,34,2,5,0.9444444444444444,0.8717948717948718
2022,ONAGRI,CITRUS VOLKAMERIANA,30152,IMG-00019-39.jpg,139,139,132,7,7,0.9496402877697842,0.9496402877697842
2022,ONAGRI,CITRUS VOLKAMERIANA,30153,IMG-00001.jpg,157,147,140,7,17,0.9523809523809524,0.89171974522293
2022,ONAGRI,CITRUS VOLKAMERIANA,30153,IMG-00007-39.jpg,127,122,120,2,7,0.9836065573770492,0.9448818897637796
2022,ONAGRI,CITRUS VOLKAMERIANA,30153,IMG-00013-39.jpg,159,153,150,3,9,0.9803921568627452,0.9433962264150944
2022,ONAGRI,CITRUS VOLKAMERIANA,30153,IMG-00040-39.jpg,153,147,144,3,9,0.979591836734694,0.9411764705882352
2022,ONAGRI,CITRUS VOLKAMERIANA,30154,IMG-00017-39.jpg,160,158,155,3,5,0.981012658227848,0.96875
2022,ONAGRI,CITRUS VOLKAMERIANA,30154,IMG-00027-39.jpg,220,215,214,1,6,0.9953488372093025,0.9727272727272728
2022,ONAGRI,CITRUS VOLKAMERIANA,30154,IMG-00033-39.jpg,51,51,49,2,2,0.9607843137254902,0.9607843137254902
2022,ONAGRI,CITRUS VOLKAMERIANA,30154,IMG-00036-39.jpg,137,139,134,5,3,0.9640287769784172,0.978102189781022
2022,ONAGRI,CITRUS VOLKAMERIANA,30154,IMG-00038-39.jpg,242,248,238,10,4,0.9596774193548387,0.9834710743801652
2022,ONAGRI,CITRUS VOLKAMERIANA,30154,IMG-00041-39.jpg,272,262,254,8,18,0.9694656488549618,0.9338235294117648
2022,ONAGRI,CITRUS VOLKAMERIANA,30154,IMG-00044-39.jpg,141,144,136,8,5,0.9444444444444444,0.9645390070921984
2022,ONAGRI,BIGARADIER,30155,IMG-00002-39.jpg,139,143,136,7,3,0.951048951048951,0.9784172661870504
2022,ONAGRI,BIGARADIER,30155,IMG-00003-39.jpg,115,111,109,2,6,0.981981981981982,0.9478260869565216
2022,ONAGRI,BIGARADIER,30155,IMG-00006-39.jpg,44,47,41,6,3,0.8723404255319149,0.9318181818181818
2022,ONAGRI,BIGARADIER,30155,IMG-00011-39.jpg,100,94,92,2,8,0.9787234042553192,0.92
2022,ONAGRI,BIGARADIER,30155,IMG-00019-39.jpg,142,133,130,3,12,0.9774436090225564,0.9154929577464788
2022,ONAGRI,BIGARADIER,30155,IMG-00026-39.jpg,124,114,112,2,12,0.9824561403508772,0.9032258064516128
2022,ONAGRI,BIGARADIER,30155,IMG-00032-39.jpg,81,79,78,1,3,0.9873417721518988,0.9629629629629628
2022,ONAGRI,BIGARADIER,30155,IMG-00039-39.jpg,19,19,18,1,1,0.9473684210526316,0.9473684210526316
2022,ONAGRI,BIGARADIER,30155,IMG-00043-39.jpg,130,133,128,5,2,0.962406015037594,0.9846153846153848
2022,ONAGRI,CITRUS VOLKAMERIANA,30157,IMG-00003-39.jpg,227,221,215,6,12,0.9728506787330315,0.947136563876652
2022,ONAGRI,CITRUS VOLKAMERIANA,30157,IMG-00012-39.jpg,283,276,270,6,13,0.9782608695652174,0.9540636042402828
2022,ONAGRI,CITRUS VOLKAMERIANA,30157,IMG-00032-39.jpg,64,65,63,2,1,0.9692307692307692,0.984375
2022,ONAGRI,CITRUS VOLKAMERIANA,30157,IMG-00035-39.jpg,159,155,152,3,7,0.9806451612903224,0.9559748427672956
2022,KHOUALKA,CITRUS VOLKAMERIANA,30235,IMG-00001.jpg,93,100,92,8,1,0.92,0.989247311827957
2022,KHOUALKA,CITRUS VOLKAMERIANA,30235,IMG-00003-40.jpg,37,39,36,3,1,0.9230769230769232,0.972972972972973
2022,KHOUALKA,CITRUS VOLKAMERIANA,30235,IMG-00009-40.jpg,103,113,103,10,0,0.911504424778761,1.0
2022,KHOUALKA,CITRUS VOLKAMERIANA,30235,IMG-00013-40.jpg,90,99,90,9,0,0.9090909090909092,1.0
2022,KHOUALKA,CITRUS VOLKAMERIANA,30235,IMG-00026-40.jpg,122,130,120,10,2,0.9230769230769232,0.9836065573770492
2022,KHOUALKA,CITRUS VOLKAMERIANA,30235,IMG-00047-40.jpg,47,55,45,10,2,0.8181818181818182,0.9574468085106383
2022,KHOUALKA,CITRUS VOLKAMERIANA,30235,IMG-00048-40.jpg,90,103,86,17,4,0.8349514563106796,0.9555555555555556
2022,KHOUALKA,CITRUS VOLKAMERIANA,30235,IMG-00049-40.jpg,44,48,42,6,2,0.875,0.9545454545454546
2022,KHOUALKA,CITRUS VOLKAMERIANA,30235,IMG-00050-40.jpg,84,82,75,7,9,0.9146341463414634,0.8928571428571429
2022,KHOUALKA,CITRUS VOLKAMERIANA,30235,IMG-00052-40.jpg,98,104,95,9,3,0.9134615384615384,0.9693877551020408
2022,KHOUALKA,CITRUS VOLKAMERIANA,30235,IMG-00057-40.jpg,80,82,75,7,5,0.9146341463414634,0.9375
2022,KHOUALKA,CITRUS VOLKAMERIANA,30235,IMG-00064-40.jpg,38,38,32,6,6,0.8421052631578947,0.8421052631578947
2022,KHOUALKA,CITRUS VOLKAMERIANA,30235,IMG-00067-40.jpg,107,103,95,8,12,0.9223300970873788,0.8878504672897196
2022,KHOUALKA,CITRUS VOLKAMERIANA,30235,IMG-00069-40.jpg,34,37,32,5,2,0.8648648648648649,0.9411764705882352
2022,KHOUALKA,CITRUS VOLKAMERIANA,30235,IMG-00075-40.jpg,95,97,91,6,4,0.9381443298969072,0.9578947368421052
2022,KHOUALKA,BIGARADIER,40141,IMG-00006-40.jpg,7,10,7,3,0,0.7,1.0
2022,KHOUALKA,BIGARADIER,40141,IMG-00007-40.jpg,20,15,12,3,8,0.8,0.6
2022,KHOUALKA,BIGARADIER,40141,IMG-00008-40.jpg,15,19,14,5,1,0.7368421052631579,0.9333333333333332
2022,ONAGRI,CITRANGE C35,40166,IMG-00009-39.jpg,38,38,37,1,1,0.9736842105263158,0.9736842105263158
2022,ONAGRI,CITRANGE C35,40166,IMG-00011-39.jpg,173,171,164,7,9,0.95906432748538,0.9479768786127168
2022,ONAGRI,CITRANGE C35,40166,IMG-00014-39.jpg,179,176,173,3,6,0.9829545454545454,0.9664804469273744
2022,ONAGRI,CITRANGE C35,40166,IMG-00015-39.jpg,122,121,119,2,3,0.9834710743801652,0.9754098360655736
2022,ONAGRI,CITRANGE C35,40166,IMG-00041-39.jpg,102,100,98,2,4,0.98,0.9607843137254902
2022,ONAGRI,CITRANGE C35,40167,IMG-00019-39.jpg,197,195,190,5,7,0.9743589743589745,0.964467005076142
2022,ONAGRI,CITRANGE C35,40167,IMG-00030-39.jpg,126,124,123,1,3,0.9919354838709676,0.9761904761904762
2022,ONAGRI,CITRANGE C35,40167,IMG-00039-39.jpg,217,208,204,4,13,0.9807692307692308,0.9400921658986175
2022,ONAGRI,CITRANGE C35,40171,IMG-00008-39.jpg,109,105,103,2,6,0.9809523809523808,0.944954128440367
2022,ONAGRI,CITRANGE C35,40171,IMG-00037-39.jpg,94,92,88,4,6,0.9565217391304348,0.9361702127659576
2022,ONAGRI,CITRANGE C35,40171,IMG-00040-39.jpg,149,143,140,3,9,0.9790209790209792,0.9395973154362416
2022,ONAGRI,CITRANGE C35,40172,IMG-00012-39.jpg,89,84,84,0,5,1.0,0.9438202247191012
2022,ONAGRI,CITRANGE C35,40172,IMG-00025-39.jpg,109,103,103,0,6,1.0,0.944954128440367
2022,ONAGRI,CITRANGE C35,40172,IMG-00027-39.jpg,103,97,95,2,8,0.979381443298969,0.9223300970873788
2022,ONAGRI,CITRANGE C35,40173,IMG-00004-39.jpg,133,123,121,2,12,0.983739837398374,0.9097744360902256
2022,ONAGRI,CITRANGE C35,40173,IMG-00008-39.jpg,57,46,43,3,14,0.9347826086956522,0.7543859649122807
2022,ONAGRI,CITRANGE C35,40173,IMG-00010-39.jpg,53,52,51,1,2,0.9807692307692308,0.9622641509433962
2022,ONAGRI,CITRANGE C35,40175,IMG-00005-39.jpg,95,93,90,3,5,0.967741935483871,0.9473684210526316
2022,ONAGRI,CITRANGE C35,40175,IMG-00006-39.jpg,64,68,63,5,1,0.9264705882352942,0.984375
2022,ONAGRI,CITRANGE C35,40176,IMG-00004-39.jpg,79,84,75,9,4,0.8928571428571429,0.9493670886075948
2022,ONAGRI,CITRANGE C35,40176,IMG-00012-39.jpg,105,111,103,8,2,0.927927927927928,0.9809523809523808
2022,ONAGRI,CITRANGE C35,40176,IMG-00014-39.jpg,91,103,88,15,3,0.8543689320388349,0.967032967032967
2022,ONAGRI,CITRUMELO SACCATON,40177,IMG-00012-39.jpg,89,104,86,18,3,0.8269230769230769,0.9662921348314608
2022,ONAGRI,CITRUMELO SACCATON,40177,IMG-00015-39.jpg,213,222,210,12,3,0.945945945945946,0.9859154929577464
2022,ONAGRI,CITRUMELO SACCATON,40177,IMG-00037-39.jpg,95,97,91,6,4,0.9381443298969072,0.9578947368421052
2022,ONAGRI,CITRANGE C35,40178,IMG-00013-39.jpg,76,80,75,5,1,0.9375,0.986842105263158
2022,ONAGRI,CITRANGE C35,40178,IMG-00027-39.jpg,56,58,55,3,1,0.9482758620689656,0.9821428571428572
2022,ONAGRI,CITRANGE C35,40178,IMG-00031-39.jpg,30,33,29,4,1,0.8787878787878788,0.9666666666666668
2022,ONAGRI,CITRANGE C35,40178,IMG-00032-39.jpg,27,30,27,3,0,0.9,1.0
2022,ONAGRI,CITRANGE C35,40178,IMG-00033-39.jpg,34,39,34,5,0,0.8717948717948718,1.0
2022,ONAGRI,CITRANGE C35,40179,IMG-00001.jpg,83,89,82,7,1,0.9213483146067416,0.9879518072289156
2022,ONAGRI,CITRANGE C35,40179,IMG-00010-39.jpg,161,168,155,13,6,0.9226190476190476,0.9627329192546584
2022,ONAGRI,CITRANGE C35,40179,IMG-00011-39.jpg,102,112,99,13,3,0.8839285714285714,0.9705882352941176
2022,ONAGRI,CITRANGE C35,40179,IMG-00018-39.jpg,9,10,9,1,0,0.9,1.0
2022,ONAGRI,CITRUMELO SACCATON,40182,IMG-00004-39.jpg,35,37,35,2,0,0.945945945945946,1.0
2022,ONAGRI,CITRUMELO SACCATON,40182,IMG-00010-39.jpg,52,52,49,3,3,0.9423076923076924,0.9423076923076924
2022,ONAGRI,CITRUMELO SACCATON,40182,IMG-00015-39.jpg,85,86,78,8,7,0.9069767441860463,0.9176470588235294
2022,ONAGRI,CITRUMELO SACCATON,40183,IMG-00005-39.jpg,68,74,68,6,0,0.918918918918919,1.0
2022,ONAGRI,CITRUMELO SACCATON,40183,IMG-00009-39.jpg,57,63,57,6,0,0.9047619047619048,1.0
2022,ONAGRI,CITRUMELO SACCATON,40183,IMG-00010-39.jpg,48,52,47,5,1,0.903846153846154,0.9791666666666666
2024,KHOUALKA,CITRUS VOLKAMERIANA,50152,IMG-17274.jpg,170,125,124,1,46,0.992,0.7294117647058823
2024,KHOUALKA,CITRUS VOLKAMERIANA,50152,IMG-17306.jpg,105,84,83,1,22,0.988095238095238,0.7904761904761904
2024,KHOUALKA,CITRUS VOLKAMERIANA,50152,IMG-17330.jpg,41,31,31,0,10,1.0,0.7560975609756098
2024,KHOUALKA,CITRUS VOLKAMERIANA,50152,IMG-17335.jpg,44,35,35,0,9,1.0,0.7954545454545454
2024,KHOUALKA,CITRUS VOLKAMERIANA,50152,IMG-17340.jpg,108,75,73,2,35,0.9733333333333334,0.6759259259259259
2024,KHOUALKA,CITRUS VOLKAMERIANA,50152,IMG-17356.jpg,60,46,43,3,17,0.9347826086956522,0.7166666666666667
2024,KHOUALKA,CITRUS VOLKAMERIANA,50152,IMG-17384.jpg,53,30,30,0,23,1.0,0.5660377358490566
2024,KHOUALKA,CITRUS VOLKAMERIANA,50154,IMG-17440.jpg,76,62,61,1,15,0.9838709677419356,0.8026315789473685
2024,KHOUALKA,CITRUS VOLKAMERIANA,50154,IMG-17490.jpg,107,75,75,0,32,1.0,0.7009345794392523
2024,KHOUALKA,CITRUS VOLKAMERIANA,50154,IMG-17543.jpg,100,72,70,2,30,0.9722222222222222,0.7
2024,KHOUALKA,CITRUS VOLKAMERIANA,50154,IMG-17545.jpg,94,61,61,0,33,1.0,0.648936170212766
2024,KHOUALKA,CITRUS VOLKAMERIANA,50154,IMG-17562.jpg,129,102,101,1,28,0.9901960784313726,0.7829457364341085
2024,KHOUALKA,CITRUS VOLKAMERIANA,50154,IMG-17576.jpg,121,87,87,0,34,1.0,0.71900826446281
2024,KHOUALKA,CITRUS VOLKAMERIANA,50154,IMG-17585.jpg,171,117,114,3,57,0.9743589743589745,0.6666666666666666
2024,KHOUALKA,CITRUS VOLKAMERIANA,50168,IMG-13980.jpg,174,121,121,0,53,1.0,0.6954022988505747
2024,KHOUALKA,CITRUS VOLKAMERIANA,50168,IMG-15749.jpg,147,116,115,1,32,0.9913793103448276,0.782312925170068
2024,KHOUALKA,CITRUS VOLKAMERIANA,50168,IMG-15758.jpg,163,125,118,7,45,0.944,0.7239263803680982
2024,KHOUALKA,CITRUS VOLKAMERIANA,50168,IMG-15981.jpg,210,155,150,5,60,0.967741935483871,0.7142857142857143
2024,KHOUALKA,CITRUS VOLKAMERIANA,50168,IMG-15983.jpg,120,83,82,1,38,0.9879518072289156,0.6833333333333333
2024,KHOUALKA,CITRUS VOLKAMERIANA,50176,IMG-16025.jpg,81,60,59,1,22,0.9833333333333332,0.7283950617283951
2024,KHOUALKA,CITRUS VOLKAMERIANA,50176,IMG-16051.jpg,85,59,59,0,26,1.0,0.6941176470588235
2024,KHOUALKA,CITRUS VOLKAMERIANA,50176,IMG-16079.jpg,161,119,117,2,44,0.9831932773109244,0.7267080745341615
2024,KHOUALKA,CITRUS VOLKAMERIANA,50176,IMG-16095.jpg,101,62,62,0,39,1.0,0.6138613861386139
2024,KHOUALKA,CITRUS VOLKAMERIANA,50176,IMG-16105.jpg,43,26,26,0,17,1.0,0.6046511627906976
2022,ONAGRI,CITRUMELO SACCATON,50193,IMG-00007-39.jpg,218,237,215,22,3,0.9071729957805909,0.9862385321100916
2022,ONAGRI,CITRUMELO SACCATON,50193,IMG-00016-39.jpg,64,81,63,18,1,0.7777777777777778,0.984375
2022,ONAGRI,CITRUMELO SACCATON,50193,IMG-00018-39.jpg,115,120,112,8,3,0.9333333333333332,0.9739130434782608
2022,ONAGRI,CITRUMELO SACCATON,50193,IMG-00021-39.jpg,62,60,57,3,5,0.95,0.9193548387096774
2022,ONAGRI,CITRUMELO SACCATON,50193,IMG-00023-39.jpg,113,126,111,15,2,0.8809523809523809,0.9823008849557522
2022,ONAGRI,CITRUMELO SACCATON,50194,IMG-00032-39.jpg,162,167,153,14,9,0.9161676646706588,0.9444444444444444
2022,ONAGRI,CITRUMELO SACCATON,50194,IMG-00034-39.jpg,105,110,102,8,3,0.9272727272727272,0.9714285714285714
2022,ONAGRI,CITRUMELO SACCATON,50194,IMG-00036-39.jpg,161,166,150,16,11,0.9036144578313252,0.9316770186335404
2022,ONAGRI,CITRUMELO SACCATON,50194,IMG-00038-39.jpg,100,105,92,13,8,0.8761904761904762,0.92
2022,ONAGRI,CITRUMELO SACCATON,50194,IMG-00039-39.jpg,65,66,64,2,1,0.9696969696969696,0.9846153846153848
2022,ONAGRI,CITRUMELO SACCATON,50194,IMG-00041-39.jpg,153,154,148,6,5,0.961038961038961,0.9673202614379084
2022,ONAGRI,CITRUMELO SACCATON,50194,IMG-00051-39.jpg,137,138,131,7,6,0.9492753623188406,0.9562043795620438
2022,ONAGRI,CITRUMELO SACCATON,50194,IMG-00054-39.jpg,111,107,103,4,8,0.9626168224299064,0.927927927927928
2022,ONAGRI,CITRUMELO SACCATON,51091,IMG-00015-39.jpg,85,97,84,13,1,0.865979381443299,0.9882352941176472
2022,ONAGRI,CITRUMELO SACCATON,51091,IMG-00016-39.jpg,170,186,170,16,0,0.913978494623656,1.0
2022,ONAGRI,CITRUMELO SACCATON,51091,IMG-00018-39.jpg,185,203,181,22,4,0.8916256157635468,0.9783783783783784
2022,ONAGRI,CITRUMELO SACCATON,51091,IMG-00022-39.jpg,135,144,130,14,5,0.9027777777777778,0.9629629629629628
2022,ONAGRI,CITRUMELO SACCATON,51091,IMG-00023-39.jpg,140,136,130,6,10,0.9558823529411764,0.9285714285714286
2022,ONAGRI,CITRUMELO SACCATON,51091,IMG-00026-39.jpg,149,149,141,8,8,0.9463087248322148,0.9463087248322148
2022,ONAGRI,CITRUMELO SACCATON,51091,IMG-00044-39.jpg,168,179,167,12,1,0.9329608938547486,0.9940476190476192
2022,ONAGRI,CITRUMELO SACCATON,51095,IMG-00004-39.jpg,201,216,193,23,8,0.8935185185185185,0.9601990049751244
2022,ONAGRI,CITRUMELO SACCATON,51095,IMG-00013-39.jpg,154,151,146,5,8,0.9668874172185432,0.948051948051948
2022,ONAGRI,CITRUMELO SACCATON,51095,IMG-00014-39.jpg,140,146,135,11,5,0.9246575342465754,0.9642857142857144
2022,ONAGRI,CITRUMELO SACCATON,51095,IMG-00015-39.jpg,196,196,191,5,5,0.9744897959183674,0.9744897959183674
2022,ONAGRI,CITRUMELO SACCATON,51095,IMG-00024-39.jpg,234,245,227,18,7,0.926530612244898,0.97008547008547
2022,ONAGRI,CITRUMELO SACCATON,51095,IMG-00025-39.jpg,198,203,192,11,6,0.9458128078817734,0.9696969696969696
2022,ONAGRI,CITRUMELO SACCATON,51096,IMG-00009-39.jpg,219,222,209,13,10,0.9414414414414416,0.954337899543379
2022,ONAGRI,CITRUMELO SACCATON,51096,IMG-00011-39.jpg,145,158,139,19,6,0.879746835443038,0.9586206896551724
2022,ONAGRI,CITRUMELO SACCATON,51096,IMG-00012-39.jpg,114,112,106,6,8,0.9464285714285714,0.9298245614035088
2022,ONAGRI,CITRUMELO SACCATON,51096,IMG-00055-39.jpg,217,209,200,9,17,0.9569377990430622,0.9216589861751152
2022,ONAGRI,MC PONSIRUCE TRIFOLIATA,51097,IMG-00025-39.jpg,121,118,112,6,9,0.9491525423728814,0.9256198347107438
2022,ONAGRI,MC PONSIRUCE TRIFOLIATA,51097,IMG-00029-39.jpg,106,114,102,12,4,0.8947368421052632,0.9622641509433962
2022,ONAGRI,MC PONSIRUCE TRIFOLIATA,51097,IMG-00044-39.jpg,182,193,175,18,7,0.9067357512953368,0.9615384615384616
2022,ONAGRI,MC PONSIRUCE TRIFOLIATA,51098,IMG-00003-39.jpg,65,72,63,9,2,0.875,0.9692307692307692
2022,ONAGRI,MC PONSIRUCE TRIFOLIATA,51098,IMG-00010-39.jpg,184,189,179,10,5,0.9470899470899472,0.9728260869565216
2022,ONAGRI,MC PONSIRUCE TRIFOLIATA,51098,IMG-00015-39.jpg,162,168,162,6,0,0.9642857142857144,1.0
2022,ONAGRI,MC PONSIRUCE TRIFOLIATA,51099,IMG-00012-39.jpg,133,145,132,13,1,0.9103448275862068,0.9924812030075189
2024,ONAGRI,MC PONSIRUCE TRIFOLIATA,51101,IMG-12118.jpg,177,116,116,0,61,1.0,0.655367231638418
2024,ONAGRI,MC PONSIRUCE TRIFOLIATA,51101,IMG-14223.jpg,153,109,109,0,44,1.0,0.7124183006535948
2024,ONAGRI,MC PONSIRUCE TRIFOLIATA,51101,IMG-14226.jpg,151,118,114,4,37,0.9661016949152542,0.7549668874172185
2024,ONAGRI,MC PONSIRUCE TRIFOLIATA,51101,IMG-14255.jpg,189,148,148,0,41,1.0,0.783068783068783
2024,ONAGRI,MC PONSIRUCE TRIFOLIATA,51101,IMG-14281.jpg,150,106,106,0,44,1.0,0.7066666666666667
2022,ONAGRI,CITRUS VOLKAMERIANA,101020,IMG-00001.jpg,6,5,5,0,1,1.0,0.8333333333333334
2022,ONAGRI,CITRUS VOLKAMERIANA,101020,IMG-00004-44.jpg,53,37,37,0,16,1.0,0.6981132075471698
2022,ONAGRI,CITRUS VOLKAMERIANA,101030,IMG-00003-44.jpg,29,23,22,1,7,0.9565217391304348,0.7586206896551724
2022,ONAGRI,CITRUS VOLKAMERIANA,101030,IMG-00004-44.jpg,110,88,88,0,22,1.0,0.8
2022,ONAGRI,CITRUS VOLKAMERIANA,101030,IMG-00005-44.jpg,134,103,100,3,34,0.970873786407767,0.746268656716418
2022,ONAGRI,CITRUS VOLKAMERIANA,101030,IMG-00017-44.jpg,79,56,53,3,26,0.9464285714285714,0.6708860759493671
2022,ONAGRI,CITRUS VOLKAMERIANA,101040,IMG-00005-44.jpg,172,129,127,2,45,0.9844961240310076,0.7383720930232558
2022,ONAGRI,CITRUS VOLKAMERIANA,101040,IMG-00009-44.jpg,131,99,96,3,35,0.9696969696969696,0.732824427480916
2022,ONAGRI,CITRUS VOLKAMERIANA,101040,IMG-00011-44.jpg,64,44,42,2,22,0.9545454545454546,0.65625
2022,ONAGRI,CITRUS VOLKAMERIANA,101040,IMG-00012-44.jpg,139,89,86,3,53,0.9662921348314608,0.6187050359712231
2022,ONAGRI,CITRUS VOLKAMERIANA,101050,IMG-00002-44.jpg,95,73,70,3,25,0.958904109589041,0.7368421052631579
2022,ONAGRI,CITRUS VOLKAMERIANA,101050,IMG-00005-44.jpg,59,43,43,0,16,1.0,0.7288135593220338
2022,ONAGRI,CITRUS VOLKAMERIANA,101050,IMG-00011-44.jpg,46,24,23,1,23,0.9583333333333334,0.5
2022,ONAGRI,CITRUS VOLKAMERIANA,101050,IMG-00024-44.jpg,40,28,27,1,13,0.9642857142857144,0.675
2022,ONAGRI,CITRUS VOLKAMERIANA,101080,IMG-00005-44.jpg,42,30,29,1,13,0.9666666666666668,0.6904761904761905
2022,ONAGRI,CITRUS VOLKAMERIANA,101080,IMG-00006-44.jpg,79,55,53,2,26,0.9636363636363636,0.6708860759493671
2022,ONAGRI,CITRUS VOLKAMERIANA,101080,IMG-00023-44.jpg,7,6,6,0,1,1.0,0.8571428571428571
2022,ONAGRI,CITRUS VOLKAMERIANA,101080,IMG-00024-44.jpg,27,12,12,0,15,1.0,0.4444444444444444
2022,ONAGRI,CITRUS VOLKAMERIANA,101090,IMG-00003-44.jpg,66,52,50,2,16,0.9615384615384616,0.7575757575757576
2022,ONAGRI,CITRUS VOLKAMERIANA,101090,IMG-00006-44.jpg,41,28,26,2,15,0.9285714285714286,0.6341463414634146
2022,ONAGRI,CITRUS VOLKAMERIANA,101090,IMG-00019-44.jpg,35,30,27,3,8,0.9,0.7714285714285715
2022,ONAGRI,CITRUS VOLKAMERIANA,101090,IMG-00020-44.jpg,42,32,32,0,10,1.0,0.7619047619047619
2022,KHOUALKA,CITRANGE CARRIZO,102130,IMG-00001.jpg,5,2,1,1,4,0.5,0.2
2022,KHOUALKA,CITRANGE CARRIZO,102130,IMG-00004-43.jpg,24,8,8,0,16,1.0,0.3333333333333333
2022,KHOUALKA,CITRANGE CARRIZO,102130,IMG-00019-43.jpg,33,21,20,1,13,0.9523809523809524,0.6060606060606061
2022,KHOUALKA,CITRANGE CARRIZO,102130,IMG-00020-43.jpg,18,11,9,2,9,0.8181818181818182,0.5
2022,KHOUALKA,MACROPHYLLA,201180,IMG-00007-43.jpg,38,32,30,2,8,0.9375,0.7894736842105263
2022,KHOUALKA,MACROPHYLLA,201180,IMG-00011-43.jpg,64,33,33,0,31,1.0,0.515625
2022,KHOUALKA,MACROPHYLLA,201180,IMG-00019-43.jpg,64,36,36,0,28,1.0,0.5625
2022,KHOUALKA,MACROPHYLLA,201180,IMG-00020-43.jpg,43,28,27,1,16,0.9642857142857144,0.627906976744186
2022,KHOUALKA,MACROPHYLLA,201190,IMG-00004-43.jpg,101,45,45,0,56,1.0,0.4455445544554456
2022,KHOUALKA,MACROPHYLLA,201190,IMG-00010-43.jpg,90,31,31,0,59,1.0,0.3444444444444444
2022,KHOUALKA,MACROPHYLLA,201190,IMG-00011-43.jpg,134,52,52,0,82,1.0,0.3880597014925373
2022,KHOUALKA,MACROPHYLLA,201190,IMG-00020-43.jpg,95,46,46,0,49,1.0,0.4842105263157895
2022,KHOUALKA,CITRUS VOLKAMERIANA,201210,IMG-00011-43.jpg,103,60,60,0,43,1.0,0.5825242718446602
2022,KHOUALKA,CITRUS VOLKAMERIANA,201210,IMG-00012-43.jpg,42,21,21,0,21,1.0,0.5
2022,KHOUALKA,CITRUS VOLKAMERIANA,201210,IMG-00015-43.jpg,77,35,35,0,42,1.0,0.4545454545454545
2022,KHOUALKA,CITRUS VOLKAMERIANA,201210,IMG-00019-43.jpg,31,18,18,0,13,1.0,0.5806451612903226
2022,KHOUALKA,BIGARADIER,201320,IMG-00006-43.jpg,87,48,48,0,39,1.0,0.5517241379310345
2022,KHOUALKA,BIGARADIER,201320,IMG-00016-43.jpg,97,71,71,0,26,1.0,0.7319587628865979
2022,KHOUALKA,BIGARADIER,201320,IMG-00017-43.jpg,49,35,35,0,14,1.0,0.7142857142857143
2022,KHOUALKA,BIGARADIER,201320,IMG-00020-43.jpg,88,63,61,2,27,0.9682539682539684,0.6931818181818182
2022,ONAGRI,BIGARADIER,201390,IMG-00008-44.jpg,62,32,31,1,31,0.96875,0.5
2022,ONAGRI,BIGARADIER,201390,IMG-00011-44.jpg,90,46,44,2,46,0.9565217391304348,0.4888888888888889
2022,ONAGRI,BIGARADIER,201390,IMG-00013-44.jpg,77,26,26,0,51,1.0,0.3376623376623377
2022,ONAGRI,BIGARADIER,201390,IMG-00016-44.jpg,69,26,26,0,43,1.0,0.3768115942028986
2022,KHOUALKA,CITRUS VOLKAMERIANA,202050,IMG-00006-43.jpg,89,39,39,0,50,1.0,0.4382022471910113
2022,KHOUALKA,CITRUS VOLKAMERIANA,202050,IMG-00010-43.jpg,94,46,46,0,48,1.0,0.4893617021276596
2022,KHOUALKA,CITRUS VOLKAMERIANA,202050,IMG-00011-43.jpg,151,81,81,0,70,1.0,0.5364238410596026
2022,KHOUALKA,CITRUS VOLKAMERIANA,202050,IMG-00020-43.jpg,129,61,61,0,68,1.0,0.4728682170542636
2022,KHOUALKA,CITRUS VOLKAMERIANA,202070,IMG-00006-43.jpg,68,32,31,1,37,0.96875,0.4558823529411765
2022,KHOUALKA,CITRUS VOLKAMERIANA,202070,IMG-00009-43.jpg,120,55,55,0,65,1.0,0.4583333333333333
2022,KHOUALKA,CITRUS VOLKAMERIANA,202070,IMG-00013-43.jpg,95,44,44,0,51,1.0,0.4631578947368421
2022,KHOUALKA,CITRUS VOLKAMERIANA,202070,IMG-00019-43.jpg,57,31,31,0,26,1.0,0.543859649122807
2022,KHOUALKA,CITRUS VOLKAMERIANA,202080,IMG-00005-43.jpg,65,41,41,0,24,1.0,0.6307692307692307
2022,KHOUALKA,CITRUS VOLKAMERIANA,202080,IMG-00008-43.jpg,31,20,20,0,11,1.0,0.6451612903225806
2022,KHOUALKA,CITRUS VOLKAMERIANA,202080,IMG-00015-43.jpg,220,85,84,1,136,0.9882352941176472,0.3818181818181818
2022,KHOUALKA,CITRUS VOLKAMERIANA,202080,IMG-00016-43.jpg,131,63,63,0,68,1.0,0.4809160305343512
2022,KHOUALKA,CITRANGE CARRIZO,301380,IMG-00007-43.jpg,30,13,13,0,17,1.0,0.4333333333333333
2022,KHOUALKA,CITRANGE CARRIZO,301380,IMG-00011-43.jpg,53,34,34,0,19,1.0,0.6415094339622641
2022,KHOUALKA,CITRANGE CARRIZO,301380,IMG-00014-43.jpg,7,4,4,0,3,1.0,0.5714285714285714
2022,KHOUALKA,CITRANGE CARRIZO,301380,IMG-00020-43.jpg,91,46,46,0,45,1.0,0.5054945054945055
2022,ONAGRI,CITRUS VOLKAMERIANA,301470,IMG-00003-44.jpg,148,77,77,0,71,1.0,0.5202702702702703
2022,ONAGRI,CITRUS VOLKAMERIANA,301470,IMG-00004-44.jpg,163,60,59,1,104,0.9833333333333332,0.3619631901840491
2022,ONAGRI,CITRUS VOLKAMERIANA,301470,IMG-00005-44.jpg,160,54,54,0,106,1.0,0.3375
2022,ONAGRI,CITRUS VOLKAMERIANA,301480,IMG-00001.jpg,92,39,39,0,53,1.0,0.4239130434782609
2022,ONAGRI,CITRUS VOLKAMERIANA,301480,IMG-00003-43.jpg,26,11,11,0,15,1.0,0.4230769230769231
2022,ONAGRI,CITRUS VOLKAMERIANA,301480,IMG-00012-43.jpg,50,23,23,0,27,1.0,0.46
2022,ONAGRI,CITRUS VOLKAMERIANA,301480,IMG-00014-43.jpg,77,36,36,0,41,1.0,0.4675324675324675
2022,ONAGRI,CITRUS VOLKAMERIANA,301490,IMG-00005-44.jpg,108,36,35,1,73,0.9722222222222222,0.3240740740740741
2022,ONAGRI,CITRUS VOLKAMERIANA,301490,IMG-00009-44.jpg,185,65,64,1,121,0.9846153846153848,0.345945945945946
2022,ONAGRI,CITRUS VOLKAMERIANA,301490,IMG-00012-44.jpg,162,71,71,0,91,1.0,0.4382716049382716
2022,ONAGRI,CITRUS VOLKAMERIANA,301490,IMG-00015-44.jpg,109,39,39,0,70,1.0,0.3577981651376147
2022,ONAGRI,CITRUS VOLKAMERIANA,301510,IMG-00001.jpg,252,89,89,0,163,1.0,0.3531746031746032
2022,ONAGRI,CITRUS VOLKAMERIANA,301510,IMG-00006-44.jpg,137,56,56,0,81,1.0,0.4087591240875912
2022,ONAGRI,CITRUS VOLKAMERIANA,301510,IMG-00007-44.jpg,115,37,37,0,78,1.0,0.3217391304347826
2022,ONAGRI,CITRUS VOLKAMERIANA,301510,IMG-00008-44.jpg,150,66,65,1,85,0.9848484848484848,0.4333333333333333
2022,ONAGRI,BIGARADIER,301550,IMG-00008-44.jpg,144,66,66,0,78,1.0,0.4583333333333333
2022,ONAGRI,BIGARADIER,301550,IMG-00011-44.jpg,40,18,18,0,22,1.0,0.45
2022,ONAGRI,BIGARADIER,301550,IMG-00013-44.jpg,76,28,28,0,48,1.0,0.3684210526315789
2022,ONAGRI,BIGARADIER,301550,IMG-00014-44.jpg,80,31,28,3,52,0.9032258064516128,0.35
2022,ONAGRI,CITRUS VOLKAMERIANA,301570,IMG-00004-44.jpg,158,69,68,1,90,0.9855072463768116,0.4303797468354431
2022,ONAGRI,CITRUS VOLKAMERIANA,301570,IMG-00007-44.jpg,152,63,62,1,90,0.984126984126984,0.4078947368421053
2022,ONAGRI,CITRUS VOLKAMERIANA,301570,IMG-00008-44.jpg,103,36,36,0,67,1.0,0.3495145631067961
2022,ONAGRI,CITRUS VOLKAMERIANA,301570,IMG-00017-44.jpg,218,89,86,3,132,0.9662921348314608,0.3944954128440367
2022,KHOUALKA,CITRUS VOLKAMERIANA,302340,IMG-00004-43.jpg,106,54,54,0,52,1.0,0.5094339622641509
2022,KHOUALKA,CITRUS VOLKAMERIANA,302340,IMG-00005-43.jpg,105,58,58,0,47,1.0,0.5523809523809524
2022,KHOUALKA,CITRUS VOLKAMERIANA,302340,IMG-00011-43.jpg,75,31,30,1,45,0.967741935483871,0.4
2022,KHOUALKA,CITRUS VOLKAMERIANA,302340,IMG-00015-43.jpg,92,29,29,0,63,1.0,0.3152173913043478
2022,KHOUALKA,CITRUS VOLKAMERIANA,302350,IMG-00008-43.jpg,33,22,22,0,11,1.0,0.6666666666666666
2022,KHOUALKA,CITRUS VOLKAMERIANA,302350,IMG-00013-43.jpg,80,43,42,1,38,0.9767441860465116,0.525
2022,KHOUALKA,CITRUS VOLKAMERIANA,302350,IMG-00014-43.jpg,76,32,32,0,44,1.0,0.4210526315789473
2022,KHOUALKA,CITRUS VOLKAMERIANA,302350,IMG-00018-43.jpg,44,27,27,0,17,1.0,0.6136363636363636
2022,KHOUALKA,CITRUS VOLKAMERIANA,302360,IMG-00005-43.jpg,97,37,37,0,60,1.0,0.3814432989690721
2022,KHOUALKA,CITRUS VOLKAMERIANA,302360,IMG-00006-43.jpg,118,40,40,0,78,1.0,0.3389830508474576
2022,KHOUALKA,CITRUS VOLKAMERIANA,302360,IMG-00016-43.jpg,67,27,27,0,40,1.0,0.4029850746268657
2022,KHOUALKA,CITRUS VOLKAMERIANA,302360,IMG-00021-43.jpg,65,31,29,2,36,0.935483870967742,0.4461538461538462
2022,KHOUALKA,CITRUS VOLKAMERIANA,302510,IMG-00001.jpg,73,33,33,0,40,1.0,0.4520547945205479
2022,KHOUALKA,CITRUS VOLKAMERIANA,302510,IMG-00002-43.jpg,44,22,22,0,22,1.0,0.5
2022,KHOUALKA,CITRUS VOLKAMERIANA,302510,IMG-00003-43.jpg,78,52,49,3,29,0.9423076923076924,0.6282051282051282
2022,KHOUALKA,CITRUS VOLKAMERIANA,302510,IMG-00015-43.jpg,49,23,23,0,26,1.0,0.4693877551020408
2022,KHOUALKA,BIGARADIER,401410,IMG-00093-43.jpg,35,16,16,0,19,1.0,0.4571428571428571
2022,KHOUALKA,BIGARADIER,401410,IMG-00099-43.jpg,6,2,2,0,4,1.0,0.3333333333333333
2022,KHOUALKA,BIGARADIER,401410,IMG-00102-43.jpg,78,28,28,0,50,1.0,0.358974358974359
2022,KHOUALKA,BIGARADIER,401410,IMG-00104-43.jpg,81,31,31,0,50,1.0,0.382716049382716
2022,ONAGRI,CITRANGE C35,401660,IMG-00001.jpg,56,34,34,0,22,1.0,0.6071428571428571
2022,ONAGRI,CITRANGE C35,401660,IMG-00008-44.jpg,42,25,25,0,17,1.0,0.5952380952380952
2022,ONAGRI,CITRANGE C35,401660,IMG-00010-44.jpg,29,19,18,1,11,0.9473684210526316,0.6206896551724138
2022,ONAGRI,CITRANGE C35,401660,IMG-00016-44.jpg,64,35,35,0,29,1.0,0.546875
2022,ONAGRI,CITRANGE C35,401710,IMG-00003-44.jpg,51,28,28,0,23,1.0,0.5490196078431373
2022,ONAGRI,CITRANGE C35,401710,IMG-00012-44.jpg,19,15,15,0,4,1.0,0.7894736842105263
2022,ONAGRI,CITRANGE C35,401710,IMG-00013-44.jpg,33,26,26,0,7,1.0,0.7878787878787878
2022,ONAGRI,CITRANGE C35,401710,IMG-00019-44.jpg,76,55,55,0,21,1.0,0.7236842105263158
2022,ONAGRI,CITRANGE C35,401720,IMG-00007-44.jpg,93,58,57,1,36,0.9827586206896552,0.6129032258064516
2022,ONAGRI,CITRANGE C35,401720,IMG-00008-44.jpg,38,24,22,2,16,0.9166666666666666,0.5789473684210527
2022,ONAGRI,CITRANGE C35,401720,IMG-00010-44.jpg,50,20,20,0,30,1.0,0.4
2022,ONAGRI,CITRANGE C35,401720,IMG-00017-44.jpg,68,42,42,0,26,1.0,0.6176470588235294
2022,ONAGRI,CITRANGE C35,401730,IMG-00001.jpg,19,9,8,1,11,0.8888888888888888,0.4210526315789473
2022,ONAGRI,CITRANGE C35,401730,IMG-00010-44.jpg,50,29,29,0,21,1.0,0.58
2022,ONAGRI,CITRANGE C35,401730,IMG-00013-44.jpg,75,59,58,1,17,0.9830508474576272,0.7733333333333333
2022,ONAGRI,CITRANGE C35,401730,IMG-00016-44.jpg,36,24,23,1,13,0.9583333333333334,0.6388888888888888
2022,ONAGRI,CITRANGE C35,401750,IMG-00005-44.jpg,88,28,28,0,60,1.0,0.3181818181818182
2022,ONAGRI,CITRANGE C35,401750,IMG-00009-44.jpg,127,60,59,1,68,0.9833333333333332,0.4645669291338583
2022,ONAGRI,CITRANGE C35,401750,IMG-00016-44.jpg,107,53,53,0,54,1.0,0.4953271028037383
2022,ONAGRI,CITRANGE C35,401750,IMG-00024-44.jpg,50,26,26,0,24,1.0,0.52
2022,ONAGRI,CITRUMELO SACCATON,401770,IMG-00003-44.jpg,24,15,14,1,10,0.9333333333333332,0.5833333333333334
2022,ONAGRI,CITRUMELO SACCATON,401770,IMG-00008-44.jpg,72,40,40,0,32,1.0,0.5555555555555556
2022,ONAGRI,CITRUMELO SACCATON,401770,IMG-00009-44.jpg,14,8,7,1,7,0.875,0.5
2022,ONAGRI,CITRUMELO SACCATON,401770,IMG-00017-44.jpg,20,11,11,0,9,1.0,0.55
2022,KHOUALKA,BIGARADIER,402440,IMG-00005-43.jpg,17,4,4,0,13,1.0,0.2352941176470588
2022,KHOUALKA,BIGARADIER,402440,IMG-00012-43.jpg,46,23,23,0,23,1.0,0.5
2022,KHOUALKA,BIGARADIER,402440,IMG-00014-43.jpg,11,4,3,1,8,0.75,0.2727272727272727
2022,KHOUALKA,BIGARADIER,402440,IMG-00015-43.jpg,22,5,5,0,17,1.0,0.2272727272727273
2022,KHOUALKA,BIGARADIER,402590,IMG-00007-43.jpg,104,50,49,1,55,0.98,0.4711538461538461
2022,KHOUALKA,BIGARADIER,402590,IMG-00012-43.jpg,45,21,20,1,25,0.9523809523809524,0.4444444444444444
2022,KHOUALKA,BIGARADIER,402590,IMG-00015-43.jpg,58,36,35,1,23,0.9722222222222222,0.603448275862069
2022,KHOUALKA,BIGARADIER,402590,IMG-00019-43.jpg,64,43,42,1,22,0.9767441860465116,0.65625
2022,KHOUALKA,CITRUS VOLKAMERIANA,501520,IMG-00004-43.jpg,39,15,15,0,24,1.0,0.3846153846153846
2022,KHOUALKA,CITRUS VOLKAMERIANA,501520,IMG-00007-43.jpg,43,18,18,0,25,1.0,0.4186046511627907
2022,KHOUALKA,CITRUS VOLKAMERIANA,501520,IMG-00015-43.jpg,18,7,7,0,11,1.0,0.3888888888888889
2022,KHOUALKA,CITRUS VOLKAMERIANA,501520,IMG-00020-43.jpg,48,25,25,0,23,1.0,0.5208333333333334
2022,KHOUALKA,CITRUS VOLKAMERIANA,501540,IMG-00006-43.jpg,38,28,27,1,11,0.9642857142857144,0.7105263157894737
2022,KHOUALKA,CITRUS VOLKAMERIANA,501540,IMG-00012-43.jpg,102,63,62,1,40,0.984126984126984,0.6078431372549019
2022,KHOUALKA,CITRUS VOLKAMERIANA,501540,IMG-00017-43.jpg,138,51,51,0,87,1.0,0.3695652173913043
2022,KHOUALKA,CITRUS VOLKAMERIANA,501540,IMG-00018-43.jpg,51,23,22,1,29,0.9565217391304348,0.4313725490196079
2022,KHOUALKA,CITRUS VOLKAMERIANA,501660,IMG-00006-43.jpg,60,38,34,4,26,0.8947368421052632,0.5666666666666667
2022,KHOUALKA,CITRUS VOLKAMERIANA,501660,IMG-00016-43.jpg,63,36,35,1,28,0.9722222222222222,0.5555555555555556
2022,KHOUALKA,CITRUS VOLKAMERIANA,501660,IMG-00018-43.jpg,112,47,47,0,65,1.0,0.4196428571428572
2022,KHOUALKA,CITRUS VOLKAMERIANA,501660,IMG-00021-43.jpg,90,48,48,0,42,1.0,0.5333333333333333
2022,KHOUALKA,CITRUS VOLKAMERIANA,501680,IMG-00005-43.jpg,179,89,89,0,90,1.0,0.4972067039106145
2022,KHOUALKA,CITRUS VOLKAMERIANA,501680,IMG-00011-43.jpg,101,37,37,0,64,1.0,0.3663366336633663
2022,KHOUALKA,CITRUS VOLKAMERIANA,501680,IMG-00012-43.jpg,76,27,27,0,49,1.0,0.3552631578947368
2022,KHOUALKA,CITRUS VOLKAMERIANA,501680,IMG-00016-43.jpg,113,60,59,1,54,0.9833333333333332,0.5221238938053098
2022,KHOUALKA,CITRUS VOLKAMERIANA,501690,IMG-00032-43.jpg,34,9,9,0,25,1.0,0.2647058823529412
2022,KHOUALKA,CITRUS VOLKAMERIANA,501690,IMG-00039-43.jpg,186,84,83,1,103,0.988095238095238,0.4462365591397849
2022,KHOUALKA,CITRUS VOLKAMERIANA,501690,IMG-00047-43.jpg,103,41,41,0,62,1.0,0.3980582524271845
2022,KHOUALKA,CITRUS VOLKAMERIANA,501690,IMG-00049-43.jpg,166,82,82,0,84,1.0,0.4939759036144578
2022,KHOUALKA,CITRUS VOLKAMERIANA,501760,IMG-00001.jpg,94,29,29,0,65,1.0,0.3085106382978723
2022,KHOUALKA,CITRUS VOLKAMERIANA,501760,IMG-00034-43.jpg,45,10,10,0,35,1.0,0.2222222222222222
2022,KHOUALKA,CITRUS VOLKAMERIANA,501760,IMG-00036-43.jpg,40,17,17,0,23,1.0,0.425
2022,KHOUALKA,CITRUS VOLKAMERIANA,501760,IMG-00051-43.jpg,92,28,28,0,64,1.0,0.3043478260869565
2022,ONAGRI,CITRUMELO SACCATON,510910,IMG-00004-44.jpg,73,45,44,1,29,0.9777777777777776,0.6027397260273972
2022,ONAGRI,CITRUMELO SACCATON,510910,IMG-00008-44.jpg,152,66,66,0,86,1.0,0.4342105263157895
2022,ONAGRI,CITRUMELO SACCATON,510910,IMG-00010-44.jpg,107,63,61,2,46,0.9682539682539684,0.5700934579439252
2022,ONAGRI,CITRUMELO SACCATON,510910,IMG-00011-44.jpg,92,54,52,2,40,0.9629629629629628,0.5652173913043478
2022,ONAGRI,CITRUMELO SACCATON,510950,IMG-00006-44.jpg,70,44,43,1,27,0.9772727272727272,0.6142857142857143
2022,ONAGRI,CITRUMELO SACCATON,510950,IMG-00008-44.jpg,75,43,43,0,32,1.0,0.5733333333333334
2022,ONAGRI,CITRUMELO SACCATON,510950,IMG-00009-44.jpg,85,48,46,2,39,0.9583333333333334,0.5411764705882353
2022,ONAGRI,CITRUMELO SACCATON,510950,IMG-00011-44.jpg,135,86,86,0,49,1.0,0.6370370370370371
2022,ONAGRI,MC PONSIRUCE TRIFOLIATA,510980,IMG-00014-44.jpg,67,37,36,1,31,0.972972972972973,0.5373134328358209
2022,ONAGRI,MC PONSIRUCE TRIFOLIATA,510980,IMG-00015-44.jpg,51,32,32,0,19,1.0,0.6274509803921569
2022,ONAGRI,MC PONSIRUCE TRIFOLIATA,510980,IMG-00016-44.jpg,99,49,49,0,50,1.0,0.494949494949495
2022,ONAGRI,MC PONSIRUCE TRIFOLIATA,510980,IMG-00019-44.jpg,102,53,53,0,49,1.0,0.5196078431372549
2022,ONAGRI,MC PONSIRUCE TRIFOLIATA,510990,IMG-00006-44.jpg,135,78,76,2,59,0.9743589743589745,0.562962962962963
2022,ONAGRI,MC PONSIRUCE TRIFOLIATA,510990,IMG-00008-44.jpg,110,76,75,1,35,0.986842105263158,0.6818181818181818
2022,ONAGRI,MC PONSIRUCE TRIFOLIATA,510990,IMG-00009-44.jpg,85,57,52,5,33,0.912280701754386,0.611764705882353
2022,ONAGRI,MC PONSIRUCE TRIFOLIATA,510990,IMG-00024-44.jpg,65,36,36,0,29,1.0,0.5538461538461539
2022,ONAGRI,MC PONSIRUCE TRIFOLIATA,511030,IMG-00007-44.jpg,100,77,73,4,27,0.948051948051948,0.73
2022,ONAGRI,MC PONSIRUCE TRIFOLIATA,511030,IMG-00016-44.jpg,63,43,43,0,20,1.0,0.6825396825396826
2022,ONAGRI,MC PONSIRUCE TRIFOLIATA,511030,IMG-00022-44.jpg,98,76,73,3,25,0.9605263157894736,0.7448979591836735
2022,ONAGRI,MC PONSIRUCE TRIFOLIATA,511030,IMG-00027-44.jpg,82,64,63,1,19,0.984375,0.7682926829268293
2022,ONAGRI,MS PONSIRUCE TRIFOLIATA,511040,IMG-00004-44.jpg,77,55,54,1,23,0.9818181818181818,0.7012987012987013
2022,ONAGRI,MS PONSIRUCE TRIFOLIATA,511040,IMG-00014-44.jpg,48,34,31,3,17,0.9117647058823528,0.6458333333333334
2022,ONAGRI,MS PONSIRUCE TRIFOLIATA,511040,IMG-00016-44.jpg,71,37,36,1,35,0.972972972972973,0.5070422535211268
2022,ONAGRI,MS PONSIRUCE TRIFOLIATA,511040,IMG-00025-44.jpg,56,31,31,0,25,1.0,0.5535714285714286
2022,ONAGRI,FUZHU,511050,IMG-00004-44.jpg,109,52,51,1,58,0.9807692307692308,0.4678899082568808
2022,ONAGRI,FUZHU,511050,IMG-00006-44.jpg,142,79,78,1,64,0.9873417721518988,0.5492957746478874
2022,ONAGRI,FUZHU,511050,IMG-00011-44.jpg,172,120,115,5,57,0.9583333333333334,0.6686046511627907
2022,ONAGRI,FUZHU,511050,IMG-00022-44.jpg,194,128,127,1,67,0.9921875,0.654639175257732
2022,ONAGRI,MS PONSIRUCE TRIFOLIATA,511060,IMG-00007-44.jpg,115,71,70,1,45,0.9859154929577464,0.6086956521739131
2022,ONAGRI,MS PONSIRUCE TRIFOLIATA,511060,IMG-00016-44.jpg,102,57,55,2,47,0.9649122807017544,0.5392156862745098
2022,ONAGRI,MS PONSIRUCE TRIFOLIATA,511060,IMG-00017-44.jpg,59,26,25,1,34,0.9615384615384616,0.423728813559322
2022,ONAGRI,MS PONSIRUCE TRIFOLIATA,511060,IMG-00019-44.jpg,108,61,59,2,49,0.9672131147540984,0.5462962962962963
2022,ONAGRI,FUZHU,511070,IMG-00006-44.jpg,82,58,58,0,24,1.0,0.7073170731707317
2022,ONAGRI,FUZHU,511070,IMG-00016-44.jpg,96,53,51,2,45,0.9622641509433962,0.53125
2022,ONAGRI,FUZHU,511070,IMG-00018-44.jpg,93,56,56,0,37,1.0,0.6021505376344086
2022,ONAGRI,FUZHU,511070,IMG-00019-44.jpg,142,87,85,2,57,0.9770114942528736,0.5985915492957746
