compagnie,Domaine,Porte-greffe,parcelle,Filename,True_count,detect_count,TP,FP,FN,Precision,Recall
2022,SAOUDA,BIGARADIER,10010,IMG-00011-45.jpg,28,37,28,9,0,0.7567567567567568,1.0
2022,SAOUDA,BIGARADIER,10010,IMG-00012-45.jpg,27,37,27,10,0,0.7297297297297297,1.0
2022,SAOUDA,BIGARADIER,10010,IMG-00014-45.jpg,50,64,48,16,2,0.75,0.96
2022,SAOUDA,BIGARADIER,10010,IMG-00018-45.jpg,30,35,29,6,1,0.8285714285714286,0.9666666666666668
2022,SAOUDA,BIGARADIER,10010,IMG-00020-45.jpg,31,43,31,12,0,0.7209302325581395,1.0
2024,SAOUDA,BIGARADIER,10010,IMG-23410.jpg,85,39,36,3,49,0.9230769230769232,0.4235294117647059
2024,SAOUDA,BIGARADIER,10010,IMG-23417.jpg,86,44,44,0,42,1.0,0.5116279069767442
2024,SAOUDA,BIGARADIER,10010,IMG-23430.jpg,74,41,41,0,33,1.0,0.5540540540540541
2024,SAOUDA,BIGARADIER,10010,IMG-23647.jpg,95,58,58,0,37,1.0,0.6105263157894737
2024,SAOUDA,BIGARADIER,10010,IMG-23672.jpg,47,13,12,1,35,0.9230769230769232,0.2553191489361702
2024,SAOUDA,BIGARADIER,10010,IMG-23707.jpg,30,23,23,0,7,1.0,0.7666666666666667
2024,SAOUDA,BIGARADIER,10010,IMG-23709.jpg,31,15,15,0,16,1.0,0.4838709677419355
2024,SAOUDA,BIGARADIER,10010,IMG-23711.jpg,79,40,38,2,41,0.95,0.4810126582278481
2022,SAOUDA,MACROPHYLLA,10030,IMG-00158-45.jpg,101,136,99,37,2,0.7279411764705882,0.9801980198019802
2022,SAOUDA,MACROPHYLLA,10030,IMG-00159-45.jpg,155,194,155,39,0,0.7989690721649485,1.0
2022,SAOUDA,MACROPHYLLA,10030,IMG-00162-45.jpg,119,143,117,26,2,0.8181818181818182,0.9831932773109244
2022,SAOUDA,MACROPHYLLA,10030,IMG-00169-45.jpg,72,97,72,25,0,0.7422680412371134,1.0
2022,SAOUDA,MACROPHYLLA,10031,IMG-00002-45.jpg,46,51,43,8,3,0.8431372549019608,0.9347826086956522
2022,SAOUDA,MACROPHYLLA,10031,IMG-00084-45.jpg,41,55,41,14,0,0.7454545454545455,1.0
2022,SAOUDA,MACROPHYLLA,10031,IMG-00450-45.jpg,27,41,26,15,1,0.6341463414634146,0.9629629629629628
2022,SAOUDA,MACROPHYLLA,10031,IMG-00451-45.jpg,34,44,31,13,3,0.7045454545454546,0.9117647058823528
2022,SAOUDA,MACROPHYLLA,10031,IMG-00464-45.jpg,33,41,33,8,0,0.8048780487804879,1.0
2022,ONAGRI,CITRUS VOLKAMERIANA,10101,IMG-00003-39.jpg,120,121,112,9,8,0.9256198347107438,0.9333333333333332
2022,ONAGRI,CITRUS VOLKAMERIANA,10101,IMG-00010-39.jpg,85,84,78,6,7,0.9285714285714286,0.9176470588235294
2024,ONAGRI,CITRUS VOLKAMERIANA,10101,IMG-10523.jpg,288,228,228,0,60,1.0,0.7916666666666666
2024,ONAGRI,CITRUS VOLKAMERIANA,10101,IMG-10545.jpg,98,75,74,1,24,0.9866666666666668,0.7551020408163265
2024,ONAGRI,CITRUS VOLKAMERIANA,10101,IMG-10558.jpg,143,104,101,3,42,0.971153846153846,0.7062937062937062
2022,ONAGRI,CITRUS VOLKAMERIANA,10102,IMG-00003-39.jpg,48,37,36,1,12,0.972972972972973,0.75
2024,ONAGRI,CITRUS VOLKAMERIANA,10102,IMG-10637.jpg,140,112,112,0,28,1.0,0.8
2024,ONAGRI,CITRUS VOLKAMERIANA,10102,IMG-10658.jpg,163,132,129,3,34,0.9772727272727272,0.7914110429447853
2022,ONAGRI,CITRUS VOLKAMERIANA,10103,IMG-00003-39.jpg,215,199,189,10,26,0.949748743718593,0.8790697674418605
2022,ONAGRI,CITRUS VOLKAMERIANA,10103,IMG-00008-39.jpg,195,183,173,10,22,0.9453551912568308,0.8871794871794871
2024,ONAGRI,CITRUS VOLKAMERIANA,10103,IMG-10614.jpg,134,115,112,3,22,0.9739130434782608,0.835820895522388
2024,ONAGRI,CITRUS VOLKAMERIANA,10103,IMG-10630.jpg,213,175,173,2,40,0.9885714285714284,0.812206572769953
2024,ONAGRI,CITRUS VOLKAMERIANA,10103,IMG-10631.jpg,134,102,102,0,32,1.0,0.7611940298507462
2022,ONAGRI,CITRUS VOLKAMERIANA,10104,IMG-00004-39.jpg,65,63,59,4,6,0.9365079365079364,0.9076923076923076
2022,ONAGRI,CITRUS VOLKAMERIANA,10104,IMG-00008-39.jpg,69,68,60,8,9,0.8823529411764706,0.8695652173913043
2024,ONAGRI,CITRUS VOLKAMERIANA,10104,IMG-11267.jpg,22,13,13,0,9,1.0,0.5909090909090909
2024,ONAGRI,CITRUS VOLKAMERIANA,10104,IMG-11327.jpg,128,107,105,2,23,0.9813084112149532,0.8203125
2024,ONAGRI,CITRUS VOLKAMERIANA,10104,IMG-11347.jpg,118,98,96,2,22,0.979591836734694,0.8135593220338984
2024,ONAGRI,CITRUS VOLKAMERIANA,10104,IMG-11366.jpg,351,253,250,3,101,0.9881422924901184,0.7122507122507122
2024,ONAGRI,CITRUS VOLKAMERIANA,10104,IMG-11386.jpg,99,77,76,1,23,0.987012987012987,0.7676767676767676
2022,ONAGRI,CITRUS VOLKAMERIANA,10105,IMG-00004-39.jpg,17,17,14,3,3,0.8235294117647058,0.8235294117647058
2022,ONAGRI,CITRUS VOLKAMERIANA,10105,IMG-00005-39.jpg,68,69,65,4,3,0.9420289855072465,0.9558823529411764
2022,ONAGRI,CITRUS VOLKAMERIANA,10108,IMG-00003-39.jpg,61,58,55,3,6,0.9482758620689656,0.9016393442622952
2022,ONAGRI,CITRUS VOLKAMERIANA,10108,IMG-00007-39.jpg,69,61,60,1,9,0.9836065573770492,0.8695652173913043
2022,ONAGRI,CITRUS VOLKAMERIANA,10109,IMG-00003-39.jpg,4,4,4,0,0,1.0,1.0
2022,ONAGRI,CITRUS VOLKAMERIANA,10109,IMG-00008-39.jpg,105,100,94,6,11,0.94,0.8952380952380953
2022,KHOUALKA,CITRANGE CARRIZO,10213,IMG-00001.jpg,77,90,75,15,2,0.8333333333333334,0.974025974025974
2022,KHOUALKA,CITRANGE CARRIZO,10213,IMG-00005-40.jpg,73,84,72,12,1,0.8571428571428571,0.9863013698630136
2022,KHOUALKA,CITRANGE CARRIZO,10213,IMG-00009-40.jpg,14,18,14,4,0,0.7777777777777778,1.0
2022,KHOUALKA,CITRANGE CARRIZO,10213,IMG-00014-40.jpg,21,22,19,3,2,0.8636363636363636,0.9047619047619048
2022,KHOUALKA,CITRANGE CARRIZO,10213,IMG-00028-40.jpg,47,47,45,2,2,0.9574468085106383,0.9574468085106383
2022,KHOUALKA,CITRANGE CARRIZO,10213,IMG-00034-40.jpg,48,47,46,1,2,0.9787234042553192,0.9583333333333334
2022,KHOUALKA,CITRANGE CARRIZO,10213,IMG-00035-40.jpg,37,39,36,3,1,0.9230769230769232,0.972972972972973
2022,KHOUALKA,CITRANGE CARRIZO,10213,IMG-00036-40.jpg,47,53,46,7,1,0.8679245283018868,0.9787234042553192
2022,KHOUALKA,CITRANGE CARRIZO,10213,IMG-00042-40.jpg,22,22,20,2,2,0.9090909090909092,0.9090909090909092
2022,KHOUALKA,CITRANGE CARRIZO,10213,IMG-00047-40.jpg,70,71,67,4,3,0.943661971830986,0.9571428571428572
2022,KHOUALKA,CITRANGE CARRIZO,10213,IMG-00054-40.jpg,33,38,32,6,1,0.8421052631578947,0.9696969696969696
2022,KHOUALKA,CITRANGE CARRIZO,10213,IMG-00055-40.jpg,93,98,90,8,3,0.9183673469387756,0.967741935483871
2022,KHOUALKA,CITRANGE CARRIZO,10213,IMG-00061-40.jpg,113,122,109,13,4,0.8934426229508197,0.9646017699115044
2022,KHOUALKA,CITRANGE CARRIZO,10213,IMG-00066-40.jpg,48,52,41,11,7,0.7884615384615384,0.8541666666666666
2024,KHOUALKA,CITRANGE CARRIZO,10213,IMG-12628.jpg,119,98,97,1,22,0.9897959183673468,0.8151260504201681
2024,KHOUALKA,CITRANGE CARRIZO,10213,IMG-12774.jpg,118,93,93,0,25,1.0,0.788135593220339
2024,KHOUALKA,CITRANGE CARRIZO,10213,IMG-12780.jpg,44,39,38,1,6,0.9743589743589745,0.8636363636363636
2024,KHOUALKA,CITRANGE CARRIZO,10213,IMG-12791.jpg,166,124,124,0,42,1.0,0.7469879518072289
2024,KHOUALKA,CITRANGE CARRIZO,10213,IMG-12834.jpg,57,43,41,2,16,0.9534883720930232,0.7192982456140351
2024,KHOUALKA,CITRANGE CARRIZO,10213,IMG-12945.jpg,130,105,105,0,25,1.0,0.8076923076923077
2022,OUARGHA,MACROPHYLLA,11010,IMG-00001.jpg,40,43,39,4,1,0.9069767441860463,0.975
2022,OUARGHA,MACROPHYLLA,11010,IMG-00015-41.jpg,24,26,22,4,2,0.8461538461538461,0.9166666666666666
2022,OUARGHA,MACROPHYLLA,11010,IMG-00019-41.jpg,20,31,20,11,0,0.6451612903225806,1.0
2022,OUARGHA,MACROPHYLLA,11010,IMG-00024-41.jpg,21,24,21,3,0,0.875,1.0
2022,OUARGHA,MACROPHYLLA,11020,IMG-00017-41.jpg,51,56,50,6,1,0.8928571428571429,0.9803921568627452
2022,OUARGHA,MACROPHYLLA,11020,IMG-00018-41.jpg,13,13,12,1,1,0.9230769230769232,0.9230769230769232
2022,OUARGHA,CITRANGE CARRIZO,13010,IMG-00067-41.jpg,55,73,55,18,0,0.7534246575342466,1.0
2022,OUARGHA,CITRANGE CARRIZO,13010,IMG-00086-41.jpg,49,59,49,10,0,0.8305084745762712,1.0
2022,OUARGHA,CITRANGE CARRIZO,13010,IMG-00194-41.jpg,33,42,32,10,1,0.7619047619047619,0.9696969696969696
2022,OUARGHA,CITRANGE CARRIZO,13020,IMG-00023-41.jpg,31,38,30,8,1,0.7894736842105263,0.967741935483871
2022,OUARGHA,CITRANGE CARRIZO,13020,IMG-00024-41.jpg,18,23,18,5,0,0.782608695652174,1.0
2022,OUARGHA,CITRANGE CARRIZO,13020,IMG-00039-41.jpg,4,12,4,8,0,0.3333333333333333,1.0
2022,OUARGHA,CITRANGE CARRIZO,13020,IMG-00040-41.jpg,6,12,6,6,0,0.5,1.0
2022,OUARGHA,CITRUS VOLKAMERIANA,13030,IMG-00009-41.jpg,18,25,17,8,1,0.68,0.9444444444444444
2022,OUARGHA,CITRUS VOLKAMERIANA,13030,IMG-00013-41.jpg,46,69,46,23,0,0.6666666666666666,1.0
2022,OUARGHA,CITRUS VOLKAMERIANA,13030,IMG-00027-41.jpg,12,24,12,12,0,0.5,1.0
2022,OUARGHA,CITRUS VOLKAMERIANA,13030,IMG-00029-41.jpg,18,33,18,15,0,0.5454545454545454,1.0
2022,OUARGHA,CITRUS VOLKAMERIANA,13030,IMG-00036-41.jpg,16,36,16,20,0,0.4444444444444444,1.0
2022,OUARGHA,CITRUS VOLKAMERIANA,14010,IMG-00008-41.jpg,40,46,37,9,3,0.8043478260869565,0.925
2022,OUARGHA,CITRUS VOLKAMERIANA,14010,IMG-00010-41.jpg,49,58,47,11,2,0.8103448275862069,0.9591836734693876
2022,OUARGHA,CITRUS VOLKAMERIANA,14010,IMG-00011-41.jpg,47,59,47,12,0,0.7966101694915254,1.0
2022,OUARGHA,CITRUS VOLKAMERIANA,14010,IMG-00018-41.jpg,44,59,44,15,0,0.7457627118644068,1.0
2022,KHOUALKA,MACROPHYLLA,20118,IMG-00007-40.jpg,44,47,43,4,1,0.9148936170212766,0.9772727272727272
2022,KHOUALKA,MACROPHYLLA,20118,IMG-00008-40.jpg,115,122,114,8,1,0.9344262295081968,0.991304347826087
2022,KHOUALKA,MACROPHYLLA,20118,IMG-00022-40.jpg,113,110,105,5,8,0.9545454545454546,0.9292035398230089
2022,KHOUALKA,MACROPHYLLA,20118,IMG-00033-40.jpg,58,63,57,6,1,0.9047619047619048,0.9827586206896552
2022,KHOUALKA,MACROPHYLLA,20118,IMG-00037-40.jpg,29,33,29,4,0,0.8787878787878788,1.0
2022,KHOUALKA,MACROPHYLLA,20118,IMG-00042-40.jpg,137,145,132,13,5,0.9103448275862068,0.9635036496350364
2022,KHOUALKA,MACROPHYLLA,20118,IMG-00046-40.jpg,45,48,44,4,1,0.9166666666666666,0.9777777777777776
2022,KHOUALKA,MACROPHYLLA,20118,IMG-00050-40.jpg,48,47,43,4,5,0.9148936170212766,0.8958333333333334
2022,KHOUALKA,MACROPHYLLA,20118,IMG-00055-40.jpg,52,49,47,2,5,0.9591836734693876,0.903846153846154
2022,KHOUALKA,MACROPHYLLA,20118,IMG-00061-40.jpg,120,126,114,12,6,0.9047619047619048,0.95
2022,KHOUALKA,MACROPHYLLA,20118,IMG-00062-40.jpg,63,65,58,7,5,0.8923076923076924,0.9206349206349206
2022,KHOUALKA,MACROPHYLLA,20118,IMG-00063-40.jpg,47,50,43,7,4,0.86,0.9148936170212766
2022,KHOUALKA,MACROPHYLLA,20118,IMG-00066-40.jpg,84,90,81,9,3,0.9,0.9642857142857144
2024,KHOUALKA,MACROPHYLLA,20118,IMG-12691.jpg,22,14,14,0,8,1.0,0.6363636363636364
2024,KHOUALKA,MACROPHYLLA,20118,IMG-12729.jpg,56,44,44,0,12,1.0,0.7857142857142857
2024,KHOUALKA,MACROPHYLLA,20118,IMG-12735.jpg,88,68,68,0,20,1.0,0.7727272727272727
2024,KHOUALKA,MACROPHYLLA,20118,IMG-12748.jpg,107,80,78,2,29,0.975,0.7289719626168224
2024,KHOUALKA,MACROPHYLLA,20118,IMG-12764.jpg,111,93,91,2,20,0.978494623655914,0.8198198198198198
2024,KHOUALKA,MACROPHYLLA,20118,IMG-12808.jpg,113,78,77,1,36,0.9871794871794872,0.6814159292035398
2024,KHOUALKA,MACROPHYLLA,20118,IMG-12851.jpg,24,12,12,0,12,1.0,0.5
2022,KHOUALKA,MACROPHYLLA,20119,IMG-00005-40.jpg,106,109,102,7,4,0.9357798165137616,0.9622641509433962
2022,KHOUALKA,MACROPHYLLA,20119,IMG-00008-40.jpg,142,146,134,12,8,0.9178082191780822,0.943661971830986
2022,KHOUALKA,MACROPHYLLA,20119,IMG-00014-40.jpg,132,133,125,8,7,0.9398496240601504,0.946969696969697
2022,KHOUALKA,BIGARADIER,20132,IMG-00004-40.jpg,181,182,177,5,4,0.9725274725274724,0.9779005524861878
2022,KHOUALKA,BIGARADIER,20132,IMG-00025-40.jpg,91,96,86,10,5,0.8958333333333334,0.945054945054945
2022,KHOUALKA,BIGARADIER,20132,IMG-00028-40.jpg,49,54,48,6,1,0.8888888888888888,0.979591836734694
2022,KHOUALKA,BIGARADIER,20132,IMG-00035-40.jpg,103,116,102,14,1,0.8793103448275862,0.9902912621359224
2022,KHOUALKA,BIGARADIER,20132,IMG-00039-40.jpg,119,128,117,11,2,0.9140625,0.9831932773109244
2022,KHOUALKA,BIGARADIER,20132,IMG-00046-40.jpg,156,166,151,15,5,0.9096385542168676,0.967948717948718
2022,KHOUALKA,BIGARADIER,20132,IMG-00051-40.jpg,108,109,103,6,5,0.944954128440367,0.9537037037037036
2022,KHOUALKA,BIGARADIER,20132,IMG-00055-40.jpg,67,70,62,8,5,0.8857142857142857,0.9253731343283582
2022,KHOUALKA,BIGARADIER,20132,IMG-00058-40.jpg,89,90,87,3,2,0.9666666666666668,0.9775280898876404
2022,KHOUALKA,BIGARADIER,20132,IMG-00059-40.jpg,139,134,129,5,10,0.9626865671641792,0.9280575539568344
2022,KHOUALKA,BIGARADIER,20132,IMG-00060-40.jpg,57,52,51,1,6,0.9807692307692308,0.8947368421052632
2022,KHOUALKA,BIGARADIER,20132,IMG-00064-40.jpg,117,127,114,13,3,0.8976377952755905,0.9743589743589745
2022,KHOUALKA,BIGARADIER,20132,IMG-00075-40.jpg,69,75,68,7,1,0.9066666666666666,0.9855072463768116
2022,ONAGRI,BIGARADIER,20139,IMG-00021-39.jpg,93,91,86,5,7,0.945054945054945,0.9247311827956988
2024,KHOUALKA,CITRUS VOLKAMERIANA,20205,IMG-12040.jpg,123,94,92,2,31,0.9787234042553192,0.7479674796747967
2024,KHOUALKA,CITRUS VOLKAMERIANA,20205,IMG-12058.jpg,116,114,109,5,7,0.956140350877193,0.9396551724137931
2024,KHOUALKA,CITRUS VOLKAMERIANA,20207,IMG-11892.jpg,94,73,67,6,27,0.9178082191780822,0.7127659574468085
2024,KHOUALKA,CITRUS VOLKAMERIANA,20207,IMG-11921.jpg,264,186,186,0,78,1.0,0.7045454545454546
2024,KHOUALKA,CITRUS VOLKAMERIANA,20207,IMG-11927.jpg,195,146,146,0,49,1.0,0.7487179487179487
2024,KHOUALKA,CITRUS VOLKAMERIANA,20207,IMG-11961.jpg,113,85,85,0,28,1.0,0.7522123893805309
2024,KHOUALKA,CITRUS VOLKAMERIANA,20207,IMG-11972.jpg,94,70,66,4,28,0.9428571428571428,0.7021276595744681
2024,KHOUALKA,CITRUS VOLKAMERIANA,20207,IMG-11981.jpg,81,54,53,1,28,0.9814814814814816,0.654320987654321
2022,SAOUDA,CITRUS VOLKAMERIANA,21020,IMG-00033-45.jpg,67,85,67,18,0,0.788235294117647,1.0
2022,SAOUDA,CITRUS VOLKAMERIANA,21020,IMG-00087-45.jpg,21,26,21,5,0,0.8076923076923077,1.0
2022,SAOUDA,CITRUS VOLKAMERIANA,21020,IMG-00138-45.jpg,40,49,40,9,0,0.8163265306122449,1.0
2022,SAOUDA,CITRUS VOLKAMERIANA,21020,IMG-00145-45.jpg,37,43,37,6,0,0.8604651162790697,1.0
2022,SAOUDA,CITRUS VOLKAMERIANA,21020,IMG-00155-45.jpg,38,52,37,15,1,0.7115384615384616,0.9736842105263158
2022,SAOUDA,CITRUS VOLKAMERIANA,21030,IMG-00521-45.jpg,31,42,31,11,0,0.7380952380952381,1.0
2022,SAOUDA,CITRUS VOLKAMERIANA,21030,IMG-00524-45.jpg,71,86,71,15,0,0.8255813953488372,1.0
2022,SAOUDA,CITRUS VOLKAMERIANA,21030,IMG-00536-45.jpg,41,61,41,20,0,0.6721311475409836,1.0
2022,SAOUDA,CITRUS VOLKAMERIANA,21030,IMG-00537-45.jpg,52,63,48,15,4,0.7619047619047619,0.9230769230769232
2022,SAOUDA,CITRUS VOLKAMERIANA,22020,IMG-00053-45.jpg,39,55,39,16,0,0.7090909090909091,1.0
2022,SAOUDA,CITRUS VOLKAMERIANA,22020,IMG-00059-45.jpg,46,53,45,8,1,0.8490566037735849,0.9782608695652174
2022,SAOUDA,CITRUS VOLKAMERIANA,22020,IMG-00060-45.jpg,48,55,47,8,1,0.8545454545454545,0.9791666666666666
2022,SAOUDA,CITRUS VOLKAMERIANA,22020,IMG-00062-45.jpg,50,70,50,20,0,0.7142857142857143,1.0
2022,SAOUDA,CITRUS VOLKAMERIANA,22030,IMG-00062-45.jpg,62,73,62,11,0,0.8493150684931506,1.0
2022,SAOUDA,CITRUS VOLKAMERIANA,22030,IMG-00063-45.jpg,83,98,82,16,1,0.8367346938775511,0.9879518072289156
2022,SAOUDA,CITRUS VOLKAMERIANA,22030,IMG-00065-45.jpg,58,66,56,10,2,0.8484848484848485,0.9655172413793104
2022,SAOUDA,CITRUS VOLKAMERIANA,22030,IMG-00068-45.jpg,66,79,65,14,1,0.8227848101265823,0.9848484848484848
2022,SAOUDA,CITRUS VOLKAMERIANA,23020,IMG-00024-45.jpg,47,58,45,13,2,0.7758620689655172,0.9574468085106383
2022,SAOUDA,CITRUS VOLKAMERIANA,23020,IMG-00032-45.jpg,33,37,33,4,0,0.8918918918918919,1.0
2022,SAOUDA,CITRUS VOLKAMERIANA,23020,IMG-00074-45.jpg,28,33,27,6,1,0.8181818181818182,0.9642857142857144
2022,SAOUDA,CITRUS VOLKAMERIANA,23020,IMG-00079-45.jpg,28,42,28,14,0,0.6666666666666666,1.0
2022,SAOUDA,CITRUS VOLKAMERIANA,23030,IMG-00014-45.jpg,25,37,24,13,1,0.6486486486486487,0.96
2022,SAOUDA,CITRUS VOLKAMERIANA,23030,IMG-00034-45.jpg,43,61,43,18,0,0.7049180327868853,1.0
2022,SAOUDA,CITRUS VOLKAMERIANA,23030,IMG-00069-45.jpg,28,51,27,24,1,0.5294117647058824,0.9642857142857144
2022,SAOUDA,CITRUS VOLKAMERIANA,23030,IMG-00079-45.jpg,50,73,50,23,0,0.684931506849315,1.0
2022,SAOUDA,CITRANGE CARRIZO,24010,IMG-00097-45.jpg,59,69,56,13,3,0.8115942028985508,0.9491525423728814
2022,SAOUDA,CITRANGE CARRIZO,24010,IMG-00101-45.jpg,27,37,27,10,0,0.7297297297297297,1.0
2022,SAOUDA,CITRANGE CARRIZO,24010,IMG-00111-45.jpg,54,61,53,8,1,0.8688524590163934,0.9814814814814816
2022,SAOUDA,CITRANGE CARRIZO,24010,IMG-00112-45.jpg,40,51,40,11,0,0.7843137254901961,1.0
2022,SAOUDA,CITRANGE CARRIZO,25010,IMG-00006-45.jpg,55,66,53,13,2,0.803030303030303,0.9636363636363636
2022,SAOUDA,CITRANGE CARRIZO,25010,IMG-00007-45.jpg,77,95,77,18,0,0.8105263157894737,1.0
2022,SAOUDA,CITRANGE CARRIZO,25010,IMG-00010-45.jpg,53,71,53,18,0,0.7464788732394366,1.0
2022,SAOUDA,CITRANGE CARRIZO,25010,IMG-00011-45.jpg,26,31,26,5,0,0.8387096774193549,1.0
2022,SAOUDA,CITRANGE CARRIZO,26010,IMG-00008-45.jpg,39,44,38,6,1,0.8636363636363636,0.9743589743589745
2022,SAOUDA,CITRANGE CARRIZO,26010,IMG-00013-45.jpg,36,47,36,11,0,0.7659574468085106,1.0
2022,SAOUDA,CITRANGE CARRIZO,26010,IMG-00018-45.jpg,43,52,43,9,0,0.8269230769230769,1.0
2022,SAOUDA,CITRANGE CARRIZO,26010,IMG-00020-45.jpg,44,48,43,5,1,0.8958333333333334,0.9772727272727272
2022,KHOUALKA,CITRANGE CARRIZO,30138,IMG-00002-40.jpg,39,45,39,6,0,0.8666666666666667,1.0
2022,KHOUALKA,CITRANGE CARRIZO,30138,IMG-00003-40.jpg,59,64,57,7,2,0.890625,0.9661016949152542
2022,KHOUALKA,CITRANGE CARRIZO,30138,IMG-00005-40.jpg,58,65,58,7,0,0.8923076923076924,1.0
2022,KHOUALKA,CITRANGE CARRIZO,30138,IMG-00008-40.jpg,32,35,32,3,0,0.9142857142857144,1.0
2022,KHOUALKA,CITRANGE CARRIZO,30138,IMG-00011-40.jpg,26,30,26,4,0,0.8666666666666667,1.0
2022,KHOUALKA,CITRANGE CARRIZO,30138,IMG-00019-40.jpg,2,3,2,1,0,0.6666666666666666,1.0
2022,KHOUALKA,CITRANGE CARRIZO,30138,IMG-00037-40.jpg,30,36,29,7,1,0.8055555555555556,0.9666666666666668
2022,KHOUALKA,CITRANGE CARRIZO,30138,IMG-00040-40.jpg,41,44,40,4,1,0.9090909090909092,0.975609756097561
2022,KHOUALKA,CITRANGE CARRIZO,30138,IMG-00043-40.jpg,28,38,27,11,1,0.7105263157894737,0.9642857142857144
2022,KHOUALKA,CITRANGE CARRIZO,30138,IMG-00044-40.jpg,99,97,93,4,6,0.9587628865979382,0.9393939393939394
2022,KHOUALKA,CITRANGE CARRIZO,30138,IMG-00048-40.jpg,37,41,34,7,3,0.8292682926829268,0.918918918918919
2022,KHOUALKA,CITRANGE CARRIZO,30138,IMG-00057-40.jpg,73,74,69,5,4,0.9324324324324323,0.9452054794520548
2022,KHOUALKA,CITRANGE CARRIZO,30138,IMG-00063-40.jpg,89,80,78,2,11,0.975,0.8764044943820225
2022,ONAGRI,CITRUS VOLKAMERIANA,30145,IMG-00018-39.jpg,219,218,207,11,12,0.9495412844036696,0.9452054794520548
2022,ONAGRI,CITRUS VOLKAMERIANA,30145,IMG-00043-39.jpg,64,66,63,3,1,0.9545454545454546,0.984375
2022,ONAGRI,CITRUS VOLKAMERIANA,30146,IMG-00008-39.jpg,262,262,249,13,13,0.950381679389313,0.950381679389313
2022,ONAGRI,CITRUS VOLKAMERIANA,30146,IMG-00045-39.jpg,190,193,178,15,12,0.922279792746114,0.936842105263158
2022,ONAGRI,CITRUS VOLKAMERIANA,30147,IMG-00002-39.jpg,269,276,250,26,19,0.9057971014492754,0.929368029739777
2022,ONAGRI,CITRUS VOLKAMERIANA,30147,IMG-00008-39.jpg,172,170,163,7,9,0.9588235294117649,0.9476744186046512
2022,ONAGRI,CITRUS VOLKAMERIANA,30148,IMG-00016-40.jpg,88,89,81,8,7,0.9101123595505618,0.9204545454545454
2022,ONAGRI,CITRUS VOLKAMERIANA,30148,IMG-00047-40.jpg,34,32,31,1,3,0.96875,0.9117647058823528
2022,ONAGRI,CITRUS VOLKAMERIANA,30149,IMG-00018-39.jpg,151,145,139,6,12,0.9586206896551724,0.9205298013245032
2022,ONAGRI,CITRUS VOLKAMERIANA,30149,IMG-00027-39.jpg,226,207,202,5,24,0.9758454106280192,0.8938053097345132
2022,ONAGRI,CITRUS VOLKAMERIANA,30151,IMG-00012-39.jpg,185,172,163,9,22,0.9476744186046512,0.8810810810810811
2022,ONAGRI,CITRUS VOLKAMERIANA,30151,IMG-00033-39.jpg,214,213,203,10,11,0.9530516431924884,0.9485981308411215
2024,ONAGRI,CITRUS VOLKAMERIANA,30151,IMG-21881.jpg,73,54,52,2,21,0.9629629629629628,0.7123287671232876
2024,ONAGRI,CITRUS VOLKAMERIANA,30151,IMG-21935.jpg,179,119,119,0,60,1.0,0.664804469273743
2024,ONAGRI,CITRUS VOLKAMERIANA,30151,IMG-21936.jpg,93,62,62,0,31,1.0,0.6666666666666666
2022,ONAGRI,CITRUS VOLKAMERIANA,30152,IMG-00016-39.jpg,39,36,34,2,5,0.9444444444444444,0.8717948717948718
2022,ONAGRI,CITRUS VOLKAMERIANA,30152,IMG-00019-39.jpg,139,128,124,4,15,0.96875,0.8920863309352518
2022,ONAGRI,CITRUS VOLKAMERIANA,30153,IMG-00001.jpg,157,149,142,7,15,0.953020134228188,0.9044585987261148
2022,ONAGRI,CITRUS VOLKAMERIANA,30153,IMG-00007-39.jpg,127,110,108,2,19,0.9818181818181818,0.8503937007874016
2022,ONAGRI,CITRUS VOLKAMERIANA,30153,IMG-00013-39.jpg,159,136,132,4,27,0.9705882352941176,0.8301886792452831
2022,ONAGRI,CITRUS VOLKAMERIANA,30153,IMG-00040-39.jpg,153,144,139,5,14,0.9652777777777778,0.9084967320261438
2022,ONAGRI,CITRUS VOLKAMERIANA,30154,IMG-00017-39.jpg,160,147,145,2,15,0.9863945578231292,0.90625
2022,ONAGRI,CITRUS VOLKAMERIANA,30154,IMG-00027-39.jpg,220,209,206,3,14,0.985645933014354,0.9363636363636364
2022,ONAGRI,CITRUS VOLKAMERIANA,30154,IMG-00033-39.jpg,51,47,47,0,4,1.0,0.9215686274509804
2022,ONAGRI,CITRUS VOLKAMERIANA,30154,IMG-00036-39.jpg,137,134,128,6,9,0.9552238805970148,0.9343065693430656
2022,ONAGRI,CITRUS VOLKAMERIANA,30154,IMG-00038-39.jpg,242,235,225,10,17,0.9574468085106383,0.9297520661157024
2022,ONAGRI,CITRUS VOLKAMERIANA,30154,IMG-00041-39.jpg,272,255,244,11,28,0.9568627450980391,0.8970588235294118
2022,ONAGRI,CITRUS VOLKAMERIANA,30154,IMG-00044-39.jpg,141,139,133,6,8,0.9568345323741008,0.9432624113475178
2022,ONAGRI,BIGARADIER,30155,IMG-00002-39.jpg,139,142,134,8,5,0.943661971830986,0.9640287769784172
2022,ONAGRI,BIGARADIER,30155,IMG-00003-39.jpg,115,109,106,3,9,0.9724770642201837,0.9217391304347826
2022,ONAGRI,BIGARADIER,30155,IMG-00006-39.jpg,44,43,40,3,4,0.9302325581395348,0.9090909090909092
2022,ONAGRI,BIGARADIER,30155,IMG-00011-39.jpg,100,92,91,1,9,0.9891304347826086,0.91
2022,ONAGRI,BIGARADIER,30155,IMG-00019-39.jpg,142,131,126,5,16,0.9618320610687024,0.8873239436619719
2022,ONAGRI,BIGARADIER,30155,IMG-00026-39.jpg,124,116,110,6,14,0.9482758620689656,0.8870967741935484
2022,ONAGRI,BIGARADIER,30155,IMG-00032-39.jpg,81,79,76,3,5,0.9620253164556962,0.9382716049382716
2022,ONAGRI,BIGARADIER,30155,IMG-00039-39.jpg,19,17,16,1,3,0.9411764705882352,0.8421052631578947
2022,ONAGRI,BIGARADIER,30155,IMG-00043-39.jpg,130,136,127,9,3,0.9338235294117648,0.9769230769230768
2022,ONAGRI,CITRUS VOLKAMERIANA,30157,IMG-00003-39.jpg,227,220,215,5,12,0.9772727272727272,0.947136563876652
2022,ONAGRI,CITRUS VOLKAMERIANA,30157,IMG-00012-39.jpg,283,281,266,15,17,0.9466192170818504,0.939929328621908
2022,ONAGRI,CITRUS VOLKAMERIANA,30157,IMG-00032-39.jpg,64,70,62,8,2,0.8857142857142857,0.96875
2022,ONAGRI,CITRUS VOLKAMERIANA,30157,IMG-00035-39.jpg,159,152,147,5,12,0.9671052631578948,0.9245283018867924
2022,KHOUALKA,CITRUS VOLKAMERIANA,30235,IMG-00001.jpg,93,102,92,10,1,0.9019607843137256,0.989247311827957
2022,KHOUALKA,CITRUS VOLKAMERIANA,30235,IMG-00003-40.jpg,37,40,37,3,0,0.925,1.0
2022,KHOUALKA,CITRUS VOLKAMERIANA,30235,IMG-00009-40.jpg,103,112,103,9,0,0.9196428571428572,1.0
2022,KHOUALKA,CITRUS VOLKAMERIANA,30235,IMG-00013-40.jpg,90,99,88,11,2,0.8888888888888888,0.9777777777777776
2022,KHOUALKA,CITRUS VOLKAMERIANA,30235,IMG-00026-40.jpg,122,126,117,9,5,0.9285714285714286,0.9590163934426228
2022,KHOUALKA,CITRUS VOLKAMERIANA,30235,IMG-00047-40.jpg,47,53,44,9,3,0.8301886792452831,0.9361702127659576
2022,KHOUALKA,CITRUS VOLKAMERIANA,30235,IMG-00048-40.jpg,90,98,88,10,2,0.8979591836734694,0.9777777777777776
2022,KHOUALKA,CITRUS VOLKAMERIANA,30235,IMG-00049-40.jpg,44,45,41,4,3,0.9111111111111112,0.9318181818181818
2022,KHOUALKA,CITRUS VOLKAMERIANA,30235,IMG-00050-40.jpg,84,88,76,12,8,0.8636363636363636,0.9047619047619048
2022,KHOUALKA,CITRUS VOLKAMERIANA,30235,IMG-00052-40.jpg,98,107,95,12,3,0.8878504672897196,0.9693877551020408
2022,KHOUALKA,CITRUS VOLKAMERIANA,30235,IMG-00057-40.jpg,80,80,76,4,4,0.95,0.95
2022,KHOUALKA,CITRUS VOLKAMERIANA,30235,IMG-00064-40.jpg,38,50,37,13,1,0.74,0.9736842105263158
2022,KHOUALKA,CITRUS VOLKAMERIANA,30235,IMG-00067-40.jpg,107,104,99,5,8,0.9519230769230768,0.9252336448598132
2022,KHOUALKA,CITRUS VOLKAMERIANA,30235,IMG-00069-40.jpg,34,43,33,10,1,0.7674418604651163,0.9705882352941176
2022,KHOUALKA,CITRUS VOLKAMERIANA,30235,IMG-00075-40.jpg,95,96,89,7,6,0.9270833333333334,0.936842105263158
2022,KHOUALKA,BIGARADIER,40141,IMG-00006-40.jpg,7,9,6,3,1,0.6666666666666666,0.8571428571428571
2022,KHOUALKA,BIGARADIER,40141,IMG-00007-40.jpg,20,15,11,4,9,0.7333333333333333,0.55
2022,KHOUALKA,BIGARADIER,40141,IMG-00008-40.jpg,15,17,13,4,2,0.7647058823529411,0.8666666666666667
2022,ONAGRI,CITRANGE C35,40166,IMG-00009-39.jpg,38,38,36,2,2,0.9473684210526316,0.9473684210526316
2022,ONAGRI,CITRANGE C35,40166,IMG-00011-39.jpg,173,172,167,5,6,0.9709302325581396,0.9653179190751444
2022,ONAGRI,CITRANGE C35,40166,IMG-00014-39.jpg,179,179,173,6,6,0.9664804469273744,0.9664804469273744
2022,ONAGRI,CITRANGE C35,40166,IMG-00015-39.jpg,122,117,115,2,7,0.9829059829059827,0.9426229508196722
2022,ONAGRI,CITRANGE C35,40166,IMG-00041-39.jpg,102,96,93,3,9,0.96875,0.9117647058823528
2022,ONAGRI,CITRANGE C35,40167,IMG-00019-39.jpg,197,195,192,3,5,0.9846153846153848,0.9746192893401016
2022,ONAGRI,CITRANGE C35,40167,IMG-00030-39.jpg,126,119,119,0,7,1.0,0.9444444444444444
2022,ONAGRI,CITRANGE C35,40167,IMG-00039-39.jpg,217,208,202,6,15,0.971153846153846,0.9308755760368664
2022,ONAGRI,CITRANGE C35,40171,IMG-00008-39.jpg,109,104,103,1,6,0.9903846153846154,0.944954128440367
2022,ONAGRI,CITRANGE C35,40171,IMG-00037-39.jpg,94,89,87,2,7,0.9775280898876404,0.925531914893617
2022,ONAGRI,CITRANGE C35,40171,IMG-00040-39.jpg,149,140,135,5,14,0.9642857142857144,0.906040268456376
2022,ONAGRI,CITRANGE C35,40172,IMG-00012-39.jpg,89,84,81,3,8,0.9642857142857144,0.9101123595505618
2022,ONAGRI,CITRANGE C35,40172,IMG-00025-39.jpg,109,99,96,3,13,0.9696969696969696,0.8807339449541285
2022,ONAGRI,CITRANGE C35,40172,IMG-00027-39.jpg,103,89,87,2,16,0.9775280898876404,0.8446601941747572
2022,ONAGRI,CITRANGE C35,40173,IMG-00004-39.jpg,133,119,116,3,17,0.9747899159663864,0.8721804511278195
2022,ONAGRI,CITRANGE C35,40173,IMG-00008-39.jpg,57,45,45,0,12,1.0,0.7894736842105263
2022,ONAGRI,CITRANGE C35,40173,IMG-00010-39.jpg,53,55,51,4,2,0.9272727272727272,0.9622641509433962
2022,ONAGRI,CITRANGE C35,40175,IMG-00005-39.jpg,95,85,81,4,14,0.9529411764705882,0.8526315789473684
2022,ONAGRI,CITRANGE C35,40175,IMG-00006-39.jpg,64,64,62,2,2,0.96875,0.96875
2022,ONAGRI,CITRANGE C35,40176,IMG-00004-39.jpg,79,78,72,6,7,0.9230769230769232,0.9113924050632912
2022,ONAGRI,CITRANGE C35,40176,IMG-00012-39.jpg,105,108,102,6,3,0.9444444444444444,0.9714285714285714
2022,ONAGRI,CITRANGE C35,40176,IMG-00014-39.jpg,91,95,85,10,6,0.8947368421052632,0.934065934065934
2022,ONAGRI,CITRUMELO SACCATON,40177,IMG-00012-39.jpg,89,95,85,10,4,0.8947368421052632,0.9550561797752808
2022,ONAGRI,CITRUMELO SACCATON,40177,IMG-00015-39.jpg,213,226,211,15,2,0.9336283185840708,0.9906103286384976
2022,ONAGRI,CITRUMELO SACCATON,40177,IMG-00037-39.jpg,95,99,91,8,4,0.9191919191919192,0.9578947368421052
2022,ONAGRI,CITRANGE C35,40178,IMG-00013-39.jpg,76,77,75,2,1,0.974025974025974,0.986842105263158
2022,ONAGRI,CITRANGE C35,40178,IMG-00027-39.jpg,56,59,55,4,1,0.9322033898305084,0.9821428571428572
2022,ONAGRI,CITRANGE C35,40178,IMG-00031-39.jpg,30,34,30,4,0,0.8823529411764706,1.0
2022,ONAGRI,CITRANGE C35,40178,IMG-00032-39.jpg,27,29,26,3,1,0.896551724137931,0.9629629629629628
2022,ONAGRI,CITRANGE C35,40178,IMG-00033-39.jpg,34,33,33,0,1,1.0,0.9705882352941176
2022,ONAGRI,CITRANGE C35,40179,IMG-00001.jpg,83,91,82,9,1,0.9010989010989012,0.9879518072289156
2022,ONAGRI,CITRANGE C35,40179,IMG-00010-39.jpg,161,162,151,11,10,0.9320987654320988,0.937888198757764
2022,ONAGRI,CITRANGE C35,40179,IMG-00011-39.jpg,102,104,97,7,5,0.9326923076923076,0.9509803921568628
2022,ONAGRI,CITRANGE C35,40179,IMG-00018-39.jpg,9,11,9,2,0,0.8181818181818182,1.0
2022,ONAGRI,CITRUMELO SACCATON,40182,IMG-00004-39.jpg,35,37,35,2,0,0.945945945945946,1.0
2022,ONAGRI,CITRUMELO SACCATON,40182,IMG-00010-39.jpg,52,54,49,5,3,0.9074074074074074,0.9423076923076924
2022,ONAGRI,CITRUMELO SACCATON,40182,IMG-00015-39.jpg,85,83,78,5,7,0.9397590361445785,0.9176470588235294
2022,ONAGRI,CITRUMELO SACCATON,40183,IMG-00005-39.jpg,68,68,65,3,3,0.9558823529411764,0.9558823529411764
2022,ONAGRI,CITRUMELO SACCATON,40183,IMG-00009-39.jpg,57,60,56,4,1,0.9333333333333332,0.9824561403508772
2022,ONAGRI,CITRUMELO SACCATON,40183,IMG-00010-39.jpg,48,51,46,5,2,0.9019607843137256,0.9583333333333334
2024,KHOUALKA,CITRUS VOLKAMERIANA,50152,IMG-17274.jpg,170,129,129,0,41,1.0,0.7588235294117647
2024,KHOUALKA,CITRUS VOLKAMERIANA,50152,IMG-17306.jpg,105,87,87,0,18,1.0,0.8285714285714286
2024,KHOUALKA,CITRUS VOLKAMERIANA,50152,IMG-17330.jpg,41,31,29,2,12,0.935483870967742,0.7073170731707317
2024,KHOUALKA,CITRUS VOLKAMERIANA,50152,IMG-17335.jpg,44,33,33,0,11,1.0,0.75
2024,KHOUALKA,CITRUS VOLKAMERIANA,50152,IMG-17340.jpg,108,76,75,1,33,0.986842105263158,0.6944444444444444
2024,KHOUALKA,CITRUS VOLKAMERIANA,50152,IMG-17356.jpg,60,44,44,0,16,1.0,0.7333333333333333
2024,KHOUALKA,CITRUS VOLKAMERIANA,50152,IMG-17384.jpg,53,37,36,1,17,0.972972972972973,0.6792452830188679
2024,KHOUALKA,CITRUS VOLKAMERIANA,50154,IMG-17440.jpg,76,68,67,1,9,0.9852941176470588,0.881578947368421
2024,KHOUALKA,CITRUS VOLKAMERIANA,50154,IMG-17490.jpg,107,77,76,1,31,0.987012987012987,0.7102803738317757
2024,KHOUALKA,CITRUS VOLKAMERIANA,50154,IMG-17543.jpg,100,69,68,1,32,0.9855072463768116,0.68
2024,KHOUALKA,CITRUS VOLKAMERIANA,50154,IMG-17545.jpg,94,65,64,1,30,0.9846153846153848,0.6808510638297872
2024,KHOUALKA,CITRUS VOLKAMERIANA,50154,IMG-17562.jpg,129,108,107,1,22,0.9907407407407408,0.8294573643410853
2024,KHOUALKA,CITRUS VOLKAMERIANA,50154,IMG-17576.jpg,121,102,102,0,19,1.0,0.8429752066115702
2024,KHOUALKA,CITRUS VOLKAMERIANA,50154,IMG-17585.jpg,171,128,126,2,45,0.984375,0.7368421052631579
2024,KHOUALKA,CITRUS VOLKAMERIANA,50168,IMG-13980.jpg,174,128,128,0,46,1.0,0.735632183908046
2024,KHOUALKA,CITRUS VOLKAMERIANA,50168,IMG-15749.jpg,147,109,108,1,39,0.9908256880733946,0.7346938775510204
2024,KHOUALKA,CITRUS VOLKAMERIANA,50168,IMG-15758.jpg,163,121,119,2,44,0.9834710743801652,0.7300613496932515
2024,KHOUALKA,CITRUS VOLKAMERIANA,50168,IMG-15981.jpg,210,169,166,3,44,0.9822485207100592,0.7904761904761904
2024,KHOUALKA,CITRUS VOLKAMERIANA,50168,IMG-15983.jpg,120,87,87,0,33,1.0,0.725
2024,KHOUALKA,CITRUS VOLKAMERIANA,50176,IMG-16025.jpg,81,64,64,0,17,1.0,0.7901234567901234
2024,KHOUALKA,CITRUS VOLKAMERIANA,50176,IMG-16051.jpg,85,63,63,0,22,1.0,0.7411764705882353
2024,KHOUALKA,CITRUS VOLKAMERIANA,50176,IMG-16079.jpg,161,125,122,3,39,0.976,0.7577639751552795
2024,KHOUALKA,CITRUS VOLKAMERIANA,50176,IMG-16095.jpg,101,70,69,1,32,0.9857142857142858,0.6831683168316832
2024,KHOUALKA,CITRUS VOLKAMERIANA,50176,IMG-16105.jpg,43,31,31,0,12,1.0,0.7209302325581395
2022,ONAGRI,CITRUMELO SACCATON,50193,IMG-00007-39.jpg,218,228,212,16,6,0.9298245614035088,0.9724770642201837
2022,ONAGRI,CITRUMELO SACCATON,50193,IMG-00016-39.jpg,64,74,62,12,2,0.8378378378378378,0.96875
2022,ONAGRI,CITRUMELO SACCATON,50193,IMG-00018-39.jpg,115,123,113,10,2,0.91869918699187,0.982608695652174
2022,ONAGRI,CITRUMELO SACCATON,50193,IMG-00021-39.jpg,62,61,58,3,4,0.9508196721311476,0.935483870967742
2022,ONAGRI,CITRUMELO SACCATON,50193,IMG-00023-39.jpg,113,122,111,11,2,0.9098360655737704,0.9823008849557522
2022,ONAGRI,CITRUMELO SACCATON,50194,IMG-00032-39.jpg,162,163,153,10,9,0.9386503067484664,0.9444444444444444
2022,ONAGRI,CITRUMELO SACCATON,50194,IMG-00034-39.jpg,105,107,103,4,2,0.9626168224299064,0.9809523809523808
2022,ONAGRI,CITRUMELO SACCATON,50194,IMG-00036-39.jpg,161,171,151,20,10,0.8830409356725146,0.937888198757764
2022,ONAGRI,CITRUMELO SACCATON,50194,IMG-00038-39.jpg,100,108,96,12,4,0.8888888888888888,0.96
2022,ONAGRI,CITRUMELO SACCATON,50194,IMG-00039-39.jpg,65,64,63,1,2,0.984375,0.9692307692307692
2022,ONAGRI,CITRUMELO SACCATON,50194,IMG-00041-39.jpg,153,153,147,6,6,0.9607843137254902,0.9607843137254902
2022,ONAGRI,CITRUMELO SACCATON,50194,IMG-00051-39.jpg,137,136,132,4,5,0.9705882352941176,0.9635036496350364
2022,ONAGRI,CITRUMELO SACCATON,50194,IMG-00054-39.jpg,111,110,103,7,8,0.9363636363636364,0.927927927927928
2022,ONAGRI,CITRUMELO SACCATON,51091,IMG-00015-39.jpg,85,93,82,11,3,0.8817204301075269,0.9647058823529412
2022,ONAGRI,CITRUMELO SACCATON,51091,IMG-00016-39.jpg,170,175,167,8,3,0.9542857142857144,0.9823529411764704
2022,ONAGRI,CITRUMELO SACCATON,51091,IMG-00018-39.jpg,185,205,183,22,2,0.8926829268292683,0.9891891891891892
2022,ONAGRI,CITRUMELO SACCATON,51091,IMG-00022-39.jpg,135,146,129,17,6,0.8835616438356164,0.9555555555555556
2022,ONAGRI,CITRUMELO SACCATON,51091,IMG-00023-39.jpg,140,137,130,7,10,0.948905109489051,0.9285714285714286
2022,ONAGRI,CITRUMELO SACCATON,51091,IMG-00026-39.jpg,149,151,141,10,8,0.933774834437086,0.9463087248322148
2022,ONAGRI,CITRUMELO SACCATON,51091,IMG-00044-39.jpg,168,181,168,13,0,0.9281767955801103,1.0
2022,ONAGRI,CITRUMELO SACCATON,51095,IMG-00004-39.jpg,201,209,195,14,6,0.9330143540669856,0.9701492537313432
2022,ONAGRI,CITRUMELO SACCATON,51095,IMG-00013-39.jpg,154,154,146,8,8,0.948051948051948,0.948051948051948
2022,ONAGRI,CITRUMELO SACCATON,51095,IMG-00014-39.jpg,140,145,135,10,5,0.9310344827586208,0.9642857142857144
2022,ONAGRI,CITRUMELO SACCATON,51095,IMG-00015-39.jpg,196,197,192,5,4,0.9746192893401016,0.979591836734694
2022,ONAGRI,CITRUMELO SACCATON,51095,IMG-00024-39.jpg,234,236,225,11,9,0.9533898305084746,0.9615384615384616
2022,ONAGRI,CITRUMELO SACCATON,51095,IMG-00025-39.jpg,198,203,193,10,5,0.9507389162561576,0.9747474747474748
2022,ONAGRI,CITRUMELO SACCATON,51096,IMG-00009-39.jpg,219,225,208,17,11,0.9244444444444444,0.9497716894977168
2022,ONAGRI,CITRUMELO SACCATON,51096,IMG-00011-39.jpg,145,150,137,13,8,0.9133333333333332,0.9448275862068966
2022,ONAGRI,CITRUMELO SACCATON,51096,IMG-00012-39.jpg,114,114,107,7,7,0.9385964912280702,0.9385964912280702
2022,ONAGRI,CITRUMELO SACCATON,51096,IMG-00055-39.jpg,217,205,198,7,19,0.9658536585365852,0.912442396313364
2022,ONAGRI,MC PONSIRUCE TRIFOLIATA,51097,IMG-00025-39.jpg,121,127,113,14,8,0.889763779527559,0.9338842975206612
2022,ONAGRI,MC PONSIRUCE TRIFOLIATA,51097,IMG-00029-39.jpg,106,114,101,13,5,0.8859649122807017,0.9528301886792452
2022,ONAGRI,MC PONSIRUCE TRIFOLIATA,51097,IMG-00044-39.jpg,182,187,176,11,6,0.9411764705882352,0.967032967032967
2022,ONAGRI,MC PONSIRUCE TRIFOLIATA,51098,IMG-00003-39.jpg,65,70,62,8,3,0.8857142857142857,0.953846153846154
2022,ONAGRI,MC PONSIRUCE TRIFOLIATA,51098,IMG-00010-39.jpg,184,183,174,9,10,0.9508196721311476,0.9456521739130436
2022,ONAGRI,MC PONSIRUCE TRIFOLIATA,51098,IMG-00015-39.jpg,162,167,161,6,1,0.9640718562874252,0.9938271604938272
2022,ONAGRI,MC PONSIRUCE TRIFOLIATA,51099,IMG-00012-39.jpg,133,142,127,15,6,0.8943661971830986,0.9548872180451128
2024,ONAGRI,MC PONSIRUCE TRIFOLIATA,51101,IMG-12118.jpg,177,134,134,0,43,1.0,0.7570621468926554
2024,ONAGRI,MC PONSIRUCE TRIFOLIATA,51101,IMG-14223.jpg,153,122,122,0,31,1.0,0.7973856209150327
2024,ONAGRI,MC PONSIRUCE TRIFOLIATA,51101,IMG-14226.jpg,151,127,125,2,26,0.984251968503937,0.8278145695364238
2024,ONAGRI,MC PONSIRUCE TRIFOLIATA,51101,IMG-14255.jpg,189,158,156,2,33,0.9873417721518988,0.8253968253968254
2024,ONAGRI,MC PONSIRUCE TRIFOLIATA,51101,IMG-14281.jpg,150,121,120,1,30,0.9917355371900828,0.8
2022,ONAGRI,CITRUS VOLKAMERIANA,101020,IMG-00001.jpg,6,7,6,1,0,0.8571428571428571,1.0
2022,ONAGRI,CITRUS VOLKAMERIANA,101020,IMG-00004-44.jpg,53,52,50,2,3,0.9615384615384616,0.9433962264150944
2022,ONAGRI,CITRUS VOLKAMERIANA,101030,IMG-00003-44.jpg,29,29,28,1,1,0.9655172413793104,0.9655172413793104
2022,ONAGRI,CITRUS VOLKAMERIANA,101030,IMG-00004-44.jpg,110,108,108,0,2,1.0,0.9818181818181818
2022,ONAGRI,CITRUS VOLKAMERIANA,101030,IMG-00005-44.jpg,134,131,124,7,10,0.9465648854961832,0.9253731343283582
2022,ONAGRI,CITRUS VOLKAMERIANA,101030,IMG-00017-44.jpg,79,79,74,5,5,0.9367088607594936,0.9367088607594936
2022,ONAGRI,CITRUS VOLKAMERIANA,101040,IMG-00005-44.jpg,172,173,168,5,4,0.9710982658959536,0.9767441860465116
2022,ONAGRI,CITRUS VOLKAMERIANA,101040,IMG-00009-44.jpg,131,143,129,14,2,0.902097902097902,0.9847328244274808
2022,ONAGRI,CITRUS VOLKAMERIANA,101040,IMG-00011-44.jpg,64,65,61,4,3,0.9384615384615383,0.953125
2022,ONAGRI,CITRUS VOLKAMERIANA,101040,IMG-00012-44.jpg,139,140,131,9,8,0.9357142857142856,0.9424460431654677
2022,ONAGRI,CITRUS VOLKAMERIANA,101050,IMG-00002-44.jpg,95,94,89,5,6,0.946808510638298,0.936842105263158
2022,ONAGRI,CITRUS VOLKAMERIANA,101050,IMG-00005-44.jpg,59,54,54,0,5,1.0,0.9152542372881356
2022,ONAGRI,CITRUS VOLKAMERIANA,101050,IMG-00011-44.jpg,46,45,43,2,3,0.9555555555555556,0.9347826086956522
2022,ONAGRI,CITRUS VOLKAMERIANA,101050,IMG-00024-44.jpg,40,41,38,3,2,0.926829268292683,0.95
2022,ONAGRI,CITRUS VOLKAMERIANA,101080,IMG-00005-44.jpg,42,41,39,2,3,0.951219512195122,0.9285714285714286
2022,ONAGRI,CITRUS VOLKAMERIANA,101080,IMG-00006-44.jpg,79,74,72,2,7,0.972972972972973,0.9113924050632912
2022,ONAGRI,CITRUS VOLKAMERIANA,101080,IMG-00023-44.jpg,7,8,7,1,0,0.875,1.0
2022,ONAGRI,CITRUS VOLKAMERIANA,101080,IMG-00024-44.jpg,27,26,25,1,2,0.9615384615384616,0.925925925925926
2022,ONAGRI,CITRUS VOLKAMERIANA,101090,IMG-00003-44.jpg,66,65,63,2,3,0.9692307692307692,0.9545454545454546
2022,ONAGRI,CITRUS VOLKAMERIANA,101090,IMG-00006-44.jpg,41,37,36,1,5,0.972972972972973,0.8780487804878049
2022,ONAGRI,CITRUS VOLKAMERIANA,101090,IMG-00019-44.jpg,35,35,34,1,1,0.9714285714285714,0.9714285714285714
2022,ONAGRI,CITRUS VOLKAMERIANA,101090,IMG-00020-44.jpg,42,43,41,2,1,0.9534883720930232,0.9761904761904762
2022,KHOUALKA,CITRANGE CARRIZO,102130,IMG-00001.jpg,5,4,3,1,2,0.75,0.6
2022,KHOUALKA,CITRANGE CARRIZO,102130,IMG-00004-43.jpg,24,17,17,0,7,1.0,0.7083333333333334
2022,KHOUALKA,CITRANGE CARRIZO,102130,IMG-00019-43.jpg,33,25,23,2,10,0.92,0.696969696969697
2022,KHOUALKA,CITRANGE CARRIZO,102130,IMG-00020-43.jpg,18,20,14,6,4,0.7,0.7777777777777778
2022,KHOUALKA,MACROPHYLLA,201180,IMG-00007-43.jpg,38,36,33,3,5,0.9166666666666666,0.868421052631579
2022,KHOUALKA,MACROPHYLLA,201180,IMG-00011-43.jpg,64,42,42,0,22,1.0,0.65625
2022,KHOUALKA,MACROPHYLLA,201180,IMG-00019-43.jpg,64,44,44,0,20,1.0,0.6875
2022,KHOUALKA,MACROPHYLLA,201180,IMG-00020-43.jpg,43,35,33,2,10,0.9428571428571428,0.7674418604651163
2022,KHOUALKA,MACROPHYLLA,201190,IMG-00004-43.jpg,101,76,74,2,27,0.9736842105263158,0.7326732673267327
2022,KHOUALKA,MACROPHYLLA,201190,IMG-00010-43.jpg,90,54,54,0,36,1.0,0.6
2022,KHOUALKA,MACROPHYLLA,201190,IMG-00011-43.jpg,134,89,83,6,51,0.9325842696629212,0.6194029850746269
2022,KHOUALKA,MACROPHYLLA,201190,IMG-00020-43.jpg,95,56,56,0,39,1.0,0.5894736842105263
2022,KHOUALKA,CITRUS VOLKAMERIANA,201210,IMG-00011-43.jpg,103,75,74,1,29,0.9866666666666668,0.7184466019417476
2022,KHOUALKA,CITRUS VOLKAMERIANA,201210,IMG-00012-43.jpg,42,29,29,0,13,1.0,0.6904761904761905
2022,KHOUALKA,CITRUS VOLKAMERIANA,201210,IMG-00015-43.jpg,77,43,43,0,34,1.0,0.5584415584415584
2022,KHOUALKA,CITRUS VOLKAMERIANA,201210,IMG-00019-43.jpg,31,25,24,1,7,0.96,0.7741935483870968
2022,KHOUALKA,BIGARADIER,201320,IMG-00006-43.jpg,87,70,67,3,20,0.9571428571428572,0.7701149425287356
2022,KHOUALKA,BIGARADIER,201320,IMG-00016-43.jpg,97,84,80,4,17,0.9523809523809524,0.8247422680412371
2022,KHOUALKA,BIGARADIER,201320,IMG-00017-43.jpg,49,43,40,3,9,0.9302325581395348,0.8163265306122449
2022,KHOUALKA,BIGARADIER,201320,IMG-00020-43.jpg,88,79,78,1,10,0.9873417721518988,0.8863636363636364
2022,ONAGRI,BIGARADIER,201390,IMG-00008-44.jpg,62,41,40,1,22,0.975609756097561,0.6451612903225806
2022,ONAGRI,BIGARADIER,201390,IMG-00011-44.jpg,90,62,58,4,32,0.935483870967742,0.6444444444444445
2022,ONAGRI,BIGARADIER,201390,IMG-00013-44.jpg,77,31,31,0,46,1.0,0.4025974025974026
2022,ONAGRI,BIGARADIER,201390,IMG-00016-44.jpg,69,34,34,0,35,1.0,0.4927536231884058
2022,KHOUALKA,CITRUS VOLKAMERIANA,202050,IMG-00006-43.jpg,89,57,56,1,33,0.9824561403508772,0.6292134831460674
2022,KHOUALKA,CITRUS VOLKAMERIANA,202050,IMG-00010-43.jpg,94,67,67,0,27,1.0,0.7127659574468085
2022,KHOUALKA,CITRUS VOLKAMERIANA,202050,IMG-00011-43.jpg,151,101,98,3,53,0.9702970297029704,0.6490066225165563
2022,KHOUALKA,CITRUS VOLKAMERIANA,202050,IMG-00020-43.jpg,129,77,77,0,52,1.0,0.5968992248062015
2022,KHOUALKA,CITRUS VOLKAMERIANA,202070,IMG-00006-43.jpg,68,44,41,3,27,0.9318181818181818,0.6029411764705882
2022,KHOUALKA,CITRUS VOLKAMERIANA,202070,IMG-00009-43.jpg,120,77,77,0,43,1.0,0.6416666666666667
2022,KHOUALKA,CITRUS VOLKAMERIANA,202070,IMG-00013-43.jpg,95,51,51,0,44,1.0,0.5368421052631579
2022,KHOUALKA,CITRUS VOLKAMERIANA,202070,IMG-00019-43.jpg,57,41,41,0,16,1.0,0.7192982456140351
2022,KHOUALKA,CITRUS VOLKAMERIANA,202080,IMG-00005-43.jpg,65,50,49,1,16,0.98,0.7538461538461538
2022,KHOUALKA,CITRUS VOLKAMERIANA,202080,IMG-00008-43.jpg,31,23,23,0,8,1.0,0.7419354838709677
2022,KHOUALKA,CITRUS VOLKAMERIANA,202080,IMG-00015-43.jpg,220,138,137,1,83,0.9927536231884058,0.6227272727272727
2022,KHOUALKA,CITRUS VOLKAMERIANA,202080,IMG-00016-43.jpg,131,88,87,1,44,0.9886363636363636,0.6641221374045801
2022,KHOUALKA,CITRANGE CARRIZO,301380,IMG-00007-43.jpg,30,20,18,2,12,0.9,0.6
2022,KHOUALKA,CITRANGE CARRIZO,301380,IMG-00011-43.jpg,53,46,46,0,7,1.0,0.8679245283018868
2022,KHOUALKA,CITRANGE CARRIZO,301380,IMG-00014-43.jpg,7,5,5,0,2,1.0,0.7142857142857143
2022,KHOUALKA,CITRANGE CARRIZO,301380,IMG-00020-43.jpg,91,65,65,0,26,1.0,0.7142857142857143
2022,ONAGRI,CITRUS VOLKAMERIANA,301470,IMG-00003-44.jpg,148,107,106,1,42,0.9906542056074766,0.7162162162162162
2022,ONAGRI,CITRUS VOLKAMERIANA,301470,IMG-00004-44.jpg,163,88,88,0,75,1.0,0.5398773006134969
2022,ONAGRI,CITRUS VOLKAMERIANA,301470,IMG-00005-44.jpg,160,83,80,3,80,0.963855421686747,0.5
2022,ONAGRI,CITRUS VOLKAMERIANA,301480,IMG-00001.jpg,92,48,45,3,47,0.9375,0.4891304347826087
2022,ONAGRI,CITRUS VOLKAMERIANA,301480,IMG-00003-43.jpg,26,12,12,0,14,1.0,0.4615384615384616
2022,ONAGRI,CITRUS VOLKAMERIANA,301480,IMG-00012-43.jpg,50,30,29,1,21,0.9666666666666668,0.58
2022,ONAGRI,CITRUS VOLKAMERIANA,301480,IMG-00014-43.jpg,77,45,45,0,32,1.0,0.5844155844155844
2022,ONAGRI,CITRUS VOLKAMERIANA,301490,IMG-00005-44.jpg,108,55,55,0,53,1.0,0.5092592592592593
2022,ONAGRI,CITRUS VOLKAMERIANA,301490,IMG-00009-44.jpg,185,97,93,4,92,0.9587628865979382,0.5027027027027027
2022,ONAGRI,CITRUS VOLKAMERIANA,301490,IMG-00012-44.jpg,162,93,93,0,69,1.0,0.5740740740740741
2022,ONAGRI,CITRUS VOLKAMERIANA,301490,IMG-00015-44.jpg,109,56,54,2,55,0.9642857142857144,0.4954128440366973
2022,ONAGRI,CITRUS VOLKAMERIANA,301510,IMG-00001.jpg,252,125,123,2,129,0.984,0.4880952380952381
2022,ONAGRI,CITRUS VOLKAMERIANA,301510,IMG-00006-44.jpg,137,87,83,4,54,0.9540229885057472,0.6058394160583942
2022,ONAGRI,CITRUS VOLKAMERIANA,301510,IMG-00007-44.jpg,115,74,71,3,44,0.9594594594594594,0.6173913043478261
2022,ONAGRI,CITRUS VOLKAMERIANA,301510,IMG-00008-44.jpg,150,89,87,2,63,0.9775280898876404,0.58
2022,ONAGRI,BIGARADIER,301550,IMG-00008-44.jpg,144,88,88,0,56,1.0,0.6111111111111112
2022,ONAGRI,BIGARADIER,301550,IMG-00011-44.jpg,40,22,22,0,18,1.0,0.55
2022,ONAGRI,BIGARADIER,301550,IMG-00013-44.jpg,76,39,39,0,37,1.0,0.5131578947368421
2022,ONAGRI,BIGARADIER,301550,IMG-00014-44.jpg,80,50,48,2,32,0.96,0.6
2022,ONAGRI,CITRUS VOLKAMERIANA,301570,IMG-00004-44.jpg,158,106,105,1,53,0.9905660377358492,0.6645569620253164
2022,ONAGRI,CITRUS VOLKAMERIANA,301570,IMG-00007-44.jpg,152,98,97,1,55,0.9897959183673468,0.6381578947368421
2022,ONAGRI,CITRUS VOLKAMERIANA,301570,IMG-00008-44.jpg,103,54,53,1,50,0.9814814814814816,0.5145631067961165
2022,ONAGRI,CITRUS VOLKAMERIANA,301570,IMG-00017-44.jpg,218,135,132,3,86,0.9777777777777776,0.6055045871559633
2022,KHOUALKA,CITRUS VOLKAMERIANA,302340,IMG-00004-43.jpg,106,60,60,0,46,1.0,0.5660377358490566
2022,KHOUALKA,CITRUS VOLKAMERIANA,302340,IMG-00005-43.jpg,105,62,61,1,44,0.9838709677419356,0.580952380952381
2022,KHOUALKA,CITRUS VOLKAMERIANA,302340,IMG-00011-43.jpg,75,42,41,1,34,0.9761904761904762,0.5466666666666666
2022,KHOUALKA,CITRUS VOLKAMERIANA,302340,IMG-00015-43.jpg,92,42,41,1,51,0.9761904761904762,0.4456521739130435
2022,KHOUALKA,CITRUS VOLKAMERIANA,302350,IMG-00008-43.jpg,33,25,23,2,10,0.92,0.696969696969697
2022,KHOUALKA,CITRUS VOLKAMERIANA,302350,IMG-00013-43.jpg,80,51,50,1,30,0.9803921568627452,0.625
2022,KHOUALKA,CITRUS VOLKAMERIANA,302350,IMG-00014-43.jpg,76,41,41,0,35,1.0,0.5394736842105263
2022,KHOUALKA,CITRUS VOLKAMERIANA,302350,IMG-00018-43.jpg,44,32,32,0,12,1.0,0.7272727272727273
2022,KHOUALKA,CITRUS VOLKAMERIANA,302360,IMG-00005-43.jpg,97,51,51,0,46,1.0,0.5257731958762887
2022,KHOUALKA,CITRUS VOLKAMERIANA,302360,IMG-00006-43.jpg,118,62,61,1,57,0.9838709677419356,0.5169491525423728
2022,KHOUALKA,CITRUS VOLKAMERIANA,302360,IMG-00016-43.jpg,67,36,36,0,31,1.0,0.5373134328358209
2022,KHOUALKA,CITRUS VOLKAMERIANA,302360,IMG-00021-43.jpg,65,41,40,1,25,0.975609756097561,0.6153846153846154
2022,KHOUALKA,CITRUS VOLKAMERIANA,302510,IMG-00001.jpg,73,39,39,0,34,1.0,0.5342465753424658
2022,KHOUALKA,CITRUS VOLKAMERIANA,302510,IMG-00002-43.jpg,44,35,32,3,12,0.9142857142857144,0.7272727272727273
2022,KHOUALKA,CITRUS VOLKAMERIANA,302510,IMG-00003-43.jpg,78,61,60,1,18,0.9836065573770492,0.7692307692307693
2022,KHOUALKA,CITRUS VOLKAMERIANA,302510,IMG-00015-43.jpg,49,29,29,0,20,1.0,0.5918367346938775
2022,KHOUALKA,BIGARADIER,401410,IMG-00093-43.jpg,35,18,18,0,17,1.0,0.5142857142857142
2022,KHOUALKA,BIGARADIER,401410,IMG-00099-43.jpg,6,4,3,1,3,0.75,0.5
2022,KHOUALKA,BIGARADIER,401410,IMG-00102-43.jpg,78,40,38,2,40,0.95,0.4871794871794872
2022,KHOUALKA,BIGARADIER,401410,IMG-00104-43.jpg,81,47,46,1,35,0.9787234042553192,0.5679012345679012
2022,ONAGRI,CITRANGE C35,401660,IMG-00001.jpg,56,48,46,2,10,0.9583333333333334,0.8214285714285714
2022,ONAGRI,CITRANGE C35,401660,IMG-00008-44.jpg,42,34,34,0,8,1.0,0.8095238095238095
2022,ONAGRI,CITRANGE C35,401660,IMG-00010-44.jpg,29,25,22,3,7,0.88,0.7586206896551724
2022,ONAGRI,CITRANGE C35,401660,IMG-00016-44.jpg,64,45,43,2,21,0.9555555555555556,0.671875
2022,ONAGRI,CITRANGE C35,401710,IMG-00003-44.jpg,51,39,38,1,13,0.9743589743589745,0.7450980392156863
2022,ONAGRI,CITRANGE C35,401710,IMG-00012-44.jpg,19,17,17,0,2,1.0,0.8947368421052632
2022,ONAGRI,CITRANGE C35,401710,IMG-00013-44.jpg,33,30,27,3,6,0.9,0.8181818181818182
2022,ONAGRI,CITRANGE C35,401710,IMG-00019-44.jpg,76,67,67,0,9,1.0,0.881578947368421
2022,ONAGRI,CITRANGE C35,401720,IMG-00007-44.jpg,93,80,78,2,15,0.975,0.8387096774193549
2022,ONAGRI,CITRANGE C35,401720,IMG-00008-44.jpg,38,28,28,0,10,1.0,0.7368421052631579
2022,ONAGRI,CITRANGE C35,401720,IMG-00010-44.jpg,50,30,30,0,20,1.0,0.6
2022,ONAGRI,CITRANGE C35,401720,IMG-00017-44.jpg,68,49,49,0,19,1.0,0.7205882352941176
2022,ONAGRI,CITRANGE C35,401730,IMG-00001.jpg,19,19,18,1,1,0.9473684210526316,0.9473684210526316
2022,ONAGRI,CITRANGE C35,401730,IMG-00010-44.jpg,50,41,41,0,9,1.0,0.82
2022,ONAGRI,CITRANGE C35,401730,IMG-00013-44.jpg,75,63,63,0,12,1.0,0.84
2022,ONAGRI,CITRANGE C35,401730,IMG-00016-44.jpg,36,33,31,2,5,0.9393939393939394,0.8611111111111112
2022,ONAGRI,CITRANGE C35,401750,IMG-00005-44.jpg,88,39,39,0,49,1.0,0.4431818181818182
2022,ONAGRI,CITRANGE C35,401750,IMG-00009-44.jpg,127,79,78,1,49,0.9873417721518988,0.6141732283464567
2022,ONAGRI,CITRANGE C35,401750,IMG-00016-44.jpg,107,69,69,0,38,1.0,0.6448598130841121
2022,ONAGRI,CITRANGE C35,401750,IMG-00024-44.jpg,50,30,30,0,20,1.0,0.6
2022,ONAGRI,CITRUMELO SACCATON,401770,IMG-00003-44.jpg,24,20,20,0,4,1.0,0.8333333333333334
2022,ONAGRI,CITRUMELO SACCATON,401770,IMG-00008-44.jpg,72,58,56,2,16,0.9655172413793104,0.7777777777777778
2022,ONAGRI,CITRUMELO SACCATON,401770,IMG-00009-44.jpg,14,12,11,1,3,0.9166666666666666,0.7857142857142857
2022,ONAGRI,CITRUMELO SACCATON,401770,IMG-00017-44.jpg,20,14,13,1,7,0.9285714285714286,0.65
2022,KHOUALKA,BIGARADIER,402440,IMG-00005-43.jpg,17,9,8,1,9,0.8888888888888888,0.4705882352941176
2022,KHOUALKA,BIGARADIER,402440,IMG-00012-43.jpg,46,32,28,4,18,0.875,0.6086956521739131
2022,KHOUALKA,BIGARADIER,402440,IMG-00014-43.jpg,11,5,5,0,6,1.0,0.4545454545454545
2022,KHOUALKA,BIGARADIER,402440,IMG-00015-43.jpg,22,9,9,0,13,1.0,0.4090909090909091
2022,KHOUALKA,BIGARADIER,402590,IMG-00007-43.jpg,104,58,57,1,47,0.9827586206896552,0.5480769230769231
2022,KHOUALKA,BIGARADIER,402590,IMG-00012-43.jpg,45,33,32,1,13,0.9696969696969696,0.7111111111111111
2022,KHOUALKA,BIGARADIER,402590,IMG-00015-43.jpg,58,48,48,0,10,1.0,0.8275862068965517
2022,KHOUALKA,BIGARADIER,402590,IMG-00019-43.jpg,64,58,56,2,8,0.9655172413793104,0.875
2022,KHOUALKA,CITRUS VOLKAMERIANA,501520,IMG-00004-43.jpg,39,24,23,1,16,0.9583333333333334,0.5897435897435898
2022,KHOUALKA,CITRUS VOLKAMERIANA,501520,IMG-00007-43.jpg,43,31,29,2,14,0.935483870967742,0.6744186046511628
2022,KHOUALKA,CITRUS VOLKAMERIANA,501520,IMG-00015-43.jpg,18,9,9,0,9,1.0,0.5
2022,KHOUALKA,CITRUS VOLKAMERIANA,501520,IMG-00020-43.jpg,48,36,36,0,12,1.0,0.75
2022,KHOUALKA,CITRUS VOLKAMERIANA,501540,IMG-00006-43.jpg,38,28,27,1,11,0.9642857142857144,0.7105263157894737
2022,KHOUALKA,CITRUS VOLKAMERIANA,501540,IMG-00012-43.jpg,102,84,83,1,19,0.988095238095238,0.8137254901960784
2022,KHOUALKA,CITRUS VOLKAMERIANA,501540,IMG-00017-43.jpg,138,81,80,1,58,0.9876543209876544,0.5797101449275363
2022,KHOUALKA,CITRUS VOLKAMERIANA,501540,IMG-00018-43.jpg,51,36,35,1,16,0.9722222222222222,0.6862745098039216
2022,KHOUALKA,CITRUS VOLKAMERIANA,501660,IMG-00006-43.jpg,60,45,42,3,18,0.9333333333333332,0.7
2022,KHOUALKA,CITRUS VOLKAMERIANA,501660,IMG-00016-43.jpg,63,48,44,4,19,0.9166666666666666,0.6984126984126984
2022,KHOUALKA,CITRUS VOLKAMERIANA,501660,IMG-00018-43.jpg,112,72,71,1,41,0.9861111111111112,0.6339285714285714
2022,KHOUALKA,CITRUS VOLKAMERIANA,501660,IMG-00021-43.jpg,90,76,74,2,16,0.9736842105263158,0.8222222222222222
2022,KHOUALKA,CITRUS VOLKAMERIANA,501680,IMG-00005-43.jpg,179,105,104,1,75,0.9904761904761904,0.5810055865921788
2022,KHOUALKA,CITRUS VOLKAMERIANA,501680,IMG-00011-43.jpg,101,54,53,1,48,0.9814814814814816,0.5247524752475248
2022,KHOUALKA,CITRUS VOLKAMERIANA,501680,IMG-00012-43.jpg,76,33,32,1,44,0.9696969696969696,0.4210526315789473
2022,KHOUALKA,CITRUS VOLKAMERIANA,501680,IMG-00016-43.jpg,113,82,80,2,33,0.975609756097561,0.7079646017699115
2022,KHOUALKA,CITRUS VOLKAMERIANA,501690,IMG-00032-43.jpg,34,15,15,0,19,1.0,0.4411764705882353
2022,KHOUALKA,CITRUS VOLKAMERIANA,501690,IMG-00039-43.jpg,186,116,114,2,72,0.9827586206896552,0.6129032258064516
2022,KHOUALKA,CITRUS VOLKAMERIANA,501690,IMG-00047-43.jpg,103,48,48,0,55,1.0,0.4660194174757282
2022,KHOUALKA,CITRUS VOLKAMERIANA,501690,IMG-00049-43.jpg,166,105,103,2,63,0.9809523809523808,0.6204819277108434
2022,KHOUALKA,CITRUS VOLKAMERIANA,501760,IMG-00001.jpg,94,44,44,0,50,1.0,0.4680851063829787
2022,KHOUALKA,CITRUS VOLKAMERIANA,501760,IMG-00034-43.jpg,45,12,12,0,33,1.0,0.2666666666666667
2022,KHOUALKA,CITRUS VOLKAMERIANA,501760,IMG-00036-43.jpg,40,23,22,1,18,0.9565217391304348,0.55
2022,KHOUALKA,CITRUS VOLKAMERIANA,501760,IMG-00051-43.jpg,92,41,41,0,51,1.0,0.4456521739130435
2022,ONAGRI,CITRUMELO SACCATON,510910,IMG-00004-44.jpg,73,64,62,2,11,0.96875,0.8493150684931506
2022,ONAGRI,CITRUMELO SACCATON,510910,IMG-00008-44.jpg,152,104,104,0,48,1.0,0.6842105263157895
2022,ONAGRI,CITRUMELO SACCATON,510910,IMG-00010-44.jpg,107,78,76,2,31,0.9743589743589745,0.7102803738317757
2022,ONAGRI,CITRUMELO SACCATON,510910,IMG-00011-44.jpg,92,69,68,1,24,0.9855072463768116,0.7391304347826086
2022,ONAGRI,CITRUMELO SACCATON,510950,IMG-00006-44.jpg,70,56,56,0,14,1.0,0.8
2022,ONAGRI,CITRUMELO SACCATON,510950,IMG-00008-44.jpg,75,58,57,1,18,0.9827586206896552,0.76
2022,ONAGRI,CITRUMELO SACCATON,510950,IMG-00009-44.jpg,85,62,60,2,25,0.967741935483871,0.7058823529411765
2022,ONAGRI,CITRUMELO SACCATON,510950,IMG-00011-44.jpg,135,105,103,2,32,0.9809523809523808,0.762962962962963
2022,ONAGRI,MC PONSIRUCE TRIFOLIATA,510980,IMG-00014-44.jpg,67,49,47,2,20,0.9591836734693876,0.7014925373134329
2022,ONAGRI,MC PONSIRUCE TRIFOLIATA,510980,IMG-00015-44.jpg,51,41,40,1,11,0.975609756097561,0.7843137254901961
2022,ONAGRI,MC PONSIRUCE TRIFOLIATA,510980,IMG-00016-44.jpg,99,72,72,0,27,1.0,0.7272727272727273
2022,ONAGRI,MC PONSIRUCE TRIFOLIATA,510980,IMG-00019-44.jpg,102,78,78,0,24,1.0,0.7647058823529411
2022,ONAGRI,MC PONSIRUCE TRIFOLIATA,510990,IMG-00006-44.jpg,135,111,109,2,26,0.981981981981982,0.8074074074074075
2022,ONAGRI,MC PONSIRUCE TRIFOLIATA,510990,IMG-00008-44.jpg,110,99,97,2,13,0.9797979797979798,0.8818181818181818
2022,ONAGRI,MC PONSIRUCE TRIFOLIATA,510990,IMG-00009-44.jpg,85,76,71,5,14,0.9342105263157896,0.8352941176470589
2022,ONAGRI,MC PONSIRUCE TRIFOLIATA,510990,IMG-00024-44.jpg,65,55,55,0,10,1.0,0.8461538461538461
2022,ONAGRI,MC PONSIRUCE TRIFOLIATA,511030,IMG-00007-44.jpg,100,84,80,4,20,0.9523809523809524,0.8
2022,ONAGRI,MC PONSIRUCE TRIFOLIATA,511030,IMG-00016-44.jpg,63,53,52,1,11,0.981132075471698,0.8253968253968254
2022,ONAGRI,MC PONSIRUCE TRIFOLIATA,511030,IMG-00022-44.jpg,98,86,80,6,18,0.9302325581395348,0.8163265306122449
2022,ONAGRI,MC PONSIRUCE TRIFOLIATA,511030,IMG-00027-44.jpg,82,73,71,2,11,0.9726027397260274,0.8658536585365854
2022,ONAGRI,MS PONSIRUCE TRIFOLIATA,511040,IMG-00004-44.jpg,77,59,59,0,18,1.0,0.7662337662337663
2022,ONAGRI,MS PONSIRUCE TRIFOLIATA,511040,IMG-00014-44.jpg,48,36,33,3,15,0.9166666666666666,0.6875
2022,ONAGRI,MS PONSIRUCE TRIFOLIATA,511040,IMG-00016-44.jpg,71,57,56,1,15,0.9824561403508772,0.7887323943661971
2022,ONAGRI,MS PONSIRUCE TRIFOLIATA,511040,IMG-00025-44.jpg,56,38,38,0,18,1.0,0.6785714285714286
2022,ONAGRI,FUZHU,511050,IMG-00004-44.jpg,109,84,78,6,31,0.9285714285714286,0.7155963302752294
2022,ONAGRI,FUZHU,511050,IMG-00006-44.jpg,142,104,99,5,43,0.9519230769230768,0.6971830985915493
2022,ONAGRI,FUZHU,511050,IMG-00011-44.jpg,172,141,135,6,37,0.9574468085106383,0.7848837209302325
2022,ONAGRI,FUZHU,511050,IMG-00022-44.jpg,194,161,153,8,41,0.9503105590062112,0.788659793814433
2022,ONAGRI,MS PONSIRUCE TRIFOLIATA,511060,IMG-00007-44.jpg,115,92,89,3,26,0.967391304347826,0.7739130434782608
2022,ONAGRI,MS PONSIRUCE TRIFOLIATA,511060,IMG-00016-44.jpg,102,71,69,2,33,0.971830985915493,0.6764705882352942
2022,ONAGRI,MS PONSIRUCE TRIFOLIATA,511060,IMG-00017-44.jpg,59,38,38,0,21,1.0,0.6440677966101694
2022,ONAGRI,MS PONSIRUCE TRIFOLIATA,511060,IMG-00019-44.jpg,108,76,75,1,33,0.986842105263158,0.6944444444444444
2022,ONAGRI,FUZHU,511070,IMG-00006-44.jpg,82,71,69,2,13,0.971830985915493,0.8414634146341463
2022,ONAGRI,FUZHU,511070,IMG-00016-44.jpg,96,68,68,0,28,1.0,0.7083333333333334
2022,ONAGRI,FUZHU,511070,IMG-00018-44.jpg,93,67,65,2,28,0.9701492537313432,0.6989247311827957
2022,ONAGRI,FUZHU,511070,IMG-00019-44.jpg,142,106,106,0,36,1.0,0.7464788732394366
