compagnie,Domaine,Porte-greffe,parcelle,Filename,True_count,detect_count,TP,FP,FN,Precision,Recall
2022,SAOUDA,BIGARADIER,10010,IMG-00011-45.jpg,28,37,28,9,0,0.7567567567567568,1.0
2022,SAOUDA,BIGARADIER,10010,IMG-00012-45.jpg,27,34,26,8,1,0.7647058823529411,0.9629629629629628
2022,SAOUDA,BIGARADIER,10010,IMG-00014-45.jpg,50,57,48,9,2,0.8421052631578947,0.96
2022,SAOUDA,BIGARADIER,10010,IMG-00018-45.jpg,30,35,28,7,2,0.8,0.9333333333333332
2022,SAOUDA,BIGARADIER,10010,IMG-00020-45.jpg,31,43,31,12,0,0.7209302325581395,1.0
2024,SAOUDA,BIGARADIER,10010,IMG-23410.jpg,85,70,67,3,18,0.9571428571428572,0.788235294117647
2024,SAOUDA,BIGARADIER,10010,IMG-23417.jpg,86,66,65,1,21,0.9848484848484848,0.7558139534883721
2024,SAOUDA,BIGARADIER,10010,IMG-23430.jpg,74,65,65,0,9,1.0,0.8783783783783784
2024,SAOUDA,BIGARADIER,10010,IMG-23647.jpg,95,85,81,4,14,0.9529411764705882,0.8526315789473684
2024,SAOUDA,BIGARADIER,10010,IMG-23672.jpg,47,33,32,1,15,0.9696969696969696,0.6808510638297872
2024,SAOUDA,BIGARADIER,10010,IMG-23707.jpg,30,27,27,0,3,1.0,0.9
2024,SAOUDA,BIGARADIER,10010,IMG-23709.jpg,31,25,25,0,6,1.0,0.8064516129032258
2024,SAOUDA,BIGARADIER,10010,IMG-23711.jpg,79,71,65,6,14,0.9154929577464788,0.8227848101265823
2022,SAOUDA,MACROPHYLLA,10030,IMG-00158-45.jpg,101,134,99,35,2,0.7388059701492538,0.9801980198019802
2022,SAOUDA,MACROPHYLLA,10030,IMG-00159-45.jpg,155,195,154,41,1,0.7897435897435897,0.9935483870967742
2022,SAOUDA,MACROPHYLLA,10030,IMG-00162-45.jpg,119,143,117,26,2,0.8181818181818182,0.9831932773109244
2022,SAOUDA,MACROPHYLLA,10030,IMG-00169-45.jpg,72,98,72,26,0,0.7346938775510204,1.0
2022,SAOUDA,MACROPHYLLA,10031,IMG-00002-45.jpg,46,55,45,10,1,0.8181818181818182,0.9782608695652174
2022,SAOUDA,MACROPHYLLA,10031,IMG-00084-45.jpg,41,52,37,15,4,0.7115384615384616,0.902439024390244
2022,SAOUDA,MACROPHYLLA,10031,IMG-00450-45.jpg,27,41,26,15,1,0.6341463414634146,0.9629629629629628
2022,SAOUDA,MACROPHYLLA,10031,IMG-00451-45.jpg,34,44,33,11,1,0.75,0.9705882352941176
2022,SAOUDA,MACROPHYLLA,10031,IMG-00464-45.jpg,33,42,33,9,0,0.7857142857142857,1.0
2022,ONAGRI,CITRUS VOLKAMERIANA,10101,IMG-00003-39.jpg,120,117,113,4,7,0.9658119658119658,0.9416666666666668
2022,ONAGRI,CITRUS VOLKAMERIANA,10101,IMG-00010-39.jpg,85,75,70,5,15,0.9333333333333332,0.8235294117647058
2024,ONAGRI,CITRUS VOLKAMERIANA,10101,IMG-10523.jpg,288,229,229,0,59,1.0,0.7951388888888888
2024,ONAGRI,CITRUS VOLKAMERIANA,10101,IMG-10545.jpg,98,74,73,1,25,0.9864864864864864,0.7448979591836735
2024,ONAGRI,CITRUS VOLKAMERIANA,10101,IMG-10558.jpg,143,98,97,1,46,0.9897959183673468,0.6783216783216783
2022,ONAGRI,CITRUS VOLKAMERIANA,10102,IMG-00003-39.jpg,48,40,40,0,8,1.0,0.8333333333333334
2024,ONAGRI,CITRUS VOLKAMERIANA,10102,IMG-10637.jpg,140,122,120,2,20,0.9836065573770492,0.8571428571428571
2024,ONAGRI,CITRUS VOLKAMERIANA,10102,IMG-10658.jpg,163,131,129,2,34,0.9847328244274808,0.7914110429447853
2022,ONAGRI,CITRUS VOLKAMERIANA,10103,IMG-00003-39.jpg,215,196,191,5,24,0.9744897959183674,0.8883720930232558
2022,ONAGRI,CITRUS VOLKAMERIANA,10103,IMG-00008-39.jpg,195,194,180,14,15,0.9278350515463918,0.9230769230769232
2024,ONAGRI,CITRUS VOLKAMERIANA,10103,IMG-10614.jpg,134,110,107,3,27,0.9727272727272728,0.7985074626865671
2024,ONAGRI,CITRUS VOLKAMERIANA,10103,IMG-10630.jpg,213,180,177,3,36,0.9833333333333332,0.8309859154929577
2024,ONAGRI,CITRUS VOLKAMERIANA,10103,IMG-10631.jpg,134,99,99,0,35,1.0,0.7388059701492538
2022,ONAGRI,CITRUS VOLKAMERIANA,10104,IMG-00004-39.jpg,65,61,59,2,6,0.9672131147540984,0.9076923076923076
2022,ONAGRI,CITRUS VOLKAMERIANA,10104,IMG-00008-39.jpg,69,60,56,4,13,0.9333333333333332,0.8115942028985508
2024,ONAGRI,CITRUS VOLKAMERIANA,10104,IMG-11267.jpg,22,12,12,0,10,1.0,0.5454545454545454
2024,ONAGRI,CITRUS VOLKAMERIANA,10104,IMG-11327.jpg,128,94,94,0,34,1.0,0.734375
2024,ONAGRI,CITRUS VOLKAMERIANA,10104,IMG-11347.jpg,118,77,77,0,41,1.0,0.652542372881356
2024,ONAGRI,CITRUS VOLKAMERIANA,10104,IMG-11366.jpg,351,257,254,3,97,0.9883268482490272,0.7236467236467237
2024,ONAGRI,CITRUS VOLKAMERIANA,10104,IMG-11386.jpg,99,67,67,0,32,1.0,0.6767676767676768
2022,ONAGRI,CITRUS VOLKAMERIANA,10105,IMG-00004-39.jpg,17,18,15,3,2,0.8333333333333334,0.8823529411764706
2022,ONAGRI,CITRUS VOLKAMERIANA,10105,IMG-00005-39.jpg,68,66,61,5,7,0.9242424242424242,0.8970588235294118
2022,ONAGRI,CITRUS VOLKAMERIANA,10108,IMG-00003-39.jpg,61,58,56,2,5,0.9655172413793104,0.918032786885246
2022,ONAGRI,CITRUS VOLKAMERIANA,10108,IMG-00007-39.jpg,69,63,63,0,6,1.0,0.9130434782608696
2022,ONAGRI,CITRUS VOLKAMERIANA,10109,IMG-00003-39.jpg,4,4,4,0,0,1.0,1.0
2022,ONAGRI,CITRUS VOLKAMERIANA,10109,IMG-00008-39.jpg,105,101,98,3,7,0.9702970297029704,0.9333333333333332
2022,KHOUALKA,CITRANGE CARRIZO,10213,IMG-00001.jpg,77,85,74,11,3,0.8705882352941177,0.961038961038961
2022,KHOUALKA,CITRANGE CARRIZO,10213,IMG-00005-40.jpg,73,82,70,12,3,0.8536585365853658,0.958904109589041
2022,KHOUALKA,CITRANGE CARRIZO,10213,IMG-00009-40.jpg,14,19,14,5,0,0.7368421052631579,1.0
2022,KHOUALKA,CITRANGE CARRIZO,10213,IMG-00014-40.jpg,21,24,20,4,1,0.8333333333333334,0.9523809523809524
2022,KHOUALKA,CITRANGE CARRIZO,10213,IMG-00028-40.jpg,47,50,46,4,1,0.92,0.9787234042553192
2022,KHOUALKA,CITRANGE CARRIZO,10213,IMG-00034-40.jpg,48,49,48,1,0,0.979591836734694,1.0
2022,KHOUALKA,CITRANGE CARRIZO,10213,IMG-00035-40.jpg,37,40,36,4,1,0.9,0.972972972972973
2022,KHOUALKA,CITRANGE CARRIZO,10213,IMG-00036-40.jpg,47,57,47,10,0,0.8245614035087719,1.0
2022,KHOUALKA,CITRANGE CARRIZO,10213,IMG-00042-40.jpg,22,26,22,4,0,0.8461538461538461,1.0
2022,KHOUALKA,CITRANGE CARRIZO,10213,IMG-00047-40.jpg,70,71,67,4,3,0.943661971830986,0.9571428571428572
2022,KHOUALKA,CITRANGE CARRIZO,10213,IMG-00054-40.jpg,33,36,33,3,0,0.9166666666666666,1.0
2022,KHOUALKA,CITRANGE CARRIZO,10213,IMG-00055-40.jpg,93,92,88,4,5,0.9565217391304348,0.946236559139785
2022,KHOUALKA,CITRANGE CARRIZO,10213,IMG-00061-40.jpg,113,128,110,18,3,0.859375,0.9734513274336284
2022,KHOUALKA,CITRANGE CARRIZO,10213,IMG-00066-40.jpg,48,47,43,4,5,0.9148936170212766,0.8958333333333334
2022,OUARGHA,MACROPHYLLA,11010,IMG-00001.jpg,40,42,39,3,1,0.9285714285714286,0.975
2022,OUARGHA,MACROPHYLLA,11010,IMG-00015-41.jpg,24,27,22,5,2,0.8148148148148148,0.9166666666666666
2022,OUARGHA,MACROPHYLLA,11010,IMG-00019-41.jpg,20,30,20,10,0,0.6666666666666666,1.0
2022,OUARGHA,MACROPHYLLA,11010,IMG-00024-41.jpg,21,25,21,4,0,0.84,1.0
2022,OUARGHA,MACROPHYLLA,11020,IMG-00017-41.jpg,51,56,51,5,0,0.9107142857142856,1.0
2022,OUARGHA,MACROPHYLLA,11020,IMG-00018-41.jpg,13,13,13,0,0,1.0,1.0
2022,OUARGHA,CITRANGE CARRIZO,13010,IMG-00067-41.jpg,55,73,54,19,1,0.7397260273972602,0.9818181818181818
2022,OUARGHA,CITRANGE CARRIZO,13010,IMG-00086-41.jpg,49,60,48,12,1,0.8,0.979591836734694
2022,OUARGHA,CITRANGE CARRIZO,13010,IMG-00194-41.jpg,33,41,33,8,0,0.8048780487804879,1.0
2022,OUARGHA,CITRANGE CARRIZO,13020,IMG-00023-41.jpg,31,36,31,5,0,0.8611111111111112,1.0
2022,OUARGHA,CITRANGE CARRIZO,13020,IMG-00024-41.jpg,18,25,18,7,0,0.72,1.0
2022,OUARGHA,CITRANGE CARRIZO,13020,IMG-00039-41.jpg,4,10,3,7,1,0.3,0.75
2022,OUARGHA,CITRANGE CARRIZO,13020,IMG-00040-41.jpg,6,13,6,7,0,0.4615384615384616,1.0
2022,OUARGHA,CITRUS VOLKAMERIANA,13030,IMG-00009-41.jpg,18,27,18,9,0,0.6666666666666666,1.0
2022,OUARGHA,CITRUS VOLKAMERIANA,13030,IMG-00013-41.jpg,46,72,46,26,0,0.6388888888888888,1.0
2022,OUARGHA,CITRUS VOLKAMERIANA,13030,IMG-00027-41.jpg,12,28,12,16,0,0.4285714285714285,1.0
2022,OUARGHA,CITRUS VOLKAMERIANA,13030,IMG-00029-41.jpg,18,29,18,11,0,0.6206896551724138,1.0
2022,OUARGHA,CITRUS VOLKAMERIANA,13030,IMG-00036-41.jpg,16,37,16,21,0,0.4324324324324325,1.0
2022,OUARGHA,CITRUS VOLKAMERIANA,14010,IMG-00008-41.jpg,40,48,40,8,0,0.8333333333333334,1.0
2022,OUARGHA,CITRUS VOLKAMERIANA,14010,IMG-00010-41.jpg,49,57,49,8,0,0.8596491228070176,1.0
2022,OUARGHA,CITRUS VOLKAMERIANA,14010,IMG-00011-41.jpg,47,58,46,12,1,0.7931034482758621,0.9787234042553192
2022,OUARGHA,CITRUS VOLKAMERIANA,14010,IMG-00018-41.jpg,44,61,43,18,1,0.7049180327868853,0.9772727272727272
2022,KHOUALKA,MACROPHYLLA,20118,IMG-00007-40.jpg,44,44,43,1,1,0.9772727272727272,0.9772727272727272
2022,KHOUALKA,MACROPHYLLA,20118,IMG-00008-40.jpg,115,125,114,11,1,0.912,0.991304347826087
2022,KHOUALKA,MACROPHYLLA,20118,IMG-00022-40.jpg,113,114,108,6,5,0.9473684210526316,0.9557522123893806
2022,KHOUALKA,MACROPHYLLA,20118,IMG-00033-40.jpg,58,62,56,6,2,0.9032258064516128,0.9655172413793104
2022,KHOUALKA,MACROPHYLLA,20118,IMG-00037-40.jpg,29,30,27,3,2,0.9,0.9310344827586208
2022,KHOUALKA,MACROPHYLLA,20118,IMG-00042-40.jpg,137,144,131,13,6,0.9097222222222222,0.9562043795620438
2022,KHOUALKA,MACROPHYLLA,20118,IMG-00046-40.jpg,45,54,44,10,1,0.8148148148148148,0.9777777777777776
2022,KHOUALKA,MACROPHYLLA,20118,IMG-00050-40.jpg,48,50,47,3,1,0.94,0.9791666666666666
2022,KHOUALKA,MACROPHYLLA,20118,IMG-00055-40.jpg,52,56,50,6,2,0.8928571428571429,0.9615384615384616
2022,KHOUALKA,MACROPHYLLA,20118,IMG-00061-40.jpg,120,129,111,18,9,0.8604651162790697,0.925
2022,KHOUALKA,MACROPHYLLA,20118,IMG-00062-40.jpg,63,63,58,5,5,0.9206349206349206,0.9206349206349206
2022,KHOUALKA,MACROPHYLLA,20118,IMG-00063-40.jpg,47,45,41,4,6,0.9111111111111112,0.8723404255319149
2022,KHOUALKA,MACROPHYLLA,20118,IMG-00066-40.jpg,84,90,80,10,4,0.8888888888888888,0.9523809523809524
2024,KHOUALKA,MACROPHYLLA,20118,IMG-12691.jpg,22,15,14,1,8,0.9333333333333332,0.6363636363636364
2024,KHOUALKA,MACROPHYLLA,20118,IMG-12729.jpg,56,44,44,0,12,1.0,0.7857142857142857
2024,KHOUALKA,MACROPHYLLA,20118,IMG-12735.jpg,88,61,61,0,27,1.0,0.6931818181818182
2024,KHOUALKA,MACROPHYLLA,20118,IMG-12748.jpg,107,69,69,0,38,1.0,0.6448598130841121
2024,KHOUALKA,MACROPHYLLA,20118,IMG-12764.jpg,111,88,88,0,23,1.0,0.7927927927927928
2024,KHOUALKA,MACROPHYLLA,20118,IMG-12808.jpg,113,75,74,1,39,0.9866666666666668,0.6548672566371682
2024,KHOUALKA,MACROPHYLLA,20118,IMG-12851.jpg,24,12,12,0,12,1.0,0.5
2022,KHOUALKA,MACROPHYLLA,20119,IMG-00005-40.jpg,106,114,104,10,2,0.912280701754386,0.981132075471698
2022,KHOUALKA,MACROPHYLLA,20119,IMG-00008-40.jpg,142,154,138,16,4,0.8961038961038961,0.971830985915493
2022,KHOUALKA,MACROPHYLLA,20119,IMG-00014-40.jpg,132,135,128,7,4,0.9481481481481482,0.9696969696969696
2022,KHOUALKA,BIGARADIER,20132,IMG-00004-40.jpg,181,179,176,3,5,0.9832402234636872,0.9723756906077348
2022,KHOUALKA,BIGARADIER,20132,IMG-00025-40.jpg,91,106,90,16,1,0.8490566037735849,0.989010989010989
2022,KHOUALKA,BIGARADIER,20132,IMG-00028-40.jpg,49,52,48,4,1,0.9230769230769232,0.979591836734694
2022,KHOUALKA,BIGARADIER,20132,IMG-00035-40.jpg,103,116,102,14,1,0.8793103448275862,0.9902912621359224
2022,KHOUALKA,BIGARADIER,20132,IMG-00039-40.jpg,119,133,117,16,2,0.8796992481203008,0.9831932773109244
2022,KHOUALKA,BIGARADIER,20132,IMG-00046-40.jpg,156,166,152,14,4,0.9156626506024096,0.9743589743589745
2022,KHOUALKA,BIGARADIER,20132,IMG-00051-40.jpg,108,109,103,6,5,0.944954128440367,0.9537037037037036
2022,KHOUALKA,BIGARADIER,20132,IMG-00055-40.jpg,67,67,62,5,5,0.9253731343283582,0.9253731343283582
2022,KHOUALKA,BIGARADIER,20132,IMG-00058-40.jpg,89,87,86,1,3,0.9885057471264368,0.9662921348314608
2022,KHOUALKA,BIGARADIER,20132,IMG-00059-40.jpg,139,142,130,12,9,0.9154929577464788,0.935251798561151
2022,KHOUALKA,BIGARADIER,20132,IMG-00060-40.jpg,57,53,50,3,7,0.9433962264150944,0.8771929824561403
2022,KHOUALKA,BIGARADIER,20132,IMG-00064-40.jpg,117,127,114,13,3,0.8976377952755905,0.9743589743589745
2022,KHOUALKA,BIGARADIER,20132,IMG-00075-40.jpg,69,75,69,6,0,0.92,1.0
2022,ONAGRI,BIGARADIER,20139,IMG-00021-39.jpg,93,93,89,4,4,0.956989247311828,0.956989247311828
2024,KHOUALKA,CITRUS VOLKAMERIANA,20205,IMG-12040.jpg,123,89,84,5,39,0.9438202247191012,0.6829268292682927
2024,KHOUALKA,CITRUS VOLKAMERIANA,20205,IMG-12058.jpg,116,108,107,1,9,0.9907407407407408,0.9224137931034484
2022,SAOUDA,CITRUS VOLKAMERIANA,21020,IMG-00033-45.jpg,67,84,65,19,2,0.7738095238095238,0.9701492537313432
2022,SAOUDA,CITRUS VOLKAMERIANA,21020,IMG-00087-45.jpg,21,26,20,6,1,0.7692307692307693,0.9523809523809524
2022,SAOUDA,CITRUS VOLKAMERIANA,21020,IMG-00138-45.jpg,40,47,39,8,1,0.8297872340425532,0.975
2022,SAOUDA,CITRUS VOLKAMERIANA,21020,IMG-00145-45.jpg,37,41,37,4,0,0.902439024390244,1.0
2022,SAOUDA,CITRUS VOLKAMERIANA,21020,IMG-00155-45.jpg,38,53,38,15,0,0.7169811320754716,1.0
2022,SAOUDA,CITRUS VOLKAMERIANA,21030,IMG-00521-45.jpg,31,42,31,11,0,0.7380952380952381,1.0
2022,SAOUDA,CITRUS VOLKAMERIANA,21030,IMG-00524-45.jpg,71,88,70,18,1,0.7954545454545454,0.9859154929577464
2022,SAOUDA,CITRUS VOLKAMERIANA,21030,IMG-00536-45.jpg,41,63,41,22,0,0.6507936507936508,1.0
2022,SAOUDA,CITRUS VOLKAMERIANA,21030,IMG-00537-45.jpg,52,68,51,17,1,0.75,0.9807692307692308
2022,SAOUDA,CITRUS VOLKAMERIANA,22020,IMG-00053-45.jpg,39,55,39,16,0,0.7090909090909091,1.0
2022,SAOUDA,CITRUS VOLKAMERIANA,22020,IMG-00059-45.jpg,46,55,44,11,2,0.8,0.9565217391304348
2022,SAOUDA,CITRUS VOLKAMERIANA,22020,IMG-00060-45.jpg,48,54,47,7,1,0.8703703703703703,0.9791666666666666
2022,SAOUDA,CITRUS VOLKAMERIANA,22020,IMG-00062-45.jpg,50,69,50,19,0,0.7246376811594203,1.0
2022,SAOUDA,CITRUS VOLKAMERIANA,22030,IMG-00062-45.jpg,62,71,62,9,0,0.8732394366197183,1.0
2022,SAOUDA,CITRUS VOLKAMERIANA,22030,IMG-00063-45.jpg,83,99,80,19,3,0.8080808080808081,0.963855421686747
2022,SAOUDA,CITRUS VOLKAMERIANA,22030,IMG-00065-45.jpg,58,66,57,9,1,0.8636363636363636,0.9827586206896552
2022,SAOUDA,CITRUS VOLKAMERIANA,22030,IMG-00068-45.jpg,66,81,65,16,1,0.8024691358024691,0.9848484848484848
2022,SAOUDA,CITRUS VOLKAMERIANA,23020,IMG-00024-45.jpg,47,59,46,13,1,0.7796610169491526,0.9787234042553192
2022,SAOUDA,CITRUS VOLKAMERIANA,23020,IMG-00032-45.jpg,33,37,33,4,0,0.8918918918918919,1.0
2022,SAOUDA,CITRUS VOLKAMERIANA,23020,IMG-00074-45.jpg,28,31,25,6,3,0.8064516129032258,0.8928571428571429
2022,SAOUDA,CITRUS VOLKAMERIANA,23020,IMG-00079-45.jpg,28,39,27,12,1,0.6923076923076923,0.9642857142857144
2022,SAOUDA,CITRUS VOLKAMERIANA,23030,IMG-00014-45.jpg,25,37,25,12,0,0.6756756756756757,1.0
2022,SAOUDA,CITRUS VOLKAMERIANA,23030,IMG-00034-45.jpg,43,56,41,15,2,0.7321428571428571,0.9534883720930232
2022,SAOUDA,CITRUS VOLKAMERIANA,23030,IMG-00069-45.jpg,28,52,28,24,0,0.5384615384615384,1.0
2022,SAOUDA,CITRUS VOLKAMERIANA,23030,IMG-00079-45.jpg,50,76,49,27,1,0.6447368421052632,0.98
2022,SAOUDA,CITRANGE CARRIZO,24010,IMG-00097-45.jpg,59,72,56,16,3,0.7777777777777778,0.9491525423728814
2022,SAOUDA,CITRANGE CARRIZO,24010,IMG-00101-45.jpg,27,35,27,8,0,0.7714285714285715,1.0
2022,SAOUDA,CITRANGE CARRIZO,24010,IMG-00111-45.jpg,54,60,54,6,0,0.9,1.0
2022,SAOUDA,CITRANGE CARRIZO,24010,IMG-00112-45.jpg,40,52,40,12,0,0.7692307692307693,1.0
2022,SAOUDA,CITRANGE CARRIZO,25010,IMG-00006-45.jpg,55,70,55,15,0,0.7857142857142857,1.0
2022,SAOUDA,CITRANGE CARRIZO,25010,IMG-00007-45.jpg,77,96,77,19,0,0.8020833333333334,1.0
2022,SAOUDA,CITRANGE CARRIZO,25010,IMG-00010-45.jpg,53,72,53,19,0,0.7361111111111112,1.0
2022,SAOUDA,CITRANGE CARRIZO,25010,IMG-00011-45.jpg,26,31,26,5,0,0.8387096774193549,1.0
2022,SAOUDA,CITRANGE CARRIZO,26010,IMG-00008-45.jpg,39,43,38,5,1,0.8837209302325582,0.9743589743589745
2022,SAOUDA,CITRANGE CARRIZO,26010,IMG-00013-45.jpg,36,49,36,13,0,0.7346938775510204,1.0
2022,SAOUDA,CITRANGE CARRIZO,26010,IMG-00018-45.jpg,43,54,43,11,0,0.7962962962962963,1.0
2022,SAOUDA,CITRANGE CARRIZO,26010,IMG-00020-45.jpg,44,48,43,5,1,0.8958333333333334,0.9772727272727272
2022,KHOUALKA,CITRANGE CARRIZO,30138,IMG-00002-40.jpg,39,45,37,8,2,0.8222222222222222,0.9487179487179488
2022,KHOUALKA,CITRANGE CARRIZO,30138,IMG-00003-40.jpg,59,63,57,6,2,0.9047619047619048,0.9661016949152542
2022,KHOUALKA,CITRANGE CARRIZO,30138,IMG-00005-40.jpg,58,66,58,8,0,0.8787878787878788,1.0
2022,KHOUALKA,CITRANGE CARRIZO,30138,IMG-00008-40.jpg,32,35,31,4,1,0.8857142857142857,0.96875
2022,KHOUALKA,CITRANGE CARRIZO,30138,IMG-00011-40.jpg,26,28,25,3,1,0.8928571428571429,0.9615384615384616
2022,KHOUALKA,CITRANGE CARRIZO,30138,IMG-00019-40.jpg,2,2,2,0,0,1.0,1.0
2022,KHOUALKA,CITRANGE CARRIZO,30138,IMG-00037-40.jpg,30,34,28,6,2,0.8235294117647058,0.9333333333333332
2022,KHOUALKA,CITRANGE CARRIZO,30138,IMG-00040-40.jpg,41,44,40,4,1,0.9090909090909092,0.975609756097561
2022,KHOUALKA,CITRANGE CARRIZO,30138,IMG-00043-40.jpg,28,30,24,6,4,0.8,0.8571428571428571
2022,KHOUALKA,CITRANGE CARRIZO,30138,IMG-00044-40.jpg,99,100,96,4,3,0.96,0.9696969696969696
2022,KHOUALKA,CITRANGE CARRIZO,30138,IMG-00048-40.jpg,37,40,34,6,3,0.85,0.918918918918919
2022,KHOUALKA,CITRANGE CARRIZO,30138,IMG-00057-40.jpg,73,77,69,8,4,0.8961038961038961,0.9452054794520548
2022,KHOUALKA,CITRANGE CARRIZO,30138,IMG-00063-40.jpg,89,76,74,2,15,0.9736842105263158,0.8314606741573034
2022,ONAGRI,CITRUS VOLKAMERIANA,30145,IMG-00018-39.jpg,219,198,192,6,27,0.9696969696969696,0.8767123287671232
2022,ONAGRI,CITRUS VOLKAMERIANA,30145,IMG-00043-39.jpg,64,67,63,4,1,0.9402985074626866,0.984375
2022,ONAGRI,CITRUS VOLKAMERIANA,30146,IMG-00008-39.jpg,262,250,241,9,21,0.964,0.9198473282442748
2022,ONAGRI,CITRUS VOLKAMERIANA,30146,IMG-00045-39.jpg,190,193,182,11,8,0.9430051813471504,0.9578947368421052
2022,ONAGRI,CITRUS VOLKAMERIANA,30147,IMG-00002-39.jpg,269,256,247,9,22,0.96484375,0.9182156133828996
2022,ONAGRI,CITRUS VOLKAMERIANA,30147,IMG-00008-39.jpg,172,163,159,4,13,0.9754601226993864,0.9244186046511628
2022,ONAGRI,CITRUS VOLKAMERIANA,30148,IMG-00016-40.jpg,88,88,84,4,4,0.9545454545454546,0.9545454545454546
2022,ONAGRI,CITRUS VOLKAMERIANA,30148,IMG-00047-40.jpg,34,33,33,0,1,1.0,0.9705882352941176
2022,ONAGRI,CITRUS VOLKAMERIANA,30149,IMG-00018-39.jpg,151,135,134,1,17,0.9925925925925926,0.8874172185430463
2022,ONAGRI,CITRUS VOLKAMERIANA,30149,IMG-00027-39.jpg,226,201,199,2,27,0.9900497512437813,0.8805309734513275
2022,ONAGRI,CITRUS VOLKAMERIANA,30151,IMG-00012-39.jpg,185,159,153,6,32,0.9622641509433962,0.827027027027027
2022,ONAGRI,CITRUS VOLKAMERIANA,30151,IMG-00033-39.jpg,214,205,195,10,19,0.951219512195122,0.911214953271028
2024,ONAGRI,CITRUS VOLKAMERIANA,30151,IMG-21881.jpg,73,53,52,1,21,0.981132075471698,0.7123287671232876
2024,ONAGRI,CITRUS VOLKAMERIANA,30151,IMG-21935.jpg,179,155,151,4,28,0.9741935483870968,0.8435754189944135
2024,ONAGRI,CITRUS VOLKAMERIANA,30151,IMG-21936.jpg,93,73,73,0,20,1.0,0.7849462365591398
2022,ONAGRI,CITRUS VOLKAMERIANA,30152,IMG-00016-39.jpg,39,37,36,1,3,0.972972972972973,0.9230769230769232
2022,ONAGRI,CITRUS VOLKAMERIANA,30152,IMG-00019-39.jpg,139,122,121,1,18,0.9918032786885246,0.8705035971223022
2022,ONAGRI,CITRUS VOLKAMERIANA,30153,IMG-00001.jpg,157,142,137,5,20,0.9647887323943662,0.8726114649681529
2022,ONAGRI,CITRUS VOLKAMERIANA,30153,IMG-00007-39.jpg,127,115,113,2,14,0.982608695652174,0.889763779527559
2022,ONAGRI,CITRUS VOLKAMERIANA,30153,IMG-00013-39.jpg,159,154,151,3,8,0.9805194805194806,0.949685534591195
2022,ONAGRI,CITRUS VOLKAMERIANA,30153,IMG-00040-39.jpg,153,143,140,3,13,0.9790209790209792,0.915032679738562
2022,ONAGRI,CITRUS VOLKAMERIANA,30154,IMG-00017-39.jpg,160,160,151,9,9,0.94375,0.94375
2022,ONAGRI,CITRUS VOLKAMERIANA,30154,IMG-00027-39.jpg,220,215,211,4,9,0.9813953488372092,0.9590909090909092
2022,ONAGRI,CITRUS VOLKAMERIANA,30154,IMG-00033-39.jpg,51,50,49,1,2,0.98,0.9607843137254902
2022,ONAGRI,CITRUS VOLKAMERIANA,30154,IMG-00036-39.jpg,137,137,132,5,5,0.9635036496350364,0.9635036496350364
2022,ONAGRI,CITRUS VOLKAMERIANA,30154,IMG-00038-39.jpg,242,245,239,6,3,0.9755102040816328,0.987603305785124
2022,ONAGRI,CITRUS VOLKAMERIANA,30154,IMG-00041-39.jpg,272,262,253,9,19,0.965648854961832,0.9301470588235294
2022,ONAGRI,CITRUS VOLKAMERIANA,30154,IMG-00044-39.jpg,141,142,136,6,5,0.9577464788732394,0.9645390070921984
2022,ONAGRI,BIGARADIER,30155,IMG-00002-39.jpg,139,145,136,9,3,0.9379310344827586,0.9784172661870504
2022,ONAGRI,BIGARADIER,30155,IMG-00003-39.jpg,115,113,107,6,8,0.9469026548672568,0.9304347826086956
2022,ONAGRI,BIGARADIER,30155,IMG-00006-39.jpg,44,43,39,4,5,0.9069767441860463,0.8863636363636364
2022,ONAGRI,BIGARADIER,30155,IMG-00011-39.jpg,100,93,93,0,7,1.0,0.93
2022,ONAGRI,BIGARADIER,30155,IMG-00019-39.jpg,142,139,135,4,7,0.9712230215827338,0.9507042253521126
2022,ONAGRI,BIGARADIER,30155,IMG-00026-39.jpg,124,120,117,3,7,0.975,0.9435483870967742
2022,ONAGRI,BIGARADIER,30155,IMG-00032-39.jpg,81,79,77,2,4,0.9746835443037974,0.9506172839506172
2022,ONAGRI,BIGARADIER,30155,IMG-00039-39.jpg,19,19,18,1,1,0.9473684210526316,0.9473684210526316
2022,ONAGRI,BIGARADIER,30155,IMG-00043-39.jpg,130,134,126,8,4,0.9402985074626866,0.9692307692307692
2022,ONAGRI,CITRUS VOLKAMERIANA,30157,IMG-00003-39.jpg,227,219,215,4,12,0.9817351598173516,0.947136563876652
2022,ONAGRI,CITRUS VOLKAMERIANA,30157,IMG-00012-39.jpg,283,277,266,11,17,0.96028880866426,0.939929328621908
2022,ONAGRI,CITRUS VOLKAMERIANA,30157,IMG-00032-39.jpg,64,66,63,3,1,0.9545454545454546,0.984375
2022,ONAGRI,CITRUS VOLKAMERIANA,30157,IMG-00035-39.jpg,159,153,148,5,11,0.9673202614379084,0.9308176100628932
2022,KHOUALKA,CITRUS VOLKAMERIANA,30235,IMG-00001.jpg,93,98,92,6,1,0.9387755102040816,0.989247311827957
2022,KHOUALKA,CITRUS VOLKAMERIANA,30235,IMG-00003-40.jpg,37,41,37,4,0,0.902439024390244,1.0
2022,KHOUALKA,CITRUS VOLKAMERIANA,30235,IMG-00009-40.jpg,103,110,101,9,2,0.9181818181818182,0.9805825242718448
2022,KHOUALKA,CITRUS VOLKAMERIANA,30235,IMG-00013-40.jpg,90,102,89,13,1,0.8725490196078431,0.9888888888888888
2022,KHOUALKA,CITRUS VOLKAMERIANA,30235,IMG-00026-40.jpg,122,132,119,13,3,0.9015151515151516,0.9754098360655736
2022,KHOUALKA,CITRUS VOLKAMERIANA,30235,IMG-00047-40.jpg,47,51,43,8,4,0.8431372549019608,0.9148936170212766
2022,KHOUALKA,CITRUS VOLKAMERIANA,30235,IMG-00048-40.jpg,90,98,88,10,2,0.8979591836734694,0.9777777777777776
2022,KHOUALKA,CITRUS VOLKAMERIANA,30235,IMG-00049-40.jpg,44,50,42,8,2,0.84,0.9545454545454546
2022,KHOUALKA,CITRUS VOLKAMERIANA,30235,IMG-00050-40.jpg,84,84,76,8,8,0.9047619047619048,0.9047619047619048
2022,KHOUALKA,CITRUS VOLKAMERIANA,30235,IMG-00052-40.jpg,98,107,96,11,2,0.897196261682243,0.979591836734694
2022,KHOUALKA,CITRUS VOLKAMERIANA,30235,IMG-00057-40.jpg,80,81,74,7,6,0.9135802469135802,0.925
2022,KHOUALKA,CITRUS VOLKAMERIANA,30235,IMG-00064-40.jpg,38,39,36,3,2,0.9230769230769232,0.9473684210526316
2022,KHOUALKA,CITRUS VOLKAMERIANA,30235,IMG-00067-40.jpg,107,106,101,5,6,0.9528301886792452,0.9439252336448598
2022,KHOUALKA,CITRUS VOLKAMERIANA,30235,IMG-00069-40.jpg,34,34,30,4,4,0.8823529411764706,0.8823529411764706
2022,KHOUALKA,CITRUS VOLKAMERIANA,30235,IMG-00075-40.jpg,95,98,91,7,4,0.9285714285714286,0.9578947368421052
2022,KHOUALKA,BIGARADIER,40141,IMG-00006-40.jpg,7,8,6,2,1,0.75,0.8571428571428571
2022,KHOUALKA,BIGARADIER,40141,IMG-00007-40.jpg,20,12,11,1,9,0.9166666666666666,0.55
2022,KHOUALKA,BIGARADIER,40141,IMG-00008-40.jpg,15,13,12,1,3,0.9230769230769232,0.8
2022,ONAGRI,CITRANGE C35,40166,IMG-00009-39.jpg,38,37,35,2,3,0.945945945945946,0.9210526315789472
2022,ONAGRI,CITRANGE C35,40166,IMG-00011-39.jpg,173,175,166,9,7,0.9485714285714286,0.9595375722543352
2022,ONAGRI,CITRANGE C35,40166,IMG-00014-39.jpg,179,180,177,3,2,0.9833333333333332,0.988826815642458
2022,ONAGRI,CITRANGE C35,40166,IMG-00015-39.jpg,122,124,118,6,4,0.9516129032258064,0.9672131147540984
2022,ONAGRI,CITRANGE C35,40166,IMG-00041-39.jpg,102,100,99,1,3,0.99,0.9705882352941176
2022,ONAGRI,CITRANGE C35,40167,IMG-00019-39.jpg,197,196,191,5,6,0.9744897959183674,0.9695431472081218
2022,ONAGRI,CITRANGE C35,40167,IMG-00030-39.jpg,126,119,117,2,9,0.9831932773109244,0.9285714285714286
2022,ONAGRI,CITRANGE C35,40167,IMG-00039-39.jpg,217,206,196,10,21,0.9514563106796116,0.9032258064516128
2022,ONAGRI,CITRANGE C35,40171,IMG-00008-39.jpg,109,106,105,1,4,0.9905660377358492,0.963302752293578
2022,ONAGRI,CITRANGE C35,40171,IMG-00037-39.jpg,94,90,86,4,8,0.9555555555555556,0.9148936170212766
2022,ONAGRI,CITRANGE C35,40171,IMG-00040-39.jpg,149,148,142,6,7,0.9594594594594594,0.953020134228188
2022,ONAGRI,CITRANGE C35,40172,IMG-00012-39.jpg,89,83,81,2,8,0.9759036144578314,0.9101123595505618
2022,ONAGRI,CITRANGE C35,40172,IMG-00025-39.jpg,109,102,100,2,9,0.9803921568627452,0.9174311926605504
2022,ONAGRI,CITRANGE C35,40172,IMG-00027-39.jpg,103,93,91,2,12,0.978494623655914,0.883495145631068
2022,ONAGRI,CITRANGE C35,40173,IMG-00004-39.jpg,133,118,117,1,16,0.9915254237288136,0.8796992481203008
2022,ONAGRI,CITRANGE C35,40173,IMG-00008-39.jpg,57,44,43,1,14,0.9772727272727272,0.7543859649122807
2022,ONAGRI,CITRANGE C35,40173,IMG-00010-39.jpg,53,57,51,6,2,0.8947368421052632,0.9622641509433962
2022,ONAGRI,CITRANGE C35,40175,IMG-00005-39.jpg,95,88,83,5,12,0.9431818181818182,0.8736842105263158
2022,ONAGRI,CITRANGE C35,40175,IMG-00006-39.jpg,64,65,62,3,2,0.953846153846154,0.96875
2022,ONAGRI,CITRANGE C35,40176,IMG-00004-39.jpg,79,87,73,14,6,0.8390804597701149,0.9240506329113924
2022,ONAGRI,CITRANGE C35,40176,IMG-00012-39.jpg,105,110,102,8,3,0.9272727272727272,0.9714285714285714
2022,ONAGRI,CITRANGE C35,40176,IMG-00014-39.jpg,91,103,88,15,3,0.8543689320388349,0.967032967032967
2022,ONAGRI,CITRUMELO SACCATON,40177,IMG-00012-39.jpg,89,98,87,11,2,0.8877551020408163,0.9775280898876404
2022,ONAGRI,CITRUMELO SACCATON,40177,IMG-00015-39.jpg,213,226,210,16,3,0.9292035398230089,0.9859154929577464
2022,ONAGRI,CITRUMELO SACCATON,40177,IMG-00037-39.jpg,95,96,90,6,5,0.9375,0.9473684210526316
2022,ONAGRI,CITRANGE C35,40178,IMG-00013-39.jpg,76,78,74,4,2,0.9487179487179488,0.9736842105263158
2022,ONAGRI,CITRANGE C35,40178,IMG-00027-39.jpg,56,58,55,3,1,0.9482758620689656,0.9821428571428572
2022,ONAGRI,CITRANGE C35,40178,IMG-00031-39.jpg,30,33,30,3,0,0.9090909090909092,1.0
2022,ONAGRI,CITRANGE C35,40178,IMG-00032-39.jpg,27,29,27,2,0,0.9310344827586208,1.0
2022,ONAGRI,CITRANGE C35,40178,IMG-00033-39.jpg,34,37,33,4,1,0.8918918918918919,0.9705882352941176
2022,ONAGRI,CITRANGE C35,40179,IMG-00001.jpg,83,87,80,7,3,0.9195402298850576,0.963855421686747
2022,ONAGRI,CITRANGE C35,40179,IMG-00010-39.jpg,161,162,154,8,7,0.9506172839506172,0.9565217391304348
2022,ONAGRI,CITRANGE C35,40179,IMG-00011-39.jpg,102,107,97,10,5,0.9065420560747663,0.9509803921568628
2022,ONAGRI,CITRANGE C35,40179,IMG-00018-39.jpg,9,10,9,1,0,0.9,1.0
2022,ONAGRI,CITRUMELO SACCATON,40182,IMG-00004-39.jpg,35,38,35,3,0,0.9210526315789472,1.0
2022,ONAGRI,CITRUMELO SACCATON,40182,IMG-00010-39.jpg,52,53,49,4,3,0.9245283018867924,0.9423076923076924
2022,ONAGRI,CITRUMELO SACCATON,40182,IMG-00015-39.jpg,85,90,78,12,7,0.8666666666666667,0.9176470588235294
2022,ONAGRI,CITRUMELO SACCATON,40183,IMG-00005-39.jpg,68,69,67,2,1,0.9710144927536232,0.9852941176470588
2022,ONAGRI,CITRUMELO SACCATON,40183,IMG-00009-39.jpg,57,65,57,8,0,0.8769230769230769,1.0
2022,ONAGRI,CITRUMELO SACCATON,40183,IMG-00010-39.jpg,48,50,46,4,2,0.92,0.9583333333333334
2024,KHOUALKA,CITRUS VOLKAMERIANA,50152,IMG-17274.jpg,170,124,123,1,47,0.9919354838709676,0.7235294117647059
2024,KHOUALKA,CITRUS VOLKAMERIANA,50152,IMG-17306.jpg,105,84,84,0,21,1.0,0.8
2024,KHOUALKA,CITRUS VOLKAMERIANA,50152,IMG-17330.jpg,41,27,27,0,14,1.0,0.6585365853658537
2024,KHOUALKA,CITRUS VOLKAMERIANA,50152,IMG-17335.jpg,44,29,29,0,15,1.0,0.6590909090909091
2024,KHOUALKA,CITRUS VOLKAMERIANA,50152,IMG-17340.jpg,108,72,70,2,38,0.9722222222222222,0.6481481481481481
2024,KHOUALKA,CITRUS VOLKAMERIANA,50152,IMG-17356.jpg,60,40,39,1,21,0.975,0.65
2024,KHOUALKA,CITRUS VOLKAMERIANA,50152,IMG-17384.jpg,53,30,30,0,23,1.0,0.5660377358490566
2024,KHOUALKA,CITRUS VOLKAMERIANA,50154,IMG-17440.jpg,76,60,60,0,16,1.0,0.7894736842105263
2024,KHOUALKA,CITRUS VOLKAMERIANA,50154,IMG-17490.jpg,107,67,67,0,40,1.0,0.6261682242990654
2024,KHOUALKA,CITRUS VOLKAMERIANA,50154,IMG-17543.jpg,100,69,69,0,31,1.0,0.69
2024,KHOUALKA,CITRUS VOLKAMERIANA,50154,IMG-17545.jpg,94,64,64,0,30,1.0,0.6808510638297872
2024,KHOUALKA,CITRUS VOLKAMERIANA,50154,IMG-17562.jpg,129,102,102,0,27,1.0,0.7906976744186046
2024,KHOUALKA,CITRUS VOLKAMERIANA,50154,IMG-17576.jpg,121,94,94,0,27,1.0,0.7768595041322314
2024,KHOUALKA,CITRUS VOLKAMERIANA,50154,IMG-17585.jpg,171,130,129,1,42,0.9923076923076924,0.7543859649122807
2024,KHOUALKA,CITRUS VOLKAMERIANA,50168,IMG-13980.jpg,174,129,129,0,45,1.0,0.7413793103448276
2024,KHOUALKA,CITRUS VOLKAMERIANA,50168,IMG-15749.jpg,147,119,118,1,29,0.9915966386554622,0.8027210884353742
2024,KHOUALKA,CITRUS VOLKAMERIANA,50168,IMG-15758.jpg,163,127,126,1,37,0.9921259842519684,0.7730061349693251
2024,KHOUALKA,CITRUS VOLKAMERIANA,50168,IMG-15981.jpg,210,155,155,0,55,1.0,0.7380952380952381
2024,KHOUALKA,CITRUS VOLKAMERIANA,50168,IMG-15983.jpg,120,91,91,0,29,1.0,0.7583333333333333
2024,KHOUALKA,CITRUS VOLKAMERIANA,50176,IMG-16025.jpg,81,62,62,0,19,1.0,0.7654320987654321
2024,KHOUALKA,CITRUS VOLKAMERIANA,50176,IMG-16051.jpg,85,63,63,0,22,1.0,0.7411764705882353
2024,KHOUALKA,CITRUS VOLKAMERIANA,50176,IMG-16079.jpg,161,115,115,0,46,1.0,0.7142857142857143
2024,KHOUALKA,CITRUS VOLKAMERIANA,50176,IMG-16095.jpg,101,65,65,0,36,1.0,0.6435643564356436
2024,KHOUALKA,CITRUS VOLKAMERIANA,50176,IMG-16105.jpg,43,29,29,0,14,1.0,0.6744186046511628
2022,ONAGRI,CITRUMELO SACCATON,50193,IMG-00007-39.jpg,218,239,217,22,1,0.9079497907949792,0.9954128440366972
2022,ONAGRI,CITRUMELO SACCATON,50193,IMG-00016-39.jpg,64,74,62,12,2,0.8378378378378378,0.96875
2022,ONAGRI,CITRUMELO SACCATON,50193,IMG-00018-39.jpg,115,120,111,9,4,0.925,0.9652173913043478
2022,ONAGRI,CITRUMELO SACCATON,50193,IMG-00021-39.jpg,62,60,57,3,5,0.95,0.9193548387096774
2022,ONAGRI,CITRUMELO SACCATON,50193,IMG-00023-39.jpg,113,126,112,14,1,0.8888888888888888,0.991150442477876
2022,ONAGRI,CITRUMELO SACCATON,50194,IMG-00032-39.jpg,162,168,153,15,9,0.9107142857142856,0.9444444444444444
2022,ONAGRI,CITRUMELO SACCATON,50194,IMG-00034-39.jpg,105,112,104,8,1,0.9285714285714286,0.9904761904761904
2022,ONAGRI,CITRUMELO SACCATON,50194,IMG-00036-39.jpg,161,180,155,25,6,0.8611111111111112,0.9627329192546584
2022,ONAGRI,CITRUMELO SACCATON,50194,IMG-00038-39.jpg,100,111,96,15,4,0.8648648648648649,0.96
2022,ONAGRI,CITRUMELO SACCATON,50194,IMG-00039-39.jpg,65,66,63,3,2,0.9545454545454546,0.9692307692307692
2022,ONAGRI,CITRUMELO SACCATON,50194,IMG-00041-39.jpg,153,158,149,9,4,0.9430379746835444,0.9738562091503268
2022,ONAGRI,CITRUMELO SACCATON,50194,IMG-00051-39.jpg,137,146,134,12,3,0.9178082191780822,0.978102189781022
2022,ONAGRI,CITRUMELO SACCATON,50194,IMG-00054-39.jpg,111,115,107,8,4,0.9304347826086956,0.963963963963964
2022,ONAGRI,CITRUMELO SACCATON,51091,IMG-00015-39.jpg,85,96,83,13,2,0.8645833333333334,0.976470588235294
2022,ONAGRI,CITRUMELO SACCATON,51091,IMG-00016-39.jpg,170,176,167,9,3,0.9488636363636364,0.9823529411764704
2022,ONAGRI,CITRUMELO SACCATON,51091,IMG-00018-39.jpg,185,210,184,26,1,0.8761904761904762,0.9945945945945946
2022,ONAGRI,CITRUMELO SACCATON,51091,IMG-00022-39.jpg,135,155,133,22,2,0.8580645161290322,0.9851851851851852
2022,ONAGRI,CITRUMELO SACCATON,51091,IMG-00023-39.jpg,140,142,133,9,7,0.9366197183098592,0.95
2022,ONAGRI,CITRUMELO SACCATON,51091,IMG-00026-39.jpg,149,148,143,5,6,0.9662162162162162,0.959731543624161
2022,ONAGRI,CITRUMELO SACCATON,51091,IMG-00044-39.jpg,168,178,165,13,3,0.9269662921348316,0.9821428571428572
2022,ONAGRI,CITRUMELO SACCATON,51095,IMG-00004-39.jpg,201,225,200,25,1,0.8888888888888888,0.9950248756218906
2022,ONAGRI,CITRUMELO SACCATON,51095,IMG-00013-39.jpg,154,154,145,9,9,0.9415584415584416,0.9415584415584416
2022,ONAGRI,CITRUMELO SACCATON,51095,IMG-00014-39.jpg,140,142,133,9,7,0.9366197183098592,0.95
2022,ONAGRI,CITRUMELO SACCATON,51095,IMG-00015-39.jpg,196,197,192,5,4,0.9746192893401016,0.979591836734694
2022,ONAGRI,CITRUMELO SACCATON,51095,IMG-00024-39.jpg,234,240,224,16,10,0.9333333333333332,0.9572649572649572
2022,ONAGRI,CITRUMELO SACCATON,51095,IMG-00025-39.jpg,198,211,194,17,4,0.919431279620853,0.9797979797979798
2022,ONAGRI,CITRUMELO SACCATON,51096,IMG-00009-39.jpg,219,223,211,12,8,0.9461883408071748,0.9634703196347032
2022,ONAGRI,CITRUMELO SACCATON,51096,IMG-00011-39.jpg,145,157,140,17,5,0.89171974522293,0.9655172413793104
2022,ONAGRI,CITRUMELO SACCATON,51096,IMG-00012-39.jpg,114,114,109,5,5,0.956140350877193,0.956140350877193
2022,ONAGRI,CITRUMELO SACCATON,51096,IMG-00055-39.jpg,217,215,206,9,11,0.958139534883721,0.9493087557603688
2022,ONAGRI,MC PONSIRUCE TRIFOLIATA,51097,IMG-00025-39.jpg,121,134,116,18,5,0.8656716417910447,0.9586776859504132
2022,ONAGRI,MC PONSIRUCE TRIFOLIATA,51097,IMG-00029-39.jpg,106,119,103,16,3,0.865546218487395,0.9716981132075472
2022,ONAGRI,MC PONSIRUCE TRIFOLIATA,51097,IMG-00044-39.jpg,182,194,174,20,8,0.8969072164948454,0.956043956043956
2022,ONAGRI,MC PONSIRUCE TRIFOLIATA,51098,IMG-00003-39.jpg,65,71,63,8,2,0.8873239436619719,0.9692307692307692
2022,ONAGRI,MC PONSIRUCE TRIFOLIATA,51098,IMG-00010-39.jpg,184,189,179,10,5,0.9470899470899472,0.9728260869565216
2022,ONAGRI,MC PONSIRUCE TRIFOLIATA,51098,IMG-00015-39.jpg,162,171,162,9,0,0.9473684210526316,1.0
2022,ONAGRI,MC PONSIRUCE TRIFOLIATA,51099,IMG-00012-39.jpg,133,144,130,14,3,0.9027777777777778,0.9774436090225564
2024,ONAGRI,MC PONSIRUCE TRIFOLIATA,51101,IMG-12118.jpg,177,130,129,1,48,0.9923076923076924,0.7288135593220338
2024,ONAGRI,MC PONSIRUCE TRIFOLIATA,51101,IMG-14223.jpg,153,116,116,0,37,1.0,0.7581699346405228
2024,ONAGRI,MC PONSIRUCE TRIFOLIATA,51101,IMG-14226.jpg,151,123,123,0,28,1.0,0.8145695364238411
2024,ONAGRI,MC PONSIRUCE TRIFOLIATA,51101,IMG-14255.jpg,189,153,152,1,37,0.9934640522875816,0.8042328042328042
2024,ONAGRI,MC PONSIRUCE TRIFOLIATA,51101,IMG-14281.jpg,150,125,125,0,25,1.0,0.8333333333333334
2022,ONAGRI,CITRUS VOLKAMERIANA,101020,IMG-00001.jpg,6,7,6,1,0,0.8571428571428571,1.0
2022,ONAGRI,CITRUS VOLKAMERIANA,101020,IMG-00004-44.jpg,53,49,48,1,5,0.979591836734694,0.9056603773584906
2022,ONAGRI,CITRUS VOLKAMERIANA,101030,IMG-00003-44.jpg,29,31,28,3,1,0.9032258064516128,0.9655172413793104
2022,ONAGRI,CITRUS VOLKAMERIANA,101030,IMG-00004-44.jpg,110,102,99,3,11,0.9705882352941176,0.9
2022,ONAGRI,CITRUS VOLKAMERIANA,101030,IMG-00005-44.jpg,134,126,122,4,12,0.9682539682539684,0.9104477611940298
2022,ONAGRI,CITRUS VOLKAMERIANA,101030,IMG-00017-44.jpg,79,71,70,1,9,0.9859154929577464,0.8860759493670886
2022,ONAGRI,CITRUS VOLKAMERIANA,101040,IMG-00005-44.jpg,172,163,158,5,14,0.9693251533742332,0.9186046511627908
2022,ONAGRI,CITRUS VOLKAMERIANA,101040,IMG-00009-44.jpg,131,134,127,7,4,0.9477611940298508,0.9694656488549618
2022,ONAGRI,CITRUS VOLKAMERIANA,101040,IMG-00011-44.jpg,64,64,63,1,1,0.984375,0.984375
2022,ONAGRI,CITRUS VOLKAMERIANA,101040,IMG-00012-44.jpg,139,133,127,6,12,0.9548872180451128,0.9136690647482014
2022,ONAGRI,CITRUS VOLKAMERIANA,101050,IMG-00002-44.jpg,95,96,90,6,5,0.9375,0.9473684210526316
2022,ONAGRI,CITRUS VOLKAMERIANA,101050,IMG-00005-44.jpg,59,55,55,0,4,1.0,0.9322033898305084
2022,ONAGRI,CITRUS VOLKAMERIANA,101050,IMG-00011-44.jpg,46,45,45,0,1,1.0,0.9782608695652174
2022,ONAGRI,CITRUS VOLKAMERIANA,101050,IMG-00024-44.jpg,40,40,39,1,1,0.975,0.975
2022,ONAGRI,CITRUS VOLKAMERIANA,101080,IMG-00005-44.jpg,42,39,37,2,5,0.9487179487179488,0.8809523809523809
2022,ONAGRI,CITRUS VOLKAMERIANA,101080,IMG-00006-44.jpg,79,72,70,2,9,0.9722222222222222,0.8860759493670886
2022,ONAGRI,CITRUS VOLKAMERIANA,101080,IMG-00023-44.jpg,7,6,6,0,1,1.0,0.8571428571428571
2022,ONAGRI,CITRUS VOLKAMERIANA,101080,IMG-00024-44.jpg,27,25,24,1,3,0.96,0.8888888888888888
2022,ONAGRI,CITRUS VOLKAMERIANA,101090,IMG-00003-44.jpg,66,65,62,3,4,0.953846153846154,0.9393939393939394
2022,ONAGRI,CITRUS VOLKAMERIANA,101090,IMG-00006-44.jpg,41,38,37,1,4,0.9736842105263158,0.902439024390244
2022,ONAGRI,CITRUS VOLKAMERIANA,101090,IMG-00019-44.jpg,35,36,34,2,1,0.9444444444444444,0.9714285714285714
2022,ONAGRI,CITRUS VOLKAMERIANA,101090,IMG-00020-44.jpg,42,43,40,3,2,0.9302325581395348,0.9523809523809524
2022,KHOUALKA,CITRANGE CARRIZO,102130,IMG-00001.jpg,5,3,3,0,2,1.0,0.6
2022,KHOUALKA,CITRANGE CARRIZO,102130,IMG-00004-43.jpg,24,20,20,0,4,1.0,0.8333333333333334
2022,KHOUALKA,CITRANGE CARRIZO,102130,IMG-00019-43.jpg,33,32,31,1,2,0.96875,0.9393939393939394
2022,KHOUALKA,CITRANGE CARRIZO,102130,IMG-00020-43.jpg,18,24,17,7,1,0.7083333333333334,0.9444444444444444
2022,KHOUALKA,MACROPHYLLA,201180,IMG-00007-43.jpg,38,40,38,2,0,0.95,1.0
2022,KHOUALKA,MACROPHYLLA,201180,IMG-00011-43.jpg,64,65,61,4,3,0.9384615384615383,0.953125
2022,KHOUALKA,MACROPHYLLA,201180,IMG-00019-43.jpg,64,62,61,1,3,0.9838709677419356,0.953125
2022,KHOUALKA,MACROPHYLLA,201180,IMG-00020-43.jpg,43,43,40,3,3,0.9302325581395348,0.9302325581395348
2022,KHOUALKA,MACROPHYLLA,201190,IMG-00004-43.jpg,101,78,76,2,25,0.9743589743589745,0.7524752475247525
2022,KHOUALKA,MACROPHYLLA,201190,IMG-00010-43.jpg,90,84,79,5,11,0.9404761904761904,0.8777777777777778
2022,KHOUALKA,MACROPHYLLA,201190,IMG-00011-43.jpg,134,116,109,7,25,0.9396551724137931,0.8134328358208955
2022,KHOUALKA,MACROPHYLLA,201190,IMG-00020-43.jpg,95,71,68,3,27,0.9577464788732394,0.7157894736842105
2022,KHOUALKA,CITRUS VOLKAMERIANA,201210,IMG-00011-43.jpg,103,99,99,0,4,1.0,0.9611650485436892
2022,KHOUALKA,CITRUS VOLKAMERIANA,201210,IMG-00012-43.jpg,42,40,40,0,2,1.0,0.9523809523809524
2022,KHOUALKA,CITRUS VOLKAMERIANA,201210,IMG-00015-43.jpg,77,73,72,1,5,0.9863013698630136,0.935064935064935
2022,KHOUALKA,CITRUS VOLKAMERIANA,201210,IMG-00019-43.jpg,31,30,30,0,1,1.0,0.967741935483871
2022,KHOUALKA,BIGARADIER,201320,IMG-00006-43.jpg,87,79,76,3,11,0.9620253164556962,0.8735632183908046
2022,KHOUALKA,BIGARADIER,201320,IMG-00016-43.jpg,97,96,93,3,4,0.96875,0.9587628865979382
2022,KHOUALKA,BIGARADIER,201320,IMG-00017-43.jpg,49,46,46,0,3,1.0,0.9387755102040816
2022,KHOUALKA,BIGARADIER,201320,IMG-00020-43.jpg,88,87,86,1,2,0.9885057471264368,0.9772727272727272
2022,ONAGRI,BIGARADIER,201390,IMG-00008-44.jpg,62,61,59,2,3,0.9672131147540984,0.9516129032258064
2022,ONAGRI,BIGARADIER,201390,IMG-00011-44.jpg,90,85,82,3,8,0.9647058823529412,0.9111111111111112
2022,ONAGRI,BIGARADIER,201390,IMG-00013-44.jpg,77,75,74,1,3,0.9866666666666668,0.961038961038961
2022,ONAGRI,BIGARADIER,201390,IMG-00016-44.jpg,69,64,62,2,7,0.96875,0.8985507246376812
2022,KHOUALKA,CITRUS VOLKAMERIANA,202050,IMG-00006-43.jpg,89,87,85,2,4,0.9770114942528736,0.9550561797752808
2022,KHOUALKA,CITRUS VOLKAMERIANA,202050,IMG-00010-43.jpg,94,88,88,0,6,1.0,0.9361702127659576
2022,KHOUALKA,CITRUS VOLKAMERIANA,202050,IMG-00011-43.jpg,151,151,148,3,3,0.9801324503311258,0.9801324503311258
2022,KHOUALKA,CITRUS VOLKAMERIANA,202050,IMG-00020-43.jpg,129,122,122,0,7,1.0,0.9457364341085271
2022,KHOUALKA,CITRUS VOLKAMERIANA,202070,IMG-00006-43.jpg,68,68,68,0,0,1.0,1.0
2022,KHOUALKA,CITRUS VOLKAMERIANA,202070,IMG-00009-43.jpg,120,122,118,4,2,0.9672131147540984,0.9833333333333332
2022,KHOUALKA,CITRUS VOLKAMERIANA,202070,IMG-00013-43.jpg,95,89,88,1,7,0.9887640449438202,0.9263157894736842
2022,KHOUALKA,CITRUS VOLKAMERIANA,202070,IMG-00019-43.jpg,57,57,55,2,2,0.9649122807017544,0.9649122807017544
2022,KHOUALKA,CITRUS VOLKAMERIANA,202080,IMG-00005-43.jpg,65,64,63,1,2,0.984375,0.9692307692307692
2022,KHOUALKA,CITRUS VOLKAMERIANA,202080,IMG-00008-43.jpg,31,30,30,0,1,1.0,0.967741935483871
2022,KHOUALKA,CITRUS VOLKAMERIANA,202080,IMG-00015-43.jpg,220,221,216,5,4,0.9773755656108596,0.9818181818181818
2022,KHOUALKA,CITRUS VOLKAMERIANA,202080,IMG-00016-43.jpg,131,132,130,2,1,0.9848484848484848,0.9923664122137404
2022,KHOUALKA,CITRANGE CARRIZO,301380,IMG-00007-43.jpg,30,29,27,2,3,0.9310344827586208,0.9
2022,KHOUALKA,CITRANGE CARRIZO,301380,IMG-00011-43.jpg,53,56,53,3,0,0.9464285714285714,1.0
2022,KHOUALKA,CITRANGE CARRIZO,301380,IMG-00014-43.jpg,7,9,7,2,0,0.7777777777777778,1.0
2022,KHOUALKA,CITRANGE CARRIZO,301380,IMG-00020-43.jpg,91,95,86,9,5,0.9052631578947368,0.945054945054945
2022,ONAGRI,CITRUS VOLKAMERIANA,301470,IMG-00003-44.jpg,148,150,142,8,6,0.9466666666666668,0.9594594594594594
2022,ONAGRI,CITRUS VOLKAMERIANA,301470,IMG-00004-44.jpg,163,162,148,14,15,0.9135802469135802,0.9079754601226994
2022,ONAGRI,CITRUS VOLKAMERIANA,301470,IMG-00005-44.jpg,160,145,140,5,20,0.9655172413793104,0.875
2022,ONAGRI,CITRUS VOLKAMERIANA,301480,IMG-00001.jpg,92,83,83,0,9,1.0,0.9021739130434784
2022,ONAGRI,CITRUS VOLKAMERIANA,301480,IMG-00003-43.jpg,26,25,25,0,1,1.0,0.9615384615384616
2022,ONAGRI,CITRUS VOLKAMERIANA,301480,IMG-00012-43.jpg,50,46,45,1,5,0.9782608695652174,0.9
2022,ONAGRI,CITRUS VOLKAMERIANA,301480,IMG-00014-43.jpg,77,69,69,0,8,1.0,0.8961038961038961
2022,ONAGRI,CITRUS VOLKAMERIANA,301490,IMG-00005-44.jpg,108,88,85,3,23,0.9659090909090908,0.7870370370370371
2022,ONAGRI,CITRUS VOLKAMERIANA,301490,IMG-00009-44.jpg,185,167,157,10,28,0.940119760479042,0.8486486486486486
2022,ONAGRI,CITRUS VOLKAMERIANA,301490,IMG-00012-44.jpg,162,147,144,3,18,0.979591836734694,0.8888888888888888
2022,ONAGRI,CITRUS VOLKAMERIANA,301490,IMG-00015-44.jpg,109,104,97,7,12,0.9326923076923076,0.8899082568807339
2022,ONAGRI,CITRUS VOLKAMERIANA,301510,IMG-00001.jpg,252,233,225,8,27,0.965665236051502,0.8928571428571429
2022,ONAGRI,CITRUS VOLKAMERIANA,301510,IMG-00006-44.jpg,137,132,126,6,11,0.9545454545454546,0.9197080291970804
2022,ONAGRI,CITRUS VOLKAMERIANA,301510,IMG-00007-44.jpg,115,119,105,14,10,0.8823529411764706,0.9130434782608696
2022,ONAGRI,CITRUS VOLKAMERIANA,301510,IMG-00008-44.jpg,150,137,128,9,22,0.9343065693430656,0.8533333333333334
2022,ONAGRI,BIGARADIER,301550,IMG-00008-44.jpg,144,137,132,5,12,0.9635036496350364,0.9166666666666666
2022,ONAGRI,BIGARADIER,301550,IMG-00011-44.jpg,40,39,38,1,2,0.9743589743589745,0.95
2022,ONAGRI,BIGARADIER,301550,IMG-00013-44.jpg,76,69,68,1,8,0.9855072463768116,0.8947368421052632
2022,ONAGRI,BIGARADIER,301550,IMG-00014-44.jpg,80,82,77,5,3,0.9390243902439024,0.9625
2022,ONAGRI,CITRUS VOLKAMERIANA,301570,IMG-00004-44.jpg,158,151,145,6,13,0.9602649006622516,0.9177215189873418
2022,ONAGRI,CITRUS VOLKAMERIANA,301570,IMG-00007-44.jpg,152,133,132,1,20,0.9924812030075189,0.868421052631579
2022,ONAGRI,CITRUS VOLKAMERIANA,301570,IMG-00008-44.jpg,103,96,84,12,19,0.875,0.8155339805825242
2022,ONAGRI,CITRUS VOLKAMERIANA,301570,IMG-00017-44.jpg,218,206,198,8,20,0.9611650485436892,0.908256880733945
2022,KHOUALKA,CITRUS VOLKAMERIANA,302340,IMG-00004-43.jpg,106,96,96,0,10,1.0,0.9056603773584906
2022,KHOUALKA,CITRUS VOLKAMERIANA,302340,IMG-00005-43.jpg,105,91,90,1,15,0.989010989010989,0.8571428571428571
2022,KHOUALKA,CITRUS VOLKAMERIANA,302340,IMG-00011-43.jpg,75,71,71,0,4,1.0,0.9466666666666668
2022,KHOUALKA,CITRUS VOLKAMERIANA,302340,IMG-00015-43.jpg,92,86,84,2,8,0.9767441860465116,0.9130434782608696
2022,KHOUALKA,CITRUS VOLKAMERIANA,302350,IMG-00008-43.jpg,33,32,32,0,1,1.0,0.9696969696969696
2022,KHOUALKA,CITRUS VOLKAMERIANA,302350,IMG-00013-43.jpg,80,75,72,3,8,0.96,0.9
2022,KHOUALKA,CITRUS VOLKAMERIANA,302350,IMG-00014-43.jpg,76,71,69,2,7,0.971830985915493,0.9078947368421052
2022,KHOUALKA,CITRUS VOLKAMERIANA,302350,IMG-00018-43.jpg,44,43,43,0,1,1.0,0.9772727272727272
2022,KHOUALKA,CITRUS VOLKAMERIANA,302360,IMG-00005-43.jpg,97,92,90,2,7,0.9782608695652174,0.9278350515463918
2022,KHOUALKA,CITRUS VOLKAMERIANA,302360,IMG-00006-43.jpg,118,115,112,3,6,0.9739130434782608,0.9491525423728814
2022,KHOUALKA,CITRUS VOLKAMERIANA,302360,IMG-00016-43.jpg,67,67,67,0,0,1.0,1.0
2022,KHOUALKA,CITRUS VOLKAMERIANA,302360,IMG-00021-43.jpg,65,68,63,5,2,0.9264705882352942,0.9692307692307692
2022,KHOUALKA,CITRUS VOLKAMERIANA,302510,IMG-00001.jpg,73,62,60,2,13,0.967741935483871,0.821917808219178
2022,KHOUALKA,CITRUS VOLKAMERIANA,302510,IMG-00002-43.jpg,44,38,36,2,8,0.9473684210526316,0.8181818181818182
2022,KHOUALKA,CITRUS VOLKAMERIANA,302510,IMG-00003-43.jpg,78,75,75,0,3,1.0,0.9615384615384616
2022,KHOUALKA,CITRUS VOLKAMERIANA,302510,IMG-00015-43.jpg,49,35,35,0,14,1.0,0.7142857142857143
2022,KHOUALKA,BIGARADIER,401410,IMG-00093-43.jpg,35,28,28,0,7,1.0,0.8
2022,KHOUALKA,BIGARADIER,401410,IMG-00099-43.jpg,6,6,6,0,0,1.0,1.0
2022,KHOUALKA,BIGARADIER,401410,IMG-00102-43.jpg,78,69,69,0,9,1.0,0.8846153846153846
2022,KHOUALKA,BIGARADIER,401410,IMG-00104-43.jpg,81,69,66,3,15,0.9565217391304348,0.8148148148148148
2022,ONAGRI,CITRANGE C35,401660,IMG-00001.jpg,56,55,52,3,4,0.9454545454545454,0.9285714285714286
2022,ONAGRI,CITRANGE C35,401660,IMG-00008-44.jpg,42,39,39,0,3,1.0,0.9285714285714286
2022,ONAGRI,CITRANGE C35,401660,IMG-00010-44.jpg,29,30,29,1,0,0.9666666666666668,1.0
2022,ONAGRI,CITRANGE C35,401660,IMG-00016-44.jpg,64,63,60,3,4,0.9523809523809524,0.9375
2022,ONAGRI,CITRANGE C35,401710,IMG-00003-44.jpg,51,48,48,0,3,1.0,0.9411764705882352
2022,ONAGRI,CITRANGE C35,401710,IMG-00012-44.jpg,19,19,19,0,0,1.0,1.0
2022,ONAGRI,CITRANGE C35,401710,IMG-00013-44.jpg,33,29,28,1,5,0.9655172413793104,0.8484848484848485
2022,ONAGRI,CITRANGE C35,401710,IMG-00019-44.jpg,76,74,74,0,2,1.0,0.9736842105263158
2022,ONAGRI,CITRANGE C35,401720,IMG-00007-44.jpg,93,95,93,2,0,0.9789473684210528,1.0
2022,ONAGRI,CITRANGE C35,401720,IMG-00008-44.jpg,38,35,35,0,3,1.0,0.9210526315789472
2022,ONAGRI,CITRANGE C35,401720,IMG-00010-44.jpg,50,42,41,1,9,0.9761904761904762,0.82
2022,ONAGRI,CITRANGE C35,401720,IMG-00017-44.jpg,68,65,63,2,5,0.9692307692307692,0.9264705882352942
2022,ONAGRI,CITRANGE C35,401730,IMG-00001.jpg,19,19,19,0,0,1.0,1.0
2022,ONAGRI,CITRANGE C35,401730,IMG-00010-44.jpg,50,50,50,0,0,1.0,1.0
2022,ONAGRI,CITRANGE C35,401730,IMG-00013-44.jpg,75,72,72,0,3,1.0,0.96
2022,ONAGRI,CITRANGE C35,401730,IMG-00016-44.jpg,36,33,33,0,3,1.0,0.9166666666666666
2022,ONAGRI,CITRANGE C35,401750,IMG-00005-44.jpg,88,84,79,5,9,0.9404761904761904,0.8977272727272727
2022,ONAGRI,CITRANGE C35,401750,IMG-00009-44.jpg,127,120,117,3,10,0.975,0.9212598425196852
2022,ONAGRI,CITRANGE C35,401750,IMG-00016-44.jpg,107,98,95,3,12,0.9693877551020408,0.8878504672897196
2022,ONAGRI,CITRANGE C35,401750,IMG-00024-44.jpg,50,50,46,4,4,0.92,0.92
2022,ONAGRI,CITRUMELO SACCATON,401770,IMG-00003-44.jpg,24,24,22,2,2,0.9166666666666666,0.9166666666666666
2022,ONAGRI,CITRUMELO SACCATON,401770,IMG-00008-44.jpg,72,73,71,2,1,0.9726027397260274,0.9861111111111112
2022,ONAGRI,CITRUMELO SACCATON,401770,IMG-00009-44.jpg,14,14,13,1,1,0.9285714285714286,0.9285714285714286
2022,ONAGRI,CITRUMELO SACCATON,401770,IMG-00017-44.jpg,20,16,16,0,4,1.0,0.8
2022,KHOUALKA,BIGARADIER,402440,IMG-00005-43.jpg,17,13,12,1,5,0.9230769230769232,0.7058823529411765
2022,KHOUALKA,BIGARADIER,402440,IMG-00012-43.jpg,46,43,43,0,3,1.0,0.9347826086956522
2022,KHOUALKA,BIGARADIER,402440,IMG-00014-43.jpg,11,10,10,0,1,1.0,0.9090909090909092
2022,KHOUALKA,BIGARADIER,402440,IMG-00015-43.jpg,22,15,15,0,7,1.0,0.6818181818181818
2022,KHOUALKA,BIGARADIER,402590,IMG-00007-43.jpg,104,96,92,4,12,0.9583333333333334,0.8846153846153846
2022,KHOUALKA,BIGARADIER,402590,IMG-00012-43.jpg,45,45,43,2,2,0.9555555555555556,0.9555555555555556
2022,KHOUALKA,BIGARADIER,402590,IMG-00015-43.jpg,58,57,56,1,2,0.9824561403508772,0.9655172413793104
2022,KHOUALKA,BIGARADIER,402590,IMG-00019-43.jpg,64,62,62,0,2,1.0,0.96875
2022,KHOUALKA,CITRUS VOLKAMERIANA,501520,IMG-00004-43.jpg,39,37,37,0,2,1.0,0.9487179487179488
2022,KHOUALKA,CITRUS VOLKAMERIANA,501520,IMG-00007-43.jpg,43,38,38,0,5,1.0,0.8837209302325582
2022,KHOUALKA,CITRUS VOLKAMERIANA,501520,IMG-00015-43.jpg,18,13,13,0,5,1.0,0.7222222222222222
2022,KHOUALKA,CITRUS VOLKAMERIANA,501520,IMG-00020-43.jpg,48,43,43,0,5,1.0,0.8958333333333334
2022,KHOUALKA,CITRUS VOLKAMERIANA,501540,IMG-00006-43.jpg,38,37,36,1,2,0.972972972972973,0.9473684210526316
2022,KHOUALKA,CITRUS VOLKAMERIANA,501540,IMG-00012-43.jpg,102,97,97,0,5,1.0,0.9509803921568628
2022,KHOUALKA,CITRUS VOLKAMERIANA,501540,IMG-00017-43.jpg,138,131,130,1,8,0.9923664122137404,0.9420289855072465
2022,KHOUALKA,CITRUS VOLKAMERIANA,501540,IMG-00018-43.jpg,51,49,48,1,3,0.979591836734694,0.9411764705882352
2022,KHOUALKA,CITRUS VOLKAMERIANA,501660,IMG-00006-43.jpg,60,60,59,1,1,0.9833333333333332,0.9833333333333332
2022,KHOUALKA,CITRUS VOLKAMERIANA,501660,IMG-00016-43.jpg,63,61,58,3,5,0.9508196721311476,0.9206349206349206
2022,KHOUALKA,CITRUS VOLKAMERIANA,501660,IMG-00018-43.jpg,112,105,101,4,11,0.961904761904762,0.9017857142857144
2022,KHOUALKA,CITRUS VOLKAMERIANA,501660,IMG-00021-43.jpg,90,92,89,3,1,0.967391304347826,0.9888888888888888
2022,KHOUALKA,CITRUS VOLKAMERIANA,501680,IMG-00005-43.jpg,179,162,159,3,20,0.9814814814814816,0.888268156424581
2022,KHOUALKA,CITRUS VOLKAMERIANA,501680,IMG-00011-43.jpg,101,78,78,0,23,1.0,0.7722772277227723
2022,KHOUALKA,CITRUS VOLKAMERIANA,501680,IMG-00012-43.jpg,76,57,54,3,22,0.9473684210526316,0.7105263157894737
2022,KHOUALKA,CITRUS VOLKAMERIANA,501680,IMG-00016-43.jpg,113,98,97,1,16,0.9897959183673468,0.8584070796460177
2022,KHOUALKA,CITRUS VOLKAMERIANA,501690,IMG-00032-43.jpg,34,25,24,1,10,0.96,0.7058823529411765
2022,KHOUALKA,CITRUS VOLKAMERIANA,501690,IMG-00039-43.jpg,186,157,154,3,32,0.9808917197452228,0.8279569892473119
2022,KHOUALKA,CITRUS VOLKAMERIANA,501690,IMG-00047-43.jpg,103,80,80,0,23,1.0,0.7766990291262136
2022,KHOUALKA,CITRUS VOLKAMERIANA,501690,IMG-00049-43.jpg,166,148,145,3,21,0.9797297297297296,0.8734939759036144
2022,KHOUALKA,CITRUS VOLKAMERIANA,501760,IMG-00001.jpg,94,52,52,0,42,1.0,0.5531914893617021
2022,KHOUALKA,CITRUS VOLKAMERIANA,501760,IMG-00034-43.jpg,45,27,27,0,18,1.0,0.6
2022,KHOUALKA,CITRUS VOLKAMERIANA,501760,IMG-00036-43.jpg,40,26,26,0,14,1.0,0.65
2022,KHOUALKA,CITRUS VOLKAMERIANA,501760,IMG-00051-43.jpg,92,70,69,1,23,0.9857142857142858,0.75
2022,ONAGRI,CITRUMELO SACCATON,510910,IMG-00004-44.jpg,73,72,70,2,3,0.9722222222222222,0.958904109589041
2022,ONAGRI,CITRUMELO SACCATON,510910,IMG-00008-44.jpg,152,135,134,1,18,0.9925925925925926,0.881578947368421
2022,ONAGRI,CITRUMELO SACCATON,510910,IMG-00010-44.jpg,107,101,100,1,7,0.99009900990099,0.9345794392523364
2022,ONAGRI,CITRUMELO SACCATON,510910,IMG-00011-44.jpg,92,88,87,1,5,0.9886363636363636,0.9456521739130436
2022,ONAGRI,CITRUMELO SACCATON,510950,IMG-00006-44.jpg,70,65,65,0,5,1.0,0.9285714285714286
2022,ONAGRI,CITRUMELO SACCATON,510950,IMG-00008-44.jpg,75,73,72,1,3,0.9863013698630136,0.96
2022,ONAGRI,CITRUMELO SACCATON,510950,IMG-00009-44.jpg,85,82,82,0,3,1.0,0.9647058823529412
2022,ONAGRI,CITRUMELO SACCATON,510950,IMG-00011-44.jpg,135,132,130,2,5,0.9848484848484848,0.9629629629629628
2022,ONAGRI,MC PONSIRUCE TRIFOLIATA,510980,IMG-00014-44.jpg,67,66,65,1,2,0.9848484848484848,0.9701492537313432
2022,ONAGRI,MC PONSIRUCE TRIFOLIATA,510980,IMG-00015-44.jpg,51,48,47,1,4,0.9791666666666666,0.9215686274509804
2022,ONAGRI,MC PONSIRUCE TRIFOLIATA,510980,IMG-00016-44.jpg,99,90,87,3,12,0.9666666666666668,0.8787878787878788
2022,ONAGRI,MC PONSIRUCE TRIFOLIATA,510980,IMG-00019-44.jpg,102,88,87,1,15,0.9886363636363636,0.8529411764705882
2022,ONAGRI,MC PONSIRUCE TRIFOLIATA,510990,IMG-00006-44.jpg,135,113,112,1,23,0.991150442477876,0.8296296296296296
2022,ONAGRI,MC PONSIRUCE TRIFOLIATA,510990,IMG-00008-44.jpg,110,108,104,4,6,0.9629629629629628,0.9454545454545454
2022,ONAGRI,MC PONSIRUCE TRIFOLIATA,510990,IMG-00009-44.jpg,85,73,72,1,13,0.9863013698630136,0.8470588235294118
2022,ONAGRI,MC PONSIRUCE TRIFOLIATA,510990,IMG-00024-44.jpg,65,58,57,1,8,0.9827586206896552,0.8769230769230769
2022,ONAGRI,MC PONSIRUCE TRIFOLIATA,511030,IMG-00007-44.jpg,100,84,84,0,16,1.0,0.84
2022,ONAGRI,MC PONSIRUCE TRIFOLIATA,511030,IMG-00016-44.jpg,63,61,59,2,4,0.9672131147540984,0.9365079365079364
2022,ONAGRI,MC PONSIRUCE TRIFOLIATA,511030,IMG-00022-44.jpg,98,90,86,4,12,0.9555555555555556,0.8775510204081632
2022,ONAGRI,MC PONSIRUCE TRIFOLIATA,511030,IMG-00027-44.jpg,82,78,77,1,5,0.9871794871794872,0.9390243902439024
2022,ONAGRI,MS PONSIRUCE TRIFOLIATA,511040,IMG-00004-44.jpg,77,68,68,0,9,1.0,0.8831168831168831
2022,ONAGRI,MS PONSIRUCE TRIFOLIATA,511040,IMG-00014-44.jpg,48,38,37,1,11,0.9736842105263158,0.7708333333333334
2022,ONAGRI,MS PONSIRUCE TRIFOLIATA,511040,IMG-00016-44.jpg,71,69,67,2,4,0.9710144927536232,0.943661971830986
2022,ONAGRI,MS PONSIRUCE TRIFOLIATA,511040,IMG-00025-44.jpg,56,48,45,3,11,0.9375,0.8035714285714286
2022,ONAGRI,FUZHU,511050,IMG-00004-44.jpg,109,106,101,5,8,0.9528301886792452,0.926605504587156
2022,ONAGRI,FUZHU,511050,IMG-00006-44.jpg,142,135,132,3,10,0.9777777777777776,0.9295774647887324
2022,ONAGRI,FUZHU,511050,IMG-00011-44.jpg,172,166,165,1,7,0.993975903614458,0.9593023255813954
2022,ONAGRI,FUZHU,511050,IMG-00022-44.jpg,194,180,179,1,15,0.9944444444444444,0.922680412371134
2022,ONAGRI,MS PONSIRUCE TRIFOLIATA,511060,IMG-00007-44.jpg,115,109,105,4,10,0.963302752293578,0.9130434782608696
2022,ONAGRI,MS PONSIRUCE TRIFOLIATA,511060,IMG-00016-44.jpg,102,89,85,4,17,0.9550561797752808,0.8333333333333334
2022,ONAGRI,MS PONSIRUCE TRIFOLIATA,511060,IMG-00017-44.jpg,59,47,46,1,13,0.9787234042553192,0.7796610169491526
2022,ONAGRI,MS PONSIRUCE TRIFOLIATA,511060,IMG-00019-44.jpg,108,91,88,3,20,0.967032967032967,0.8148148148148148
2022,ONAGRI,FUZHU,511070,IMG-00006-44.jpg,82,78,78,0,4,1.0,0.951219512195122
2022,ONAGRI,FUZHU,511070,IMG-00016-44.jpg,96,96,93,3,3,0.96875,0.96875
2022,ONAGRI,FUZHU,511070,IMG-00018-44.jpg,93,88,87,1,6,0.9886363636363636,0.935483870967742
2022,ONAGRI,FUZHU,511070,IMG-00019-44.jpg,142,136,133,3,9,0.9779411764705882,0.9366197183098592
