compagnie,Domaine,Porte-greffe,parcelle,Filename,True_count,detect_count,TP,FP,FN,Precision,Recall
2022,SAOUDA,BIGARADIER,10010,IMG-00011-45.jpg,28,37,28,9,0,0.7567567567567568,1.0
2022,SAOUDA,BIGARADIER,10010,IMG-00012-45.jpg,27,34,26,8,1,0.7647058823529411,0.9629629629629628
2022,SAOUDA,BIGARADIER,10010,IMG-00014-45.jpg,50,64,50,14,0,0.78125,1.0
2022,SAOUDA,BIGARADIER,10010,IMG-00018-45.jpg,30,35,29,6,1,0.8285714285714286,0.9666666666666668
2022,SAOUDA,BIGARADIER,10010,IMG-00020-45.jpg,31,41,31,10,0,0.7560975609756098,1.0
2024,SAOUDA,BIGARADIER,10010,IMG-23410.jpg,85,26,24,2,61,0.9230769230769232,0.2823529411764706
2024,SAOUDA,BIGARADIER,10010,IMG-23417.jpg,86,36,35,1,51,0.9722222222222222,0.4069767441860465
2024,SAOUDA,BIGARADIER,10010,IMG-23430.jpg,74,38,37,1,37,0.9736842105263158,0.5
2024,SAOUDA,BIGARADIER,10010,IMG-23647.jpg,95,42,42,0,53,1.0,0.4421052631578947
2024,SAOUDA,BIGARADIER,10010,IMG-23672.jpg,47,9,9,0,38,1.0,0.1914893617021277
2024,SAOUDA,BIGARADIER,10010,IMG-23707.jpg,30,12,12,0,18,1.0,0.4
2024,SAOUDA,BIGARADIER,10010,IMG-23709.jpg,31,11,11,0,20,1.0,0.3548387096774194
2024,SAOUDA,BIGARADIER,10010,IMG-23711.jpg,79,24,22,2,57,0.9166666666666666,0.2784810126582278
2022,SAOUDA,MACROPHYLLA,10030,IMG-00158-45.jpg,101,139,99,40,2,0.7122302158273381,0.9801980198019802
2022,SAOUDA,MACROPHYLLA,10030,IMG-00159-45.jpg,155,194,152,42,3,0.7835051546391752,0.9806451612903224
2022,SAOUDA,MACROPHYLLA,10030,IMG-00162-45.jpg,119,144,115,29,4,0.7986111111111112,0.9663865546218487
2022,SAOUDA,MACROPHYLLA,10030,IMG-00169-45.jpg,72,90,68,22,4,0.7555555555555555,0.9444444444444444
2022,SAOUDA,MACROPHYLLA,10031,IMG-00002-45.jpg,46,54,45,9,1,0.8333333333333334,0.9782608695652174
2022,SAOUDA,MACROPHYLLA,10031,IMG-00084-45.jpg,41,51,41,10,0,0.803921568627451,1.0
2022,SAOUDA,MACROPHYLLA,10031,IMG-00450-45.jpg,27,39,26,13,1,0.6666666666666666,0.9629629629629628
2022,SAOUDA,MACROPHYLLA,10031,IMG-00451-45.jpg,34,47,33,14,1,0.7021276595744681,0.9705882352941176
2022,SAOUDA,MACROPHYLLA,10031,IMG-00464-45.jpg,33,38,31,7,2,0.8157894736842105,0.9393939393939394
2022,ONAGRI,CITRUS VOLKAMERIANA,10101,IMG-00003-39.jpg,120,124,114,10,6,0.9193548387096774,0.95
2022,ONAGRI,CITRUS VOLKAMERIANA,10101,IMG-00010-39.jpg,85,83,78,5,7,0.9397590361445785,0.9176470588235294
2024,ONAGRI,CITRUS VOLKAMERIANA,10101,IMG-10523.jpg,288,231,231,0,57,1.0,0.8020833333333334
2024,ONAGRI,CITRUS VOLKAMERIANA,10101,IMG-10545.jpg,98,77,76,1,22,0.987012987012987,0.7755102040816326
2024,ONAGRI,CITRUS VOLKAMERIANA,10101,IMG-10558.jpg,143,105,101,4,42,0.961904761904762,0.7062937062937062
2022,ONAGRI,CITRUS VOLKAMERIANA,10102,IMG-00003-39.jpg,48,43,40,3,8,0.9302325581395348,0.8333333333333334
2024,ONAGRI,CITRUS VOLKAMERIANA,10102,IMG-10637.jpg,140,111,110,1,30,0.990990990990991,0.7857142857142857
2024,ONAGRI,CITRUS VOLKAMERIANA,10102,IMG-10658.jpg,163,130,127,3,36,0.9769230769230768,0.7791411042944786
2022,ONAGRI,CITRUS VOLKAMERIANA,10103,IMG-00003-39.jpg,215,201,194,7,21,0.965174129353234,0.9023255813953488
2022,ONAGRI,CITRUS VOLKAMERIANA,10103,IMG-00008-39.jpg,195,192,178,14,17,0.9270833333333334,0.9128205128205128
2024,ONAGRI,CITRUS VOLKAMERIANA,10103,IMG-10614.jpg,134,110,108,2,26,0.9818181818181818,0.8059701492537313
2024,ONAGRI,CITRUS VOLKAMERIANA,10103,IMG-10630.jpg,213,173,171,2,42,0.9884393063583816,0.8028169014084507
2024,ONAGRI,CITRUS VOLKAMERIANA,10103,IMG-10631.jpg,134,95,94,1,40,0.9894736842105264,0.7014925373134329
2022,ONAGRI,CITRUS VOLKAMERIANA,10104,IMG-00004-39.jpg,65,66,59,7,6,0.8939393939393939,0.9076923076923076
2022,ONAGRI,CITRUS VOLKAMERIANA,10104,IMG-00008-39.jpg,69,68,60,8,9,0.8823529411764706,0.8695652173913043
2024,ONAGRI,CITRUS VOLKAMERIANA,10104,IMG-11267.jpg,22,14,14,0,8,1.0,0.6363636363636364
2024,ONAGRI,CITRUS VOLKAMERIANA,10104,IMG-11327.jpg,128,99,97,2,31,0.9797979797979798,0.7578125
2024,ONAGRI,CITRUS VOLKAMERIANA,10104,IMG-11347.jpg,118,97,94,3,24,0.9690721649484536,0.7966101694915254
2024,ONAGRI,CITRUS VOLKAMERIANA,10104,IMG-11366.jpg,351,258,253,5,98,0.9806201550387597,0.7207977207977208
2024,ONAGRI,CITRUS VOLKAMERIANA,10104,IMG-11386.jpg,99,74,73,1,26,0.9864864864864864,0.7373737373737373
2022,ONAGRI,CITRUS VOLKAMERIANA,10105,IMG-00004-39.jpg,17,19,15,4,2,0.7894736842105263,0.8823529411764706
2022,ONAGRI,CITRUS VOLKAMERIANA,10105,IMG-00005-39.jpg,68,67,63,4,5,0.9402985074626866,0.9264705882352942
2022,ONAGRI,CITRUS VOLKAMERIANA,10108,IMG-00003-39.jpg,61,54,52,2,9,0.9629629629629628,0.8524590163934426
2022,ONAGRI,CITRUS VOLKAMERIANA,10108,IMG-00007-39.jpg,69,60,60,0,9,1.0,0.8695652173913043
2022,ONAGRI,CITRUS VOLKAMERIANA,10109,IMG-00003-39.jpg,4,4,4,0,0,1.0,1.0
2022,ONAGRI,CITRUS VOLKAMERIANA,10109,IMG-00008-39.jpg,105,105,97,8,8,0.923809523809524,0.923809523809524
2022,KHOUALKA,CITRANGE CARRIZO,10213,IMG-00001.jpg,77,82,74,8,3,0.902439024390244,0.961038961038961
2022,KHOUALKA,CITRANGE CARRIZO,10213,IMG-00005-40.jpg,73,76,71,5,2,0.9342105263157896,0.9726027397260274
2022,KHOUALKA,CITRANGE CARRIZO,10213,IMG-00009-40.jpg,14,19,14,5,0,0.7368421052631579,1.0
2022,KHOUALKA,CITRANGE CARRIZO,10213,IMG-00014-40.jpg,21,24,19,5,2,0.7916666666666666,0.9047619047619048
2022,KHOUALKA,CITRANGE CARRIZO,10213,IMG-00028-40.jpg,47,47,45,2,2,0.9574468085106383,0.9574468085106383
2022,KHOUALKA,CITRANGE CARRIZO,10213,IMG-00034-40.jpg,48,50,46,4,2,0.92,0.9583333333333334
2022,KHOUALKA,CITRANGE CARRIZO,10213,IMG-00035-40.jpg,37,38,36,2,1,0.9473684210526316,0.972972972972973
2022,KHOUALKA,CITRANGE CARRIZO,10213,IMG-00036-40.jpg,47,53,47,6,0,0.8867924528301887,1.0
2022,KHOUALKA,CITRANGE CARRIZO,10213,IMG-00042-40.jpg,22,23,21,2,1,0.9130434782608696,0.9545454545454546
2022,KHOUALKA,CITRANGE CARRIZO,10213,IMG-00047-40.jpg,70,69,68,1,2,0.9855072463768116,0.9714285714285714
2022,KHOUALKA,CITRANGE CARRIZO,10213,IMG-00054-40.jpg,33,38,32,6,1,0.8421052631578947,0.9696969696969696
2022,KHOUALKA,CITRANGE CARRIZO,10213,IMG-00055-40.jpg,93,91,88,3,5,0.967032967032967,0.946236559139785
2022,KHOUALKA,CITRANGE CARRIZO,10213,IMG-00061-40.jpg,113,120,110,10,3,0.9166666666666666,0.9734513274336284
2022,KHOUALKA,CITRANGE CARRIZO,10213,IMG-00066-40.jpg,48,48,42,6,6,0.875,0.875
2024,KHOUALKA,CITRANGE CARRIZO,10213,IMG-12628.jpg,119,101,100,1,19,0.99009900990099,0.8403361344537815
2024,KHOUALKA,CITRANGE CARRIZO,10213,IMG-12774.jpg,118,95,93,2,25,0.9789473684210528,0.788135593220339
2024,KHOUALKA,CITRANGE CARRIZO,10213,IMG-12780.jpg,44,40,38,2,6,0.95,0.8636363636363636
2024,KHOUALKA,CITRANGE CARRIZO,10213,IMG-12791.jpg,166,124,122,2,44,0.9838709677419356,0.7349397590361446
2024,KHOUALKA,CITRANGE CARRIZO,10213,IMG-12834.jpg,57,44,43,1,14,0.9772727272727272,0.7543859649122807
2024,KHOUALKA,CITRANGE CARRIZO,10213,IMG-12945.jpg,130,105,104,1,26,0.9904761904761904,0.8
2022,OUARGHA,MACROPHYLLA,11010,IMG-00001.jpg,40,41,39,2,1,0.951219512195122,0.975
2022,OUARGHA,MACROPHYLLA,11010,IMG-00015-41.jpg,24,26,22,4,2,0.8461538461538461,0.9166666666666666
2022,OUARGHA,MACROPHYLLA,11010,IMG-00019-41.jpg,20,38,20,18,0,0.5263157894736842,1.0
2022,OUARGHA,MACROPHYLLA,11010,IMG-00024-41.jpg,21,24,21,3,0,0.875,1.0
2022,OUARGHA,MACROPHYLLA,11020,IMG-00017-41.jpg,51,59,50,9,1,0.847457627118644,0.9803921568627452
2022,OUARGHA,MACROPHYLLA,11020,IMG-00018-41.jpg,13,15,13,2,0,0.8666666666666667,1.0
2022,OUARGHA,CITRANGE CARRIZO,13010,IMG-00067-41.jpg,55,72,54,18,1,0.75,0.9818181818181818
2022,OUARGHA,CITRANGE CARRIZO,13010,IMG-00086-41.jpg,49,58,48,10,1,0.8275862068965517,0.979591836734694
2022,OUARGHA,CITRANGE CARRIZO,13010,IMG-00194-41.jpg,33,41,32,9,1,0.7804878048780488,0.9696969696969696
2022,OUARGHA,CITRANGE CARRIZO,13020,IMG-00023-41.jpg,31,37,31,6,0,0.8378378378378378,1.0
2022,OUARGHA,CITRANGE CARRIZO,13020,IMG-00024-41.jpg,18,24,18,6,0,0.75,1.0
2022,OUARGHA,CITRANGE CARRIZO,13020,IMG-00039-41.jpg,4,10,4,6,0,0.4,1.0
2022,OUARGHA,CITRANGE CARRIZO,13020,IMG-00040-41.jpg,6,13,6,7,0,0.4615384615384616,1.0
2022,OUARGHA,CITRUS VOLKAMERIANA,13030,IMG-00009-41.jpg,18,25,18,7,0,0.72,1.0
2022,OUARGHA,CITRUS VOLKAMERIANA,13030,IMG-00013-41.jpg,46,66,46,20,0,0.696969696969697,1.0
2022,OUARGHA,CITRUS VOLKAMERIANA,13030,IMG-00027-41.jpg,12,24,11,13,1,0.4583333333333333,0.9166666666666666
2022,OUARGHA,CITRUS VOLKAMERIANA,13030,IMG-00029-41.jpg,18,30,18,12,0,0.6,1.0
2022,OUARGHA,CITRUS VOLKAMERIANA,13030,IMG-00036-41.jpg,16,38,16,22,0,0.4210526315789473,1.0
2022,OUARGHA,CITRUS VOLKAMERIANA,14010,IMG-00008-41.jpg,40,51,40,11,0,0.7843137254901961,1.0
2022,OUARGHA,CITRUS VOLKAMERIANA,14010,IMG-00010-41.jpg,49,57,48,9,1,0.8421052631578947,0.979591836734694
2022,OUARGHA,CITRUS VOLKAMERIANA,14010,IMG-00011-41.jpg,47,61,47,14,0,0.7704918032786885,1.0
2022,OUARGHA,CITRUS VOLKAMERIANA,14010,IMG-00018-41.jpg,44,56,43,13,1,0.7678571428571429,0.9772727272727272
2022,KHOUALKA,MACROPHYLLA,20118,IMG-00007-40.jpg,44,47,44,3,0,0.9361702127659576,1.0
2022,KHOUALKA,MACROPHYLLA,20118,IMG-00008-40.jpg,115,120,112,8,3,0.9333333333333332,0.9739130434782608
2022,KHOUALKA,MACROPHYLLA,20118,IMG-00022-40.jpg,113,112,105,7,8,0.9375,0.9292035398230089
2022,KHOUALKA,MACROPHYLLA,20118,IMG-00033-40.jpg,58,61,56,5,2,0.918032786885246,0.9655172413793104
2022,KHOUALKA,MACROPHYLLA,20118,IMG-00037-40.jpg,29,30,28,2,1,0.9333333333333332,0.9655172413793104
2022,KHOUALKA,MACROPHYLLA,20118,IMG-00042-40.jpg,137,139,132,7,5,0.9496402877697842,0.9635036496350364
2022,KHOUALKA,MACROPHYLLA,20118,IMG-00046-40.jpg,45,49,44,5,1,0.8979591836734694,0.9777777777777776
2022,KHOUALKA,MACROPHYLLA,20118,IMG-00050-40.jpg,48,49,45,4,3,0.9183673469387756,0.9375
2022,KHOUALKA,MACROPHYLLA,20118,IMG-00055-40.jpg,52,50,48,2,4,0.96,0.9230769230769232
2022,KHOUALKA,MACROPHYLLA,20118,IMG-00061-40.jpg,120,124,111,13,9,0.8951612903225806,0.925
2022,KHOUALKA,MACROPHYLLA,20118,IMG-00062-40.jpg,63,64,55,9,8,0.859375,0.873015873015873
2022,KHOUALKA,MACROPHYLLA,20118,IMG-00063-40.jpg,47,54,43,11,4,0.7962962962962963,0.9148936170212766
2022,KHOUALKA,MACROPHYLLA,20118,IMG-00066-40.jpg,84,83,78,5,6,0.9397590361445785,0.9285714285714286
2024,KHOUALKA,MACROPHYLLA,20118,IMG-12691.jpg,22,14,14,0,8,1.0,0.6363636363636364
2024,KHOUALKA,MACROPHYLLA,20118,IMG-12729.jpg,56,44,42,2,14,0.9545454545454546,0.75
2024,KHOUALKA,MACROPHYLLA,20118,IMG-12735.jpg,88,69,69,0,19,1.0,0.7840909090909091
2024,KHOUALKA,MACROPHYLLA,20118,IMG-12748.jpg,107,80,77,3,30,0.9625,0.719626168224299
2024,KHOUALKA,MACROPHYLLA,20118,IMG-12764.jpg,111,92,92,0,19,1.0,0.8288288288288288
2024,KHOUALKA,MACROPHYLLA,20118,IMG-12808.jpg,113,80,78,2,35,0.975,0.6902654867256637
2024,KHOUALKA,MACROPHYLLA,20118,IMG-12851.jpg,24,13,13,0,11,1.0,0.5416666666666666
2022,KHOUALKA,MACROPHYLLA,20119,IMG-00005-40.jpg,106,110,103,7,3,0.9363636363636364,0.9716981132075472
2022,KHOUALKA,MACROPHYLLA,20119,IMG-00008-40.jpg,142,146,133,13,9,0.910958904109589,0.9366197183098592
2022,KHOUALKA,MACROPHYLLA,20119,IMG-00014-40.jpg,132,136,127,9,5,0.9338235294117648,0.9621212121212122
2022,KHOUALKA,BIGARADIER,20132,IMG-00004-40.jpg,181,183,175,8,6,0.9562841530054644,0.9668508287292816
2022,KHOUALKA,BIGARADIER,20132,IMG-00025-40.jpg,91,95,88,7,3,0.9263157894736842,0.967032967032967
2022,KHOUALKA,BIGARADIER,20132,IMG-00028-40.jpg,49,52,49,3,0,0.9423076923076924,1.0
2022,KHOUALKA,BIGARADIER,20132,IMG-00035-40.jpg,103,111,103,8,0,0.927927927927928,1.0
2022,KHOUALKA,BIGARADIER,20132,IMG-00039-40.jpg,119,127,116,11,3,0.9133858267716536,0.9747899159663864
2022,KHOUALKA,BIGARADIER,20132,IMG-00046-40.jpg,156,158,151,7,5,0.9556962025316456,0.967948717948718
2022,KHOUALKA,BIGARADIER,20132,IMG-00051-40.jpg,108,109,100,9,8,0.9174311926605504,0.925925925925926
2022,KHOUALKA,BIGARADIER,20132,IMG-00055-40.jpg,67,63,62,1,5,0.984126984126984,0.9253731343283582
2022,KHOUALKA,BIGARADIER,20132,IMG-00058-40.jpg,89,90,86,4,3,0.9555555555555556,0.9662921348314608
2022,KHOUALKA,BIGARADIER,20132,IMG-00059-40.jpg,139,140,132,8,7,0.9428571428571428,0.9496402877697842
2022,KHOUALKA,BIGARADIER,20132,IMG-00060-40.jpg,57,56,52,4,5,0.9285714285714286,0.912280701754386
2022,KHOUALKA,BIGARADIER,20132,IMG-00064-40.jpg,117,125,113,12,4,0.904,0.9658119658119658
2022,KHOUALKA,BIGARADIER,20132,IMG-00075-40.jpg,69,73,68,5,1,0.9315068493150684,0.9855072463768116
2022,ONAGRI,BIGARADIER,20139,IMG-00021-39.jpg,93,91,86,5,7,0.945054945054945,0.9247311827956988
2024,KHOUALKA,CITRUS VOLKAMERIANA,20205,IMG-12040.jpg,123,90,89,1,34,0.9888888888888888,0.7235772357723578
2024,KHOUALKA,CITRUS VOLKAMERIANA,20205,IMG-12058.jpg,116,119,114,5,2,0.957983193277311,0.9827586206896552
2024,KHOUALKA,CITRUS VOLKAMERIANA,20207,IMG-11892.jpg,94,77,74,3,20,0.961038961038961,0.7872340425531915
2024,KHOUALKA,CITRUS VOLKAMERIANA,20207,IMG-11921.jpg,264,174,172,2,92,0.9885057471264368,0.6515151515151515
2024,KHOUALKA,CITRUS VOLKAMERIANA,20207,IMG-11927.jpg,195,147,145,2,50,0.9863945578231292,0.7435897435897436
2024,KHOUALKA,CITRUS VOLKAMERIANA,20207,IMG-11961.jpg,113,91,91,0,22,1.0,0.8053097345132744
2024,KHOUALKA,CITRUS VOLKAMERIANA,20207,IMG-11972.jpg,94,68,66,2,28,0.9705882352941176,0.7021276595744681
2024,KHOUALKA,CITRUS VOLKAMERIANA,20207,IMG-11981.jpg,81,54,52,2,29,0.9629629629629628,0.6419753086419753
2022,SAOUDA,CITRUS VOLKAMERIANA,21020,IMG-00033-45.jpg,67,84,67,17,0,0.7976190476190477,1.0
2022,SAOUDA,CITRUS VOLKAMERIANA,21020,IMG-00087-45.jpg,21,27,20,7,1,0.7407407407407407,0.9523809523809524
2022,SAOUDA,CITRUS VOLKAMERIANA,21020,IMG-00138-45.jpg,40,47,40,7,0,0.851063829787234,1.0
2022,SAOUDA,CITRUS VOLKAMERIANA,21020,IMG-00145-45.jpg,37,43,37,6,0,0.8604651162790697,1.0
2022,SAOUDA,CITRUS VOLKAMERIANA,21020,IMG-00155-45.jpg,38,54,38,16,0,0.7037037037037037,1.0
2022,SAOUDA,CITRUS VOLKAMERIANA,21030,IMG-00521-45.jpg,31,42,31,11,0,0.7380952380952381,1.0
2022,SAOUDA,CITRUS VOLKAMERIANA,21030,IMG-00524-45.jpg,71,88,71,17,0,0.8068181818181818,1.0
2022,SAOUDA,CITRUS VOLKAMERIANA,21030,IMG-00536-45.jpg,41,61,40,21,1,0.6557377049180327,0.975609756097561
2022,SAOUDA,CITRUS VOLKAMERIANA,21030,IMG-00537-45.jpg,52,68,52,16,0,0.7647058823529411,1.0
2022,SAOUDA,CITRUS VOLKAMERIANA,22020,IMG-00053-45.jpg,39,53,39,14,0,0.7358490566037735,1.0
2022,SAOUDA,CITRUS VOLKAMERIANA,22020,IMG-00059-45.jpg,46,54,45,9,1,0.8333333333333334,0.9782608695652174
2022,SAOUDA,CITRUS VOLKAMERIANA,22020,IMG-00060-45.jpg,48,57,48,9,0,0.8421052631578947,1.0
2022,SAOUDA,CITRUS VOLKAMERIANA,22020,IMG-00062-45.jpg,50,65,50,15,0,0.7692307692307693,1.0
2022,SAOUDA,CITRUS VOLKAMERIANA,22030,IMG-00062-45.jpg,62,72,62,10,0,0.8611111111111112,1.0
2022,SAOUDA,CITRUS VOLKAMERIANA,22030,IMG-00063-45.jpg,83,99,82,17,1,0.8282828282828283,0.9879518072289156
2022,SAOUDA,CITRUS VOLKAMERIANA,22030,IMG-00065-45.jpg,58,67,56,11,2,0.835820895522388,0.9655172413793104
2022,SAOUDA,CITRUS VOLKAMERIANA,22030,IMG-00068-45.jpg,66,77,65,12,1,0.8441558441558441,0.9848484848484848
2022,SAOUDA,CITRUS VOLKAMERIANA,23020,IMG-00024-45.jpg,47,61,46,15,1,0.7540983606557377,0.9787234042553192
2022,SAOUDA,CITRUS VOLKAMERIANA,23020,IMG-00032-45.jpg,33,35,33,2,0,0.9428571428571428,1.0
2022,SAOUDA,CITRUS VOLKAMERIANA,23020,IMG-00074-45.jpg,28,34,27,7,1,0.7941176470588235,0.9642857142857144
2022,SAOUDA,CITRUS VOLKAMERIANA,23020,IMG-00079-45.jpg,28,40,28,12,0,0.7,1.0
2022,SAOUDA,CITRUS VOLKAMERIANA,23030,IMG-00014-45.jpg,25,36,24,12,1,0.6666666666666666,0.96
2022,SAOUDA,CITRUS VOLKAMERIANA,23030,IMG-00034-45.jpg,43,64,43,21,0,0.671875,1.0
2022,SAOUDA,CITRUS VOLKAMERIANA,23030,IMG-00069-45.jpg,28,50,27,23,1,0.54,0.9642857142857144
2022,SAOUDA,CITRUS VOLKAMERIANA,23030,IMG-00079-45.jpg,50,76,50,26,0,0.6578947368421053,1.0
2022,SAOUDA,CITRANGE CARRIZO,24010,IMG-00097-45.jpg,59,71,58,13,1,0.8169014084507042,0.9830508474576272
2022,SAOUDA,CITRANGE CARRIZO,24010,IMG-00101-45.jpg,27,36,27,9,0,0.75,1.0
2022,SAOUDA,CITRANGE CARRIZO,24010,IMG-00111-45.jpg,54,60,53,7,1,0.8833333333333333,0.9814814814814816
2022,SAOUDA,CITRANGE CARRIZO,24010,IMG-00112-45.jpg,40,52,40,12,0,0.7692307692307693,1.0
2022,SAOUDA,CITRANGE CARRIZO,25010,IMG-00006-45.jpg,55,71,55,16,0,0.7746478873239436,1.0
2022,SAOUDA,CITRANGE CARRIZO,25010,IMG-00007-45.jpg,77,99,77,22,0,0.7777777777777778,1.0
2022,SAOUDA,CITRANGE CARRIZO,25010,IMG-00010-45.jpg,53,68,53,15,0,0.7794117647058824,1.0
2022,SAOUDA,CITRANGE CARRIZO,25010,IMG-00011-45.jpg,26,30,26,4,0,0.8666666666666667,1.0
2022,SAOUDA,CITRANGE CARRIZO,26010,IMG-00008-45.jpg,39,43,39,4,0,0.9069767441860463,1.0
2022,SAOUDA,CITRANGE CARRIZO,26010,IMG-00013-45.jpg,36,47,36,11,0,0.7659574468085106,1.0
2022,SAOUDA,CITRANGE CARRIZO,26010,IMG-00018-45.jpg,43,53,43,10,0,0.8113207547169812,1.0
2022,SAOUDA,CITRANGE CARRIZO,26010,IMG-00020-45.jpg,44,49,44,5,0,0.8979591836734694,1.0
2022,KHOUALKA,CITRANGE CARRIZO,30138,IMG-00002-40.jpg,39,39,36,3,3,0.9230769230769232,0.9230769230769232
2022,KHOUALKA,CITRANGE CARRIZO,30138,IMG-00003-40.jpg,59,63,57,6,2,0.9047619047619048,0.9661016949152542
2022,KHOUALKA,CITRANGE CARRIZO,30138,IMG-00005-40.jpg,58,62,58,4,0,0.935483870967742,1.0
2022,KHOUALKA,CITRANGE CARRIZO,30138,IMG-00008-40.jpg,32,35,30,5,2,0.8571428571428571,0.9375
2022,KHOUALKA,CITRANGE CARRIZO,30138,IMG-00011-40.jpg,26,28,25,3,1,0.8928571428571429,0.9615384615384616
2022,KHOUALKA,CITRANGE CARRIZO,30138,IMG-00019-40.jpg,2,2,2,0,0,1.0,1.0
2022,KHOUALKA,CITRANGE CARRIZO,30138,IMG-00037-40.jpg,30,33,29,4,1,0.8787878787878788,0.9666666666666668
2022,KHOUALKA,CITRANGE CARRIZO,30138,IMG-00040-40.jpg,41,42,40,2,1,0.9523809523809524,0.975609756097561
2022,KHOUALKA,CITRANGE CARRIZO,30138,IMG-00043-40.jpg,28,36,28,8,0,0.7777777777777778,1.0
2022,KHOUALKA,CITRANGE CARRIZO,30138,IMG-00044-40.jpg,99,99,96,3,3,0.9696969696969696,0.9696969696969696
2022,KHOUALKA,CITRANGE CARRIZO,30138,IMG-00048-40.jpg,37,44,35,9,2,0.7954545454545454,0.945945945945946
2022,KHOUALKA,CITRANGE CARRIZO,30138,IMG-00057-40.jpg,73,75,68,7,5,0.9066666666666666,0.9315068493150684
2022,KHOUALKA,CITRANGE CARRIZO,30138,IMG-00063-40.jpg,89,84,82,2,7,0.9761904761904762,0.9213483146067416
2022,ONAGRI,CITRUS VOLKAMERIANA,30145,IMG-00018-39.jpg,219,223,206,17,13,0.9237668161434978,0.9406392694063926
2022,ONAGRI,CITRUS VOLKAMERIANA,30145,IMG-00043-39.jpg,64,68,61,7,3,0.8970588235294118,0.953125
2022,ONAGRI,CITRUS VOLKAMERIANA,30146,IMG-00008-39.jpg,262,264,250,14,12,0.946969696969697,0.9541984732824428
2022,ONAGRI,CITRUS VOLKAMERIANA,30146,IMG-00045-39.jpg,190,194,178,16,12,0.9175257731958762,0.936842105263158
2022,ONAGRI,CITRUS VOLKAMERIANA,30147,IMG-00002-39.jpg,269,287,260,27,9,0.9059233449477352,0.966542750929368
2022,ONAGRI,CITRUS VOLKAMERIANA,30147,IMG-00008-39.jpg,172,181,166,15,6,0.9171270718232044,0.9651162790697676
2022,ONAGRI,CITRUS VOLKAMERIANA,30148,IMG-00016-40.jpg,88,90,82,8,6,0.9111111111111112,0.9318181818181818
2022,ONAGRI,CITRUS VOLKAMERIANA,30148,IMG-00047-40.jpg,34,31,31,0,3,1.0,0.9117647058823528
2022,ONAGRI,CITRUS VOLKAMERIANA,30149,IMG-00018-39.jpg,151,145,140,5,11,0.9655172413793104,0.9271523178807948
2022,ONAGRI,CITRUS VOLKAMERIANA,30149,IMG-00027-39.jpg,226,211,205,6,21,0.971563981042654,0.9070796460176992
2022,ONAGRI,CITRUS VOLKAMERIANA,30151,IMG-00012-39.jpg,185,182,170,12,15,0.934065934065934,0.918918918918919
2022,ONAGRI,CITRUS VOLKAMERIANA,30151,IMG-00033-39.jpg,214,211,198,13,16,0.9383886255924172,0.9252336448598132
2024,ONAGRI,CITRUS VOLKAMERIANA,30151,IMG-21881.jpg,73,55,51,4,22,0.9272727272727272,0.6986301369863014
2024,ONAGRI,CITRUS VOLKAMERIANA,30151,IMG-21935.jpg,179,104,104,0,75,1.0,0.5810055865921788
2024,ONAGRI,CITRUS VOLKAMERIANA,30151,IMG-21936.jpg,93,61,61,0,32,1.0,0.6559139784946236
2022,ONAGRI,CITRUS VOLKAMERIANA,30152,IMG-00016-39.jpg,39,32,30,2,9,0.9375,0.7692307692307693
2022,ONAGRI,CITRUS VOLKAMERIANA,30152,IMG-00019-39.jpg,139,138,131,7,8,0.9492753623188406,0.9424460431654677
2022,ONAGRI,CITRUS VOLKAMERIANA,30153,IMG-00001.jpg,157,144,142,2,15,0.9861111111111112,0.9044585987261148
2022,ONAGRI,CITRUS VOLKAMERIANA,30153,IMG-00007-39.jpg,127,115,113,2,14,0.982608695652174,0.889763779527559
2022,ONAGRI,CITRUS VOLKAMERIANA,30153,IMG-00013-39.jpg,159,148,145,3,14,0.9797297297297296,0.9119496855345912
2022,ONAGRI,CITRUS VOLKAMERIANA,30153,IMG-00040-39.jpg,153,151,148,3,5,0.9801324503311258,0.9673202614379084
2022,ONAGRI,CITRUS VOLKAMERIANA,30154,IMG-00017-39.jpg,160,159,152,7,8,0.9559748427672956,0.95
2022,ONAGRI,CITRUS VOLKAMERIANA,30154,IMG-00027-39.jpg,220,215,211,4,9,0.9813953488372092,0.9590909090909092
2022,ONAGRI,CITRUS VOLKAMERIANA,30154,IMG-00033-39.jpg,51,52,51,1,0,0.9807692307692308,1.0
2022,ONAGRI,CITRUS VOLKAMERIANA,30154,IMG-00036-39.jpg,137,135,129,6,8,0.9555555555555556,0.9416058394160584
2022,ONAGRI,CITRUS VOLKAMERIANA,30154,IMG-00038-39.jpg,242,239,231,8,11,0.9665271966527196,0.9545454545454546
2022,ONAGRI,CITRUS VOLKAMERIANA,30154,IMG-00041-39.jpg,272,263,251,12,21,0.9543726235741444,0.9227941176470588
2022,ONAGRI,CITRUS VOLKAMERIANA,30154,IMG-00044-39.jpg,141,146,134,12,7,0.9178082191780822,0.950354609929078
2022,ONAGRI,BIGARADIER,30155,IMG-00002-39.jpg,139,140,135,5,4,0.9642857142857144,0.9712230215827338
2022,ONAGRI,BIGARADIER,30155,IMG-00003-39.jpg,115,108,105,3,10,0.9722222222222222,0.9130434782608696
2022,ONAGRI,BIGARADIER,30155,IMG-00006-39.jpg,44,43,42,1,2,0.9767441860465116,0.9545454545454546
2022,ONAGRI,BIGARADIER,30155,IMG-00011-39.jpg,100,97,95,2,5,0.979381443298969,0.95
2022,ONAGRI,BIGARADIER,30155,IMG-00019-39.jpg,142,131,129,2,13,0.9847328244274808,0.908450704225352
2022,ONAGRI,BIGARADIER,30155,IMG-00026-39.jpg,124,113,109,4,15,0.9646017699115044,0.8790322580645161
2022,ONAGRI,BIGARADIER,30155,IMG-00032-39.jpg,81,78,73,5,8,0.935897435897436,0.9012345679012346
2022,ONAGRI,BIGARADIER,30155,IMG-00039-39.jpg,19,20,17,3,2,0.85,0.8947368421052632
2022,ONAGRI,BIGARADIER,30155,IMG-00043-39.jpg,130,133,126,7,4,0.9473684210526316,0.9692307692307692
2022,ONAGRI,CITRUS VOLKAMERIANA,30157,IMG-00003-39.jpg,227,220,213,7,14,0.968181818181818,0.9383259911894272
2022,ONAGRI,CITRUS VOLKAMERIANA,30157,IMG-00012-39.jpg,283,274,263,11,20,0.95985401459854,0.9293286219081272
2022,ONAGRI,CITRUS VOLKAMERIANA,30157,IMG-00032-39.jpg,64,68,62,6,2,0.9117647058823528,0.96875
2022,ONAGRI,CITRUS VOLKAMERIANA,30157,IMG-00035-39.jpg,159,155,149,6,10,0.9612903225806452,0.9371069182389936
2022,KHOUALKA,CITRUS VOLKAMERIANA,30235,IMG-00001.jpg,93,98,90,8,3,0.9183673469387756,0.967741935483871
2022,KHOUALKA,CITRUS VOLKAMERIANA,30235,IMG-00003-40.jpg,37,38,37,1,0,0.9736842105263158,1.0
2022,KHOUALKA,CITRUS VOLKAMERIANA,30235,IMG-00009-40.jpg,103,109,101,8,2,0.926605504587156,0.9805825242718448
2022,KHOUALKA,CITRUS VOLKAMERIANA,30235,IMG-00013-40.jpg,90,99,90,9,0,0.9090909090909092,1.0
2022,KHOUALKA,CITRUS VOLKAMERIANA,30235,IMG-00026-40.jpg,122,132,120,12,2,0.9090909090909092,0.9836065573770492
2022,KHOUALKA,CITRUS VOLKAMERIANA,30235,IMG-00047-40.jpg,47,48,40,8,7,0.8333333333333334,0.851063829787234
2022,KHOUALKA,CITRUS VOLKAMERIANA,30235,IMG-00048-40.jpg,90,95,86,9,4,0.9052631578947368,0.9555555555555556
2022,KHOUALKA,CITRUS VOLKAMERIANA,30235,IMG-00049-40.jpg,44,48,42,6,2,0.875,0.9545454545454546
2022,KHOUALKA,CITRUS VOLKAMERIANA,30235,IMG-00050-40.jpg,84,83,76,7,8,0.9156626506024096,0.9047619047619048
2022,KHOUALKA,CITRUS VOLKAMERIANA,30235,IMG-00052-40.jpg,98,105,96,9,2,0.9142857142857144,0.979591836734694
2022,KHOUALKA,CITRUS VOLKAMERIANA,30235,IMG-00057-40.jpg,80,79,74,5,6,0.9367088607594936,0.925
2022,KHOUALKA,CITRUS VOLKAMERIANA,30235,IMG-00064-40.jpg,38,43,37,6,1,0.8604651162790697,0.9736842105263158
2022,KHOUALKA,CITRUS VOLKAMERIANA,30235,IMG-00067-40.jpg,107,102,99,3,8,0.9705882352941176,0.9252336448598132
2022,KHOUALKA,CITRUS VOLKAMERIANA,30235,IMG-00069-40.jpg,34,34,30,4,4,0.8823529411764706,0.8823529411764706
2022,KHOUALKA,CITRUS VOLKAMERIANA,30235,IMG-00075-40.jpg,95,97,89,8,6,0.9175257731958762,0.936842105263158
2022,KHOUALKA,BIGARADIER,40141,IMG-00006-40.jpg,7,10,7,3,0,0.7,1.0
2022,KHOUALKA,BIGARADIER,40141,IMG-00007-40.jpg,20,16,11,5,9,0.6875,0.55
2022,KHOUALKA,BIGARADIER,40141,IMG-00008-40.jpg,15,13,11,2,4,0.8461538461538461,0.7333333333333333
2022,ONAGRI,CITRANGE C35,40166,IMG-00009-39.jpg,38,38,37,1,1,0.9736842105263158,0.9736842105263158
2022,ONAGRI,CITRANGE C35,40166,IMG-00011-39.jpg,173,165,163,2,10,0.987878787878788,0.9421965317919077
2022,ONAGRI,CITRANGE C35,40166,IMG-00014-39.jpg,179,178,176,2,3,0.9887640449438202,0.9832402234636872
2022,ONAGRI,CITRANGE C35,40166,IMG-00015-39.jpg,122,115,113,2,9,0.982608695652174,0.9262295081967212
2022,ONAGRI,CITRANGE C35,40166,IMG-00041-39.jpg,102,101,98,3,4,0.9702970297029704,0.9607843137254902
2022,ONAGRI,CITRANGE C35,40167,IMG-00019-39.jpg,197,199,194,5,3,0.9748743718592964,0.9847715736040608
2022,ONAGRI,CITRANGE C35,40167,IMG-00030-39.jpg,126,118,118,0,8,1.0,0.9365079365079364
2022,ONAGRI,CITRANGE C35,40167,IMG-00039-39.jpg,217,203,198,5,19,0.9753694581280788,0.912442396313364
2022,ONAGRI,CITRANGE C35,40171,IMG-00008-39.jpg,109,100,100,0,9,1.0,0.9174311926605504
2022,ONAGRI,CITRANGE C35,40171,IMG-00037-39.jpg,94,84,82,2,12,0.9761904761904762,0.8723404255319149
2022,ONAGRI,CITRANGE C35,40171,IMG-00040-39.jpg,149,142,134,8,15,0.943661971830986,0.8993288590604027
2022,ONAGRI,CITRANGE C35,40172,IMG-00012-39.jpg,89,83,82,1,7,0.9879518072289156,0.9213483146067416
2022,ONAGRI,CITRANGE C35,40172,IMG-00025-39.jpg,109,101,101,0,8,1.0,0.926605504587156
2022,ONAGRI,CITRANGE C35,40172,IMG-00027-39.jpg,103,88,86,2,17,0.9772727272727272,0.8349514563106796
2022,ONAGRI,CITRANGE C35,40173,IMG-00004-39.jpg,133,121,118,3,15,0.975206611570248,0.8872180451127819
2022,ONAGRI,CITRANGE C35,40173,IMG-00008-39.jpg,57,41,41,0,16,1.0,0.7192982456140351
2022,ONAGRI,CITRANGE C35,40173,IMG-00010-39.jpg,53,59,51,8,2,0.864406779661017,0.9622641509433962
2022,ONAGRI,CITRANGE C35,40175,IMG-00005-39.jpg,95,85,84,1,11,0.9882352941176472,0.8842105263157894
2022,ONAGRI,CITRANGE C35,40175,IMG-00006-39.jpg,64,65,62,3,2,0.953846153846154,0.96875
2022,ONAGRI,CITRANGE C35,40176,IMG-00004-39.jpg,79,79,71,8,8,0.8987341772151899,0.8987341772151899
2022,ONAGRI,CITRANGE C35,40176,IMG-00012-39.jpg,105,107,99,8,6,0.9252336448598132,0.9428571428571428
2022,ONAGRI,CITRANGE C35,40176,IMG-00014-39.jpg,91,95,86,9,5,0.9052631578947368,0.945054945054945
2022,ONAGRI,CITRUMELO SACCATON,40177,IMG-00012-39.jpg,89,95,86,9,3,0.9052631578947368,0.9662921348314608
2022,ONAGRI,CITRUMELO SACCATON,40177,IMG-00015-39.jpg,213,220,211,9,2,0.9590909090909092,0.9906103286384976
2022,ONAGRI,CITRUMELO SACCATON,40177,IMG-00037-39.jpg,95,97,91,6,4,0.9381443298969072,0.9578947368421052
2022,ONAGRI,CITRANGE C35,40178,IMG-00013-39.jpg,76,79,76,3,0,0.9620253164556962,1.0
2022,ONAGRI,CITRANGE C35,40178,IMG-00027-39.jpg,56,58,55,3,1,0.9482758620689656,0.9821428571428572
2022,ONAGRI,CITRANGE C35,40178,IMG-00031-39.jpg,30,32,30,2,0,0.9375,1.0
2022,ONAGRI,CITRANGE C35,40178,IMG-00032-39.jpg,27,29,27,2,0,0.9310344827586208,1.0
2022,ONAGRI,CITRANGE C35,40178,IMG-00033-39.jpg,34,36,34,2,0,0.9444444444444444,1.0
2022,ONAGRI,CITRANGE C35,40179,IMG-00001.jpg,83,85,79,6,4,0.9294117647058824,0.9518072289156626
2022,ONAGRI,CITRANGE C35,40179,IMG-00010-39.jpg,161,164,153,11,8,0.9329268292682928,0.9503105590062112
2022,ONAGRI,CITRANGE C35,40179,IMG-00011-39.jpg,102,106,98,8,4,0.9245283018867924,0.9607843137254902
2022,ONAGRI,CITRANGE C35,40179,IMG-00018-39.jpg,9,10,9,1,0,0.9,1.0
2022,ONAGRI,CITRUMELO SACCATON,40182,IMG-00004-39.jpg,35,38,35,3,0,0.9210526315789472,1.0
2022,ONAGRI,CITRUMELO SACCATON,40182,IMG-00010-39.jpg,52,52,50,2,2,0.9615384615384616,0.9615384615384616
2022,ONAGRI,CITRUMELO SACCATON,40182,IMG-00015-39.jpg,85,82,77,5,8,0.9390243902439024,0.9058823529411764
2022,ONAGRI,CITRUMELO SACCATON,40183,IMG-00005-39.jpg,68,70,65,5,3,0.9285714285714286,0.9558823529411764
2022,ONAGRI,CITRUMELO SACCATON,40183,IMG-00009-39.jpg,57,63,57,6,0,0.9047619047619048,1.0
2022,ONAGRI,CITRUMELO SACCATON,40183,IMG-00010-39.jpg,48,49,46,3,2,0.9387755102040816,0.9583333333333334
2024,KHOUALKA,CITRUS VOLKAMERIANA,50152,IMG-17274.jpg,170,131,131,0,39,1.0,0.7705882352941177
2024,KHOUALKA,CITRUS VOLKAMERIANA,50152,IMG-17306.jpg,105,85,84,1,21,0.9882352941176472,0.8
2024,KHOUALKA,CITRUS VOLKAMERIANA,50152,IMG-17330.jpg,41,32,32,0,9,1.0,0.7804878048780488
2024,KHOUALKA,CITRUS VOLKAMERIANA,50152,IMG-17335.jpg,44,35,35,0,9,1.0,0.7954545454545454
2024,KHOUALKA,CITRUS VOLKAMERIANA,50152,IMG-17340.jpg,108,76,74,2,34,0.9736842105263158,0.6851851851851852
2024,KHOUALKA,CITRUS VOLKAMERIANA,50152,IMG-17356.jpg,60,45,43,2,17,0.9555555555555556,0.7166666666666667
2024,KHOUALKA,CITRUS VOLKAMERIANA,50152,IMG-17384.jpg,53,33,32,1,21,0.9696969696969696,0.6037735849056604
2024,KHOUALKA,CITRUS VOLKAMERIANA,50154,IMG-17440.jpg,76,61,61,0,15,1.0,0.8026315789473685
2024,KHOUALKA,CITRUS VOLKAMERIANA,50154,IMG-17490.jpg,107,74,74,0,33,1.0,0.6915887850467289
2024,KHOUALKA,CITRUS VOLKAMERIANA,50154,IMG-17543.jpg,100,70,69,1,31,0.9857142857142858,0.69
2024,KHOUALKA,CITRUS VOLKAMERIANA,50154,IMG-17545.jpg,94,67,67,0,27,1.0,0.7127659574468085
2024,KHOUALKA,CITRUS VOLKAMERIANA,50154,IMG-17562.jpg,129,102,101,1,28,0.9901960784313726,0.7829457364341085
2024,KHOUALKA,CITRUS VOLKAMERIANA,50154,IMG-17576.jpg,121,95,95,0,26,1.0,0.7851239669421488
2024,KHOUALKA,CITRUS VOLKAMERIANA,50154,IMG-17585.jpg,171,124,119,5,52,0.9596774193548387,0.695906432748538
2024,KHOUALKA,CITRUS VOLKAMERIANA,50168,IMG-13980.jpg,174,131,131,0,43,1.0,0.7528735632183908
2024,KHOUALKA,CITRUS VOLKAMERIANA,50168,IMG-15749.jpg,147,107,106,1,41,0.9906542056074766,0.7210884353741497
2024,KHOUALKA,CITRUS VOLKAMERIANA,50168,IMG-15758.jpg,163,123,122,1,41,0.991869918699187,0.7484662576687117
2024,KHOUALKA,CITRUS VOLKAMERIANA,50168,IMG-15981.jpg,210,167,165,2,45,0.9880239520958084,0.7857142857142857
2024,KHOUALKA,CITRUS VOLKAMERIANA,50168,IMG-15983.jpg,120,91,91,0,29,1.0,0.7583333333333333
2024,KHOUALKA,CITRUS VOLKAMERIANA,50176,IMG-16025.jpg,81,65,64,1,17,0.9846153846153848,0.7901234567901234
2024,KHOUALKA,CITRUS VOLKAMERIANA,50176,IMG-16051.jpg,85,65,64,1,21,0.9846153846153848,0.7529411764705882
2024,KHOUALKA,CITRUS VOLKAMERIANA,50176,IMG-16079.jpg,161,124,120,4,41,0.967741935483871,0.7453416149068323
2024,KHOUALKA,CITRUS VOLKAMERIANA,50176,IMG-16095.jpg,101,70,68,2,33,0.9714285714285714,0.6732673267326733
2024,KHOUALKA,CITRUS VOLKAMERIANA,50176,IMG-16105.jpg,43,34,33,1,10,0.9705882352941176,0.7674418604651163
2022,ONAGRI,CITRUMELO SACCATON,50193,IMG-00007-39.jpg,218,228,214,14,4,0.9385964912280702,0.981651376146789
2022,ONAGRI,CITRUMELO SACCATON,50193,IMG-00016-39.jpg,64,74,60,14,4,0.8108108108108109,0.9375
2022,ONAGRI,CITRUMELO SACCATON,50193,IMG-00018-39.jpg,115,123,112,11,3,0.9105691056910568,0.9739130434782608
2022,ONAGRI,CITRUMELO SACCATON,50193,IMG-00021-39.jpg,62,62,58,4,4,0.935483870967742,0.935483870967742
2022,ONAGRI,CITRUMELO SACCATON,50193,IMG-00023-39.jpg,113,123,112,11,1,0.9105691056910568,0.991150442477876
2022,ONAGRI,CITRUMELO SACCATON,50194,IMG-00032-39.jpg,162,164,152,12,10,0.926829268292683,0.9382716049382716
2022,ONAGRI,CITRUMELO SACCATON,50194,IMG-00034-39.jpg,105,108,101,7,4,0.9351851851851852,0.961904761904762
2022,ONAGRI,CITRUMELO SACCATON,50194,IMG-00036-39.jpg,161,160,151,9,10,0.94375,0.937888198757764
2022,ONAGRI,CITRUMELO SACCATON,50194,IMG-00038-39.jpg,100,101,95,6,5,0.9405940594059404,0.95
2022,ONAGRI,CITRUMELO SACCATON,50194,IMG-00039-39.jpg,65,66,63,3,2,0.9545454545454546,0.9692307692307692
2022,ONAGRI,CITRUMELO SACCATON,50194,IMG-00041-39.jpg,153,145,141,4,12,0.9724137931034482,0.9215686274509804
2022,ONAGRI,CITRUMELO SACCATON,50194,IMG-00051-39.jpg,137,136,133,3,4,0.9779411764705882,0.9708029197080292
2022,ONAGRI,CITRUMELO SACCATON,50194,IMG-00054-39.jpg,111,107,102,5,9,0.9532710280373832,0.918918918918919
2022,ONAGRI,CITRUMELO SACCATON,51091,IMG-00015-39.jpg,85,96,84,12,1,0.875,0.9882352941176472
2022,ONAGRI,CITRUMELO SACCATON,51091,IMG-00016-39.jpg,170,177,169,8,1,0.9548022598870056,0.9941176470588236
2022,ONAGRI,CITRUMELO SACCATON,51091,IMG-00018-39.jpg,185,209,184,25,1,0.8803827751196173,0.9945945945945946
2022,ONAGRI,CITRUMELO SACCATON,51091,IMG-00022-39.jpg,135,145,133,12,2,0.9172413793103448,0.9851851851851852
2022,ONAGRI,CITRUMELO SACCATON,51091,IMG-00023-39.jpg,140,136,131,5,9,0.9632352941176472,0.9357142857142856
2022,ONAGRI,CITRUMELO SACCATON,51091,IMG-00026-39.jpg,149,145,138,7,11,0.9517241379310344,0.9261744966442952
2022,ONAGRI,CITRUMELO SACCATON,51091,IMG-00044-39.jpg,168,180,167,13,1,0.9277777777777778,0.9940476190476192
2022,ONAGRI,CITRUMELO SACCATON,51095,IMG-00004-39.jpg,201,212,194,18,7,0.9150943396226416,0.965174129353234
2022,ONAGRI,CITRUMELO SACCATON,51095,IMG-00013-39.jpg,154,154,145,9,9,0.9415584415584416,0.9415584415584416
2022,ONAGRI,CITRUMELO SACCATON,51095,IMG-00014-39.jpg,140,143,131,12,9,0.916083916083916,0.9357142857142856
2022,ONAGRI,CITRUMELO SACCATON,51095,IMG-00015-39.jpg,196,197,191,6,5,0.9695431472081218,0.9744897959183674
2022,ONAGRI,CITRUMELO SACCATON,51095,IMG-00024-39.jpg,234,235,222,13,12,0.9446808510638298,0.9487179487179488
2022,ONAGRI,CITRUMELO SACCATON,51095,IMG-00025-39.jpg,198,207,192,15,6,0.927536231884058,0.9696969696969696
2022,ONAGRI,CITRUMELO SACCATON,51096,IMG-00009-39.jpg,219,224,206,18,13,0.9196428571428572,0.9406392694063926
2022,ONAGRI,CITRUMELO SACCATON,51096,IMG-00011-39.jpg,145,148,137,11,8,0.9256756756756755,0.9448275862068966
2022,ONAGRI,CITRUMELO SACCATON,51096,IMG-00012-39.jpg,114,108,105,3,9,0.9722222222222222,0.9210526315789472
2022,ONAGRI,CITRUMELO SACCATON,51096,IMG-00055-39.jpg,217,208,205,3,12,0.9855769230769232,0.9447004608294932
2022,ONAGRI,MC PONSIRUCE TRIFOLIATA,51097,IMG-00025-39.jpg,121,126,112,14,9,0.8888888888888888,0.9256198347107438
2022,ONAGRI,MC PONSIRUCE TRIFOLIATA,51097,IMG-00029-39.jpg,106,111,101,10,5,0.90990990990991,0.9528301886792452
2022,ONAGRI,MC PONSIRUCE TRIFOLIATA,51097,IMG-00044-39.jpg,182,183,171,12,11,0.9344262295081968,0.9395604395604396
2022,ONAGRI,MC PONSIRUCE TRIFOLIATA,51098,IMG-00003-39.jpg,65,67,62,5,3,0.9253731343283582,0.953846153846154
2022,ONAGRI,MC PONSIRUCE TRIFOLIATA,51098,IMG-00010-39.jpg,184,183,174,9,10,0.9508196721311476,0.9456521739130436
2022,ONAGRI,MC PONSIRUCE TRIFOLIATA,51098,IMG-00015-39.jpg,162,168,161,7,1,0.9583333333333334,0.9938271604938272
2022,ONAGRI,MC PONSIRUCE TRIFOLIATA,51099,IMG-00012-39.jpg,133,139,130,9,3,0.935251798561151,0.9774436090225564
2024,ONAGRI,MC PONSIRUCE TRIFOLIATA,51101,IMG-12118.jpg,177,122,122,0,55,1.0,0.6892655367231638
2024,ONAGRI,MC PONSIRUCE TRIFOLIATA,51101,IMG-14223.jpg,153,128,127,1,26,0.9921875,0.8300653594771242
2024,ONAGRI,MC PONSIRUCE TRIFOLIATA,51101,IMG-14226.jpg,151,127,125,2,26,0.984251968503937,0.8278145695364238
2024,ONAGRI,MC PONSIRUCE TRIFOLIATA,51101,IMG-14255.jpg,189,163,162,1,27,0.9938650306748468,0.8571428571428571
2024,ONAGRI,MC PONSIRUCE TRIFOLIATA,51101,IMG-14281.jpg,150,123,121,2,29,0.983739837398374,0.8066666666666666
2022,ONAGRI,CITRUS VOLKAMERIANA,101020,IMG-00001.jpg,6,5,5,0,1,1.0,0.8333333333333334
2022,ONAGRI,CITRUS VOLKAMERIANA,101020,IMG-00004-44.jpg,53,40,40,0,13,1.0,0.7547169811320755
2022,ONAGRI,CITRUS VOLKAMERIANA,101030,IMG-00003-44.jpg,29,27,27,0,2,1.0,0.9310344827586208
2022,ONAGRI,CITRUS VOLKAMERIANA,101030,IMG-00004-44.jpg,110,87,87,0,23,1.0,0.7909090909090909
2022,ONAGRI,CITRUS VOLKAMERIANA,101030,IMG-00005-44.jpg,134,109,108,1,26,0.9908256880733946,0.8059701492537313
2022,ONAGRI,CITRUS VOLKAMERIANA,101030,IMG-00017-44.jpg,79,57,57,0,22,1.0,0.7215189873417721
2022,ONAGRI,CITRUS VOLKAMERIANA,101040,IMG-00005-44.jpg,172,128,127,1,45,0.9921875,0.7383720930232558
2022,ONAGRI,CITRUS VOLKAMERIANA,101040,IMG-00009-44.jpg,131,106,106,0,25,1.0,0.8091603053435115
2022,ONAGRI,CITRUS VOLKAMERIANA,101040,IMG-00011-44.jpg,64,47,47,0,17,1.0,0.734375
2022,ONAGRI,CITRUS VOLKAMERIANA,101040,IMG-00012-44.jpg,139,87,87,0,52,1.0,0.6258992805755396
2022,ONAGRI,CITRUS VOLKAMERIANA,101050,IMG-00002-44.jpg,95,72,72,0,23,1.0,0.7578947368421053
2022,ONAGRI,CITRUS VOLKAMERIANA,101050,IMG-00005-44.jpg,59,44,44,0,15,1.0,0.7457627118644068
2022,ONAGRI,CITRUS VOLKAMERIANA,101050,IMG-00011-44.jpg,46,25,25,0,21,1.0,0.5434782608695652
2022,ONAGRI,CITRUS VOLKAMERIANA,101050,IMG-00024-44.jpg,40,29,29,0,11,1.0,0.725
2022,ONAGRI,CITRUS VOLKAMERIANA,101080,IMG-00005-44.jpg,42,25,25,0,17,1.0,0.5952380952380952
2022,ONAGRI,CITRUS VOLKAMERIANA,101080,IMG-00006-44.jpg,79,53,53,0,26,1.0,0.6708860759493671
2022,ONAGRI,CITRUS VOLKAMERIANA,101080,IMG-00023-44.jpg,7,8,7,1,0,0.875,1.0
2022,ONAGRI,CITRUS VOLKAMERIANA,101080,IMG-00024-44.jpg,27,14,14,0,13,1.0,0.5185185185185185
2022,ONAGRI,CITRUS VOLKAMERIANA,101090,IMG-00003-44.jpg,66,53,53,0,13,1.0,0.803030303030303
2022,ONAGRI,CITRUS VOLKAMERIANA,101090,IMG-00006-44.jpg,41,31,31,0,10,1.0,0.7560975609756098
2022,ONAGRI,CITRUS VOLKAMERIANA,101090,IMG-00019-44.jpg,35,31,31,0,4,1.0,0.8857142857142857
2022,ONAGRI,CITRUS VOLKAMERIANA,101090,IMG-00020-44.jpg,42,31,31,0,11,1.0,0.7380952380952381
2022,KHOUALKA,CITRANGE CARRIZO,102130,IMG-00001.jpg,5,2,2,0,3,1.0,0.4
2022,KHOUALKA,CITRANGE CARRIZO,102130,IMG-00004-43.jpg,24,8,8,0,16,1.0,0.3333333333333333
2022,KHOUALKA,CITRANGE CARRIZO,102130,IMG-00019-43.jpg,33,18,18,0,15,1.0,0.5454545454545454
2022,KHOUALKA,CITRANGE CARRIZO,102130,IMG-00020-43.jpg,18,8,8,0,10,1.0,0.4444444444444444
2022,KHOUALKA,MACROPHYLLA,201180,IMG-00007-43.jpg,38,34,34,0,4,1.0,0.8947368421052632
2022,KHOUALKA,MACROPHYLLA,201180,IMG-00011-43.jpg,64,37,37,0,27,1.0,0.578125
2022,KHOUALKA,MACROPHYLLA,201180,IMG-00019-43.jpg,64,45,45,0,19,1.0,0.703125
2022,KHOUALKA,MACROPHYLLA,201180,IMG-00020-43.jpg,43,31,30,1,13,0.967741935483871,0.6976744186046512
2022,KHOUALKA,MACROPHYLLA,201190,IMG-00004-43.jpg,101,52,51,1,50,0.9807692307692308,0.504950495049505
2022,KHOUALKA,MACROPHYLLA,201190,IMG-00010-43.jpg,90,36,36,0,54,1.0,0.4
2022,KHOUALKA,MACROPHYLLA,201190,IMG-00011-43.jpg,134,52,51,1,83,0.9807692307692308,0.3805970149253731
2022,KHOUALKA,MACROPHYLLA,201190,IMG-00020-43.jpg,95,45,45,0,50,1.0,0.4736842105263158
2022,KHOUALKA,CITRUS VOLKAMERIANA,201210,IMG-00011-43.jpg,103,64,63,1,40,0.984375,0.6116504854368932
2022,KHOUALKA,CITRUS VOLKAMERIANA,201210,IMG-00012-43.jpg,42,25,25,0,17,1.0,0.5952380952380952
2022,KHOUALKA,CITRUS VOLKAMERIANA,201210,IMG-00015-43.jpg,77,41,40,1,37,0.975609756097561,0.5194805194805194
2022,KHOUALKA,CITRUS VOLKAMERIANA,201210,IMG-00019-43.jpg,31,20,20,0,11,1.0,0.6451612903225806
2022,KHOUALKA,BIGARADIER,201320,IMG-00006-43.jpg,87,51,51,0,36,1.0,0.5862068965517241
2022,KHOUALKA,BIGARADIER,201320,IMG-00016-43.jpg,97,71,71,0,26,1.0,0.7319587628865979
2022,KHOUALKA,BIGARADIER,201320,IMG-00017-43.jpg,49,36,36,0,13,1.0,0.7346938775510204
2022,KHOUALKA,BIGARADIER,201320,IMG-00020-43.jpg,88,60,60,0,28,1.0,0.6818181818181818
2022,ONAGRI,BIGARADIER,201390,IMG-00008-44.jpg,62,39,39,0,23,1.0,0.6290322580645161
2022,ONAGRI,BIGARADIER,201390,IMG-00011-44.jpg,90,56,54,2,36,0.9642857142857144,0.6
2022,ONAGRI,BIGARADIER,201390,IMG-00013-44.jpg,77,29,29,0,48,1.0,0.3766233766233766
2022,ONAGRI,BIGARADIER,201390,IMG-00016-44.jpg,69,28,28,0,41,1.0,0.4057971014492754
2022,KHOUALKA,CITRUS VOLKAMERIANA,202050,IMG-00006-43.jpg,89,51,51,0,38,1.0,0.5730337078651685
2022,KHOUALKA,CITRUS VOLKAMERIANA,202050,IMG-00010-43.jpg,94,58,57,1,37,0.9827586206896552,0.6063829787234043
2022,KHOUALKA,CITRUS VOLKAMERIANA,202050,IMG-00011-43.jpg,151,100,98,2,53,0.98,0.6490066225165563
2022,KHOUALKA,CITRUS VOLKAMERIANA,202050,IMG-00020-43.jpg,129,70,70,0,59,1.0,0.5426356589147286
2022,KHOUALKA,CITRUS VOLKAMERIANA,202070,IMG-00006-43.jpg,68,34,34,0,34,1.0,0.5
2022,KHOUALKA,CITRUS VOLKAMERIANA,202070,IMG-00009-43.jpg,120,67,66,1,54,0.9850746268656716,0.55
2022,KHOUALKA,CITRUS VOLKAMERIANA,202070,IMG-00013-43.jpg,95,48,48,0,47,1.0,0.5052631578947369
2022,KHOUALKA,CITRUS VOLKAMERIANA,202070,IMG-00019-43.jpg,57,36,36,0,21,1.0,0.631578947368421
2022,KHOUALKA,CITRUS VOLKAMERIANA,202080,IMG-00005-43.jpg,65,43,43,0,22,1.0,0.6615384615384615
2022,KHOUALKA,CITRUS VOLKAMERIANA,202080,IMG-00008-43.jpg,31,23,23,0,8,1.0,0.7419354838709677
2022,KHOUALKA,CITRUS VOLKAMERIANA,202080,IMG-00015-43.jpg,220,108,107,1,113,0.9907407407407408,0.4863636363636364
2022,KHOUALKA,CITRUS VOLKAMERIANA,202080,IMG-00016-43.jpg,131,76,76,0,55,1.0,0.5801526717557252
2022,KHOUALKA,CITRANGE CARRIZO,301380,IMG-00007-43.jpg,30,18,18,0,12,1.0,0.6
2022,KHOUALKA,CITRANGE CARRIZO,301380,IMG-00011-43.jpg,53,40,39,1,14,0.975,0.7358490566037735
2022,KHOUALKA,CITRANGE CARRIZO,301380,IMG-00014-43.jpg,7,4,4,0,3,1.0,0.5714285714285714
2022,KHOUALKA,CITRANGE CARRIZO,301380,IMG-00020-43.jpg,91,56,56,0,35,1.0,0.6153846153846154
2022,ONAGRI,CITRUS VOLKAMERIANA,301470,IMG-00003-44.jpg,148,102,101,1,47,0.9901960784313726,0.6824324324324325
2022,ONAGRI,CITRUS VOLKAMERIANA,301470,IMG-00004-44.jpg,163,85,82,3,81,0.9647058823529412,0.5030674846625767
2022,ONAGRI,CITRUS VOLKAMERIANA,301470,IMG-00005-44.jpg,160,78,76,2,84,0.9743589743589745,0.475
2022,ONAGRI,CITRUS VOLKAMERIANA,301480,IMG-00001.jpg,92,42,42,0,50,1.0,0.4565217391304348
2022,ONAGRI,CITRUS VOLKAMERIANA,301480,IMG-00003-43.jpg,26,12,12,0,14,1.0,0.4615384615384616
2022,ONAGRI,CITRUS VOLKAMERIANA,301480,IMG-00012-43.jpg,50,26,26,0,24,1.0,0.52
2022,ONAGRI,CITRUS VOLKAMERIANA,301480,IMG-00014-43.jpg,77,40,40,0,37,1.0,0.5194805194805194
2022,ONAGRI,CITRUS VOLKAMERIANA,301490,IMG-00005-44.jpg,108,47,46,1,62,0.9787234042553192,0.4259259259259259
2022,ONAGRI,CITRUS VOLKAMERIANA,301490,IMG-00009-44.jpg,185,83,81,2,104,0.9759036144578314,0.4378378378378379
2022,ONAGRI,CITRUS VOLKAMERIANA,301490,IMG-00012-44.jpg,162,86,86,0,76,1.0,0.5308641975308642
2022,ONAGRI,CITRUS VOLKAMERIANA,301490,IMG-00015-44.jpg,109,53,52,1,57,0.981132075471698,0.4770642201834863
2022,ONAGRI,CITRUS VOLKAMERIANA,301510,IMG-00001.jpg,252,117,117,0,135,1.0,0.4642857142857143
2022,ONAGRI,CITRUS VOLKAMERIANA,301510,IMG-00006-44.jpg,137,85,83,2,54,0.976470588235294,0.6058394160583942
2022,ONAGRI,CITRUS VOLKAMERIANA,301510,IMG-00007-44.jpg,115,59,57,2,58,0.9661016949152542,0.4956521739130435
2022,ONAGRI,CITRUS VOLKAMERIANA,301510,IMG-00008-44.jpg,150,76,75,1,75,0.986842105263158,0.5
2022,ONAGRI,BIGARADIER,301550,IMG-00008-44.jpg,144,87,87,0,57,1.0,0.6041666666666666
2022,ONAGRI,BIGARADIER,301550,IMG-00011-44.jpg,40,23,22,1,18,0.9565217391304348,0.55
2022,ONAGRI,BIGARADIER,301550,IMG-00013-44.jpg,76,35,35,0,41,1.0,0.4605263157894737
2022,ONAGRI,BIGARADIER,301550,IMG-00014-44.jpg,80,39,36,3,44,0.9230769230769232,0.45
2022,ONAGRI,CITRUS VOLKAMERIANA,301570,IMG-00004-44.jpg,158,80,80,0,78,1.0,0.5063291139240507
2022,ONAGRI,CITRUS VOLKAMERIANA,301570,IMG-00007-44.jpg,152,91,89,2,63,0.978021978021978,0.5855263157894737
2022,ONAGRI,CITRUS VOLKAMERIANA,301570,IMG-00008-44.jpg,103,38,38,0,65,1.0,0.3689320388349515
2022,ONAGRI,CITRUS VOLKAMERIANA,301570,IMG-00017-44.jpg,218,99,97,2,121,0.9797979797979798,0.444954128440367
2022,KHOUALKA,CITRUS VOLKAMERIANA,302340,IMG-00004-43.jpg,106,57,56,1,50,0.9824561403508772,0.5283018867924528
2022,KHOUALKA,CITRUS VOLKAMERIANA,302340,IMG-00005-43.jpg,105,58,58,0,47,1.0,0.5523809523809524
2022,KHOUALKA,CITRUS VOLKAMERIANA,302340,IMG-00011-43.jpg,75,34,34,0,41,1.0,0.4533333333333333
2022,KHOUALKA,CITRUS VOLKAMERIANA,302340,IMG-00015-43.jpg,92,30,28,2,64,0.9333333333333332,0.3043478260869565
2022,KHOUALKA,CITRUS VOLKAMERIANA,302350,IMG-00008-43.jpg,33,23,23,0,10,1.0,0.696969696969697
2022,KHOUALKA,CITRUS VOLKAMERIANA,302350,IMG-00013-43.jpg,80,46,44,2,36,0.9565217391304348,0.55
2022,KHOUALKA,CITRUS VOLKAMERIANA,302350,IMG-00014-43.jpg,76,38,38,0,38,1.0,0.5
2022,KHOUALKA,CITRUS VOLKAMERIANA,302350,IMG-00018-43.jpg,44,30,30,0,14,1.0,0.6818181818181818
2022,KHOUALKA,CITRUS VOLKAMERIANA,302360,IMG-00005-43.jpg,97,42,42,0,55,1.0,0.4329896907216495
2022,KHOUALKA,CITRUS VOLKAMERIANA,302360,IMG-00006-43.jpg,118,48,48,0,70,1.0,0.4067796610169492
2022,KHOUALKA,CITRUS VOLKAMERIANA,302360,IMG-00016-43.jpg,67,35,35,0,32,1.0,0.5223880597014925
2022,KHOUALKA,CITRUS VOLKAMERIANA,302360,IMG-00021-43.jpg,65,39,38,1,27,0.9743589743589745,0.5846153846153846
2022,KHOUALKA,CITRUS VOLKAMERIANA,302510,IMG-00001.jpg,73,36,36,0,37,1.0,0.4931506849315068
2022,KHOUALKA,CITRUS VOLKAMERIANA,302510,IMG-00002-43.jpg,44,23,22,1,22,0.9565217391304348,0.5
2022,KHOUALKA,CITRUS VOLKAMERIANA,302510,IMG-00003-43.jpg,78,51,47,4,31,0.9215686274509804,0.6025641025641025
2022,KHOUALKA,CITRUS VOLKAMERIANA,302510,IMG-00015-43.jpg,49,22,22,0,27,1.0,0.4489795918367347
2022,KHOUALKA,BIGARADIER,401410,IMG-00093-43.jpg,35,16,16,0,19,1.0,0.4571428571428571
2022,KHOUALKA,BIGARADIER,401410,IMG-00099-43.jpg,6,3,3,0,3,1.0,0.5
2022,KHOUALKA,BIGARADIER,401410,IMG-00102-43.jpg,78,30,29,1,49,0.9666666666666668,0.3717948717948718
2022,KHOUALKA,BIGARADIER,401410,IMG-00104-43.jpg,81,36,35,1,46,0.9722222222222222,0.4320987654320987
2022,ONAGRI,CITRANGE C35,401660,IMG-00001.jpg,56,40,38,2,18,0.95,0.6785714285714286
2022,ONAGRI,CITRANGE C35,401660,IMG-00008-44.jpg,42,24,24,0,18,1.0,0.5714285714285714
2022,ONAGRI,CITRANGE C35,401660,IMG-00010-44.jpg,29,23,21,2,8,0.9130434782608696,0.7241379310344828
2022,ONAGRI,CITRANGE C35,401660,IMG-00016-44.jpg,64,45,45,0,19,1.0,0.703125
2022,ONAGRI,CITRANGE C35,401710,IMG-00003-44.jpg,51,28,28,0,23,1.0,0.5490196078431373
2022,ONAGRI,CITRANGE C35,401710,IMG-00012-44.jpg,19,12,12,0,7,1.0,0.631578947368421
2022,ONAGRI,CITRANGE C35,401710,IMG-00013-44.jpg,33,24,24,0,9,1.0,0.7272727272727273
2022,ONAGRI,CITRANGE C35,401710,IMG-00019-44.jpg,76,56,56,0,20,1.0,0.7368421052631579
2022,ONAGRI,CITRANGE C35,401720,IMG-00007-44.jpg,93,61,60,1,33,0.9836065573770492,0.6451612903225806
2022,ONAGRI,CITRANGE C35,401720,IMG-00008-44.jpg,38,24,24,0,14,1.0,0.631578947368421
2022,ONAGRI,CITRANGE C35,401720,IMG-00010-44.jpg,50,20,20,0,30,1.0,0.4
2022,ONAGRI,CITRANGE C35,401720,IMG-00017-44.jpg,68,43,43,0,25,1.0,0.6323529411764706
2022,ONAGRI,CITRANGE C35,401730,IMG-00001.jpg,19,11,11,0,8,1.0,0.5789473684210527
2022,ONAGRI,CITRANGE C35,401730,IMG-00010-44.jpg,50,34,34,0,16,1.0,0.68
2022,ONAGRI,CITRANGE C35,401730,IMG-00013-44.jpg,75,58,57,1,18,0.9827586206896552,0.76
2022,ONAGRI,CITRANGE C35,401730,IMG-00016-44.jpg,36,24,23,1,13,0.9583333333333334,0.6388888888888888
2022,ONAGRI,CITRANGE C35,401750,IMG-00005-44.jpg,88,43,43,0,45,1.0,0.4886363636363636
2022,ONAGRI,CITRANGE C35,401750,IMG-00009-44.jpg,127,79,77,2,50,0.9746835443037974,0.6062992125984252
2022,ONAGRI,CITRANGE C35,401750,IMG-00016-44.jpg,107,68,68,0,39,1.0,0.6355140186915887
2022,ONAGRI,CITRANGE C35,401750,IMG-00024-44.jpg,50,30,29,1,21,0.9666666666666668,0.58
2022,ONAGRI,CITRUMELO SACCATON,401770,IMG-00003-44.jpg,24,15,15,0,9,1.0,0.625
2022,ONAGRI,CITRUMELO SACCATON,401770,IMG-00008-44.jpg,72,41,41,0,31,1.0,0.5694444444444444
2022,ONAGRI,CITRUMELO SACCATON,401770,IMG-00009-44.jpg,14,9,8,1,6,0.8888888888888888,0.5714285714285714
2022,ONAGRI,CITRUMELO SACCATON,401770,IMG-00017-44.jpg,20,11,11,0,9,1.0,0.55
2022,KHOUALKA,BIGARADIER,402440,IMG-00005-43.jpg,17,5,5,0,12,1.0,0.2941176470588235
2022,KHOUALKA,BIGARADIER,402440,IMG-00012-43.jpg,46,23,23,0,23,1.0,0.5
2022,KHOUALKA,BIGARADIER,402440,IMG-00014-43.jpg,11,4,4,0,7,1.0,0.3636363636363636
2022,KHOUALKA,BIGARADIER,402440,IMG-00015-43.jpg,22,4,4,0,18,1.0,0.1818181818181818
2022,KHOUALKA,BIGARADIER,402590,IMG-00007-43.jpg,104,52,51,1,53,0.9807692307692308,0.4903846153846154
2022,KHOUALKA,BIGARADIER,402590,IMG-00012-43.jpg,45,23,23,0,22,1.0,0.5111111111111111
2022,KHOUALKA,BIGARADIER,402590,IMG-00015-43.jpg,58,32,32,0,26,1.0,0.5517241379310345
2022,KHOUALKA,BIGARADIER,402590,IMG-00019-43.jpg,64,44,44,0,20,1.0,0.6875
2022,KHOUALKA,CITRUS VOLKAMERIANA,501520,IMG-00004-43.jpg,39,16,16,0,23,1.0,0.4102564102564102
2022,KHOUALKA,CITRUS VOLKAMERIANA,501520,IMG-00007-43.jpg,43,24,23,1,20,0.9583333333333334,0.5348837209302325
2022,KHOUALKA,CITRUS VOLKAMERIANA,501520,IMG-00015-43.jpg,18,9,8,1,10,0.8888888888888888,0.4444444444444444
2022,KHOUALKA,CITRUS VOLKAMERIANA,501520,IMG-00020-43.jpg,48,30,29,1,19,0.9666666666666668,0.6041666666666666
2022,KHOUALKA,CITRUS VOLKAMERIANA,501540,IMG-00006-43.jpg,38,25,24,1,14,0.96,0.631578947368421
2022,KHOUALKA,CITRUS VOLKAMERIANA,501540,IMG-00012-43.jpg,102,67,66,1,36,0.9850746268656716,0.6470588235294118
2022,KHOUALKA,CITRUS VOLKAMERIANA,501540,IMG-00017-43.jpg,138,56,56,0,82,1.0,0.4057971014492754
2022,KHOUALKA,CITRUS VOLKAMERIANA,501540,IMG-00018-43.jpg,51,26,26,0,25,1.0,0.5098039215686274
2022,KHOUALKA,CITRUS VOLKAMERIANA,501660,IMG-00006-43.jpg,60,31,30,1,30,0.967741935483871,0.5
2022,KHOUALKA,CITRUS VOLKAMERIANA,501660,IMG-00016-43.jpg,63,39,39,0,24,1.0,0.6190476190476191
2022,KHOUALKA,CITRUS VOLKAMERIANA,501660,IMG-00018-43.jpg,112,52,52,0,60,1.0,0.4642857142857143
2022,KHOUALKA,CITRUS VOLKAMERIANA,501660,IMG-00021-43.jpg,90,52,52,0,38,1.0,0.5777777777777777
2022,KHOUALKA,CITRUS VOLKAMERIANA,501680,IMG-00005-43.jpg,179,94,94,0,85,1.0,0.5251396648044693
2022,KHOUALKA,CITRUS VOLKAMERIANA,501680,IMG-00011-43.jpg,101,42,42,0,59,1.0,0.4158415841584158
2022,KHOUALKA,CITRUS VOLKAMERIANA,501680,IMG-00012-43.jpg,76,26,25,1,51,0.9615384615384616,0.3289473684210527
2022,KHOUALKA,CITRUS VOLKAMERIANA,501680,IMG-00016-43.jpg,113,67,67,0,46,1.0,0.5929203539823009
2022,KHOUALKA,CITRUS VOLKAMERIANA,501690,IMG-00032-43.jpg,34,12,11,1,23,0.9166666666666666,0.3235294117647059
2022,KHOUALKA,CITRUS VOLKAMERIANA,501690,IMG-00039-43.jpg,186,93,92,1,94,0.989247311827957,0.4946236559139785
2022,KHOUALKA,CITRUS VOLKAMERIANA,501690,IMG-00047-43.jpg,103,47,47,0,56,1.0,0.4563106796116505
2022,KHOUALKA,CITRUS VOLKAMERIANA,501690,IMG-00049-43.jpg,166,78,78,0,88,1.0,0.4698795180722892
2022,KHOUALKA,CITRUS VOLKAMERIANA,501760,IMG-00001.jpg,94,35,33,2,61,0.9428571428571428,0.351063829787234
2022,KHOUALKA,CITRUS VOLKAMERIANA,501760,IMG-00034-43.jpg,45,11,11,0,34,1.0,0.2444444444444444
2022,KHOUALKA,CITRUS VOLKAMERIANA,501760,IMG-00036-43.jpg,40,16,15,1,25,0.9375,0.375
2022,KHOUALKA,CITRUS VOLKAMERIANA,501760,IMG-00051-43.jpg,92,34,33,1,59,0.9705882352941176,0.358695652173913
2022,ONAGRI,CITRUMELO SACCATON,510910,IMG-00004-44.jpg,73,44,44,0,29,1.0,0.6027397260273972
2022,ONAGRI,CITRUMELO SACCATON,510910,IMG-00008-44.jpg,152,72,72,0,80,1.0,0.4736842105263158
2022,ONAGRI,CITRUMELO SACCATON,510910,IMG-00010-44.jpg,107,62,61,1,46,0.9838709677419356,0.5700934579439252
2022,ONAGRI,CITRUMELO SACCATON,510910,IMG-00011-44.jpg,92,57,56,1,36,0.9824561403508772,0.6086956521739131
2022,ONAGRI,CITRUMELO SACCATON,510950,IMG-00006-44.jpg,70,45,45,0,25,1.0,0.6428571428571429
2022,ONAGRI,CITRUMELO SACCATON,510950,IMG-00008-44.jpg,75,38,38,0,37,1.0,0.5066666666666667
2022,ONAGRI,CITRUMELO SACCATON,510950,IMG-00009-44.jpg,85,51,49,2,36,0.9607843137254902,0.5764705882352941
2022,ONAGRI,CITRUMELO SACCATON,510950,IMG-00011-44.jpg,135,89,89,0,46,1.0,0.6592592592592592
2022,ONAGRI,MC PONSIRUCE TRIFOLIATA,510980,IMG-00014-44.jpg,67,38,37,1,30,0.9736842105263158,0.5522388059701493
2022,ONAGRI,MC PONSIRUCE TRIFOLIATA,510980,IMG-00015-44.jpg,51,37,36,1,15,0.972972972972973,0.7058823529411765
2022,ONAGRI,MC PONSIRUCE TRIFOLIATA,510980,IMG-00016-44.jpg,99,56,55,1,44,0.9821428571428572,0.5555555555555556
2022,ONAGRI,MC PONSIRUCE TRIFOLIATA,510980,IMG-00019-44.jpg,102,55,54,1,48,0.9818181818181818,0.5294117647058824
2022,ONAGRI,MC PONSIRUCE TRIFOLIATA,510990,IMG-00006-44.jpg,135,77,77,0,58,1.0,0.5703703703703704
2022,ONAGRI,MC PONSIRUCE TRIFOLIATA,510990,IMG-00008-44.jpg,110,72,72,0,38,1.0,0.6545454545454545
2022,ONAGRI,MC PONSIRUCE TRIFOLIATA,510990,IMG-00009-44.jpg,85,54,52,2,33,0.9629629629629628,0.611764705882353
2022,ONAGRI,MC PONSIRUCE TRIFOLIATA,510990,IMG-00024-44.jpg,65,35,34,1,31,0.9714285714285714,0.5230769230769231
2022,ONAGRI,MC PONSIRUCE TRIFOLIATA,511030,IMG-00007-44.jpg,100,77,75,2,25,0.974025974025974,0.75
2022,ONAGRI,MC PONSIRUCE TRIFOLIATA,511030,IMG-00016-44.jpg,63,46,46,0,17,1.0,0.7301587301587301
2022,ONAGRI,MC PONSIRUCE TRIFOLIATA,511030,IMG-00022-44.jpg,98,73,73,0,25,1.0,0.7448979591836735
2022,ONAGRI,MC PONSIRUCE TRIFOLIATA,511030,IMG-00027-44.jpg,82,62,62,0,20,1.0,0.7560975609756098
2022,ONAGRI,MS PONSIRUCE TRIFOLIATA,511040,IMG-00004-44.jpg,77,54,54,0,23,1.0,0.7012987012987013
2022,ONAGRI,MS PONSIRUCE TRIFOLIATA,511040,IMG-00014-44.jpg,48,27,27,0,21,1.0,0.5625
2022,ONAGRI,MS PONSIRUCE TRIFOLIATA,511040,IMG-00016-44.jpg,71,43,42,1,29,0.9767441860465116,0.5915492957746479
2022,ONAGRI,MS PONSIRUCE TRIFOLIATA,511040,IMG-00025-44.jpg,56,31,31,0,25,1.0,0.5535714285714286
2022,ONAGRI,FUZHU,511050,IMG-00004-44.jpg,109,61,58,3,51,0.9508196721311476,0.5321100917431193
2022,ONAGRI,FUZHU,511050,IMG-00006-44.jpg,142,79,77,2,65,0.9746835443037974,0.5422535211267606
2022,ONAGRI,FUZHU,511050,IMG-00011-44.jpg,172,125,122,3,50,0.976,0.7093023255813954
2022,ONAGRI,FUZHU,511050,IMG-00022-44.jpg,194,128,127,1,67,0.9921875,0.654639175257732
2022,ONAGRI,MS PONSIRUCE TRIFOLIATA,511060,IMG-00007-44.jpg,115,78,78,0,37,1.0,0.6782608695652174
2022,ONAGRI,MS PONSIRUCE TRIFOLIATA,511060,IMG-00016-44.jpg,102,61,59,2,43,0.9672131147540984,0.5784313725490197
2022,ONAGRI,MS PONSIRUCE TRIFOLIATA,511060,IMG-00017-44.jpg,59,29,29,0,30,1.0,0.4915254237288136
2022,ONAGRI,MS PONSIRUCE TRIFOLIATA,511060,IMG-00019-44.jpg,108,67,65,2,43,0.9701492537313432,0.6018518518518519
2022,ONAGRI,FUZHU,511070,IMG-00006-44.jpg,82,65,63,2,19,0.9692307692307692,0.7682926829268293
2022,ONAGRI,FUZHU,511070,IMG-00016-44.jpg,96,64,63,1,33,0.984375,0.65625
2022,ONAGRI,FUZHU,511070,IMG-00018-44.jpg,93,61,59,2,34,0.9672131147540984,0.6344086021505376
2022,ONAGRI,FUZHU,511070,IMG-00019-44.jpg,142,93,91,2,51,0.978494623655914,0.6408450704225352
