compagnie,Domaine,Porte-greffe,parcelle,Filename,True_count,detect_count,TP,FP,FN,Precision,Recall
2022,SAOUDA,BIGARADIER,10010,IMG-00011-45.jpg,28,29,27,2,1,0.9310344827586208,0.9642857142857144
2022,SAOUDA,BIGARADIER,10010,IMG-00012-45.jpg,27,28,26,2,1,0.9285714285714286,0.9629629629629628
2022,SAOUDA,BIGARADIER,10010,IMG-00014-45.jpg,50,50,44,6,6,0.88,0.88
2022,SAOUDA,BIGARADIER,10010,IMG-00018-45.jpg,30,24,24,0,6,1.0,0.8
2022,SAOUDA,BIGARADIER,10010,IMG-00020-45.jpg,31,31,27,4,4,0.8709677419354839,0.8709677419354839
2024,SAOUDA,BIGARADIER,10010,IMG-23410.jpg,85,21,20,1,65,0.9523809523809524,0.2352941176470588
2024,SAOUDA,BIGARADIER,10010,IMG-23417.jpg,86,24,24,0,62,1.0,0.2790697674418605
2024,SAOUDA,BIGARADIER,10010,IMG-23430.jpg,74,27,27,0,47,1.0,0.3648648648648649
2024,SAOUDA,BIGARADIER,10010,IMG-23647.jpg,95,35,34,1,61,0.9714285714285714,0.3578947368421053
2024,SAOUDA,BIGARADIER,10010,IMG-23672.jpg,47,10,9,1,38,0.9,0.1914893617021277
2024,SAOUDA,BIGARADIER,10010,IMG-23707.jpg,30,15,15,0,15,1.0,0.5
2024,SAOUDA,BIGARADIER,10010,IMG-23709.jpg,31,12,12,0,19,1.0,0.3870967741935484
2024,SAOUDA,BIGARADIER,10010,IMG-23711.jpg,79,25,21,4,58,0.84,0.2658227848101266
2022,SAOUDA,MACROPHYLLA,10030,IMG-00158-45.jpg,101,112,93,19,8,0.8303571428571429,0.9207920792079208
2022,SAOUDA,MACROPHYLLA,10030,IMG-00159-45.jpg,155,156,143,13,12,0.9166666666666666,0.9225806451612903
2022,SAOUDA,MACROPHYLLA,10030,IMG-00162-45.jpg,119,121,110,11,9,0.9090909090909092,0.9243697478991596
2022,SAOUDA,MACROPHYLLA,10030,IMG-00169-45.jpg,72,73,64,9,8,0.8767123287671232,0.8888888888888888
2022,SAOUDA,MACROPHYLLA,10031,IMG-00002-45.jpg,46,46,41,5,5,0.8913043478260869,0.8913043478260869
2022,SAOUDA,MACROPHYLLA,10031,IMG-00084-45.jpg,41,48,39,9,2,0.8125,0.951219512195122
2022,SAOUDA,MACROPHYLLA,10031,IMG-00450-45.jpg,27,27,21,6,6,0.7777777777777778,0.7777777777777778
2022,SAOUDA,MACROPHYLLA,10031,IMG-00451-45.jpg,34,39,27,12,7,0.6923076923076923,0.7941176470588235
2022,SAOUDA,MACROPHYLLA,10031,IMG-00464-45.jpg,33,30,22,8,11,0.7333333333333333,0.6666666666666666
2022,ONAGRI,CITRUS VOLKAMERIANA,10101,IMG-00003-39.jpg,120,125,115,10,5,0.92,0.9583333333333334
2022,ONAGRI,CITRUS VOLKAMERIANA,10101,IMG-00010-39.jpg,85,84,76,8,9,0.9047619047619048,0.8941176470588236
2024,ONAGRI,CITRUS VOLKAMERIANA,10101,IMG-10523.jpg,288,221,218,3,70,0.986425339366516,0.7569444444444444
2024,ONAGRI,CITRUS VOLKAMERIANA,10101,IMG-10545.jpg,98,73,73,0,25,1.0,0.7448979591836735
2024,ONAGRI,CITRUS VOLKAMERIANA,10101,IMG-10558.jpg,143,95,93,2,50,0.9789473684210528,0.6503496503496503
2022,ONAGRI,CITRUS VOLKAMERIANA,10102,IMG-00003-39.jpg,48,49,46,3,2,0.9387755102040816,0.9583333333333334
2024,ONAGRI,CITRUS VOLKAMERIANA,10102,IMG-10637.jpg,140,105,105,0,35,1.0,0.75
2024,ONAGRI,CITRUS VOLKAMERIANA,10102,IMG-10658.jpg,163,129,126,3,37,0.9767441860465116,0.7730061349693251
2022,ONAGRI,CITRUS VOLKAMERIANA,10103,IMG-00003-39.jpg,215,202,191,11,24,0.9455445544554456,0.8883720930232558
2022,ONAGRI,CITRUS VOLKAMERIANA,10103,IMG-00008-39.jpg,195,192,176,16,19,0.9166666666666666,0.9025641025641026
2024,ONAGRI,CITRUS VOLKAMERIANA,10103,IMG-10614.jpg,134,104,102,2,32,0.9807692307692308,0.7611940298507462
2024,ONAGRI,CITRUS VOLKAMERIANA,10103,IMG-10630.jpg,213,170,163,7,50,0.9588235294117649,0.7652582159624414
2024,ONAGRI,CITRUS VOLKAMERIANA,10103,IMG-10631.jpg,134,92,90,2,44,0.9782608695652174,0.6716417910447762
2022,ONAGRI,CITRUS VOLKAMERIANA,10104,IMG-00004-39.jpg,65,71,59,12,6,0.8309859154929577,0.9076923076923076
2022,ONAGRI,CITRUS VOLKAMERIANA,10104,IMG-00008-39.jpg,69,75,61,14,8,0.8133333333333334,0.8840579710144928
2024,ONAGRI,CITRUS VOLKAMERIANA,10104,IMG-11267.jpg,22,13,12,1,10,0.9230769230769232,0.5454545454545454
2024,ONAGRI,CITRUS VOLKAMERIANA,10104,IMG-11327.jpg,128,97,94,3,34,0.9690721649484536,0.734375
2024,ONAGRI,CITRUS VOLKAMERIANA,10104,IMG-11347.jpg,118,85,84,1,34,0.9882352941176472,0.711864406779661
2024,ONAGRI,CITRUS VOLKAMERIANA,10104,IMG-11366.jpg,351,246,241,5,110,0.9796747967479674,0.6866096866096866
2024,ONAGRI,CITRUS VOLKAMERIANA,10104,IMG-11386.jpg,99,71,69,2,30,0.971830985915493,0.696969696969697
2022,ONAGRI,CITRUS VOLKAMERIANA,10105,IMG-00004-39.jpg,17,19,15,4,2,0.7894736842105263,0.8823529411764706
2022,ONAGRI,CITRUS VOLKAMERIANA,10105,IMG-00005-39.jpg,68,64,59,5,9,0.921875,0.8676470588235294
2022,ONAGRI,CITRUS VOLKAMERIANA,10108,IMG-00003-39.jpg,61,60,55,5,6,0.9166666666666666,0.9016393442622952
2022,ONAGRI,CITRUS VOLKAMERIANA,10108,IMG-00007-39.jpg,69,65,62,3,7,0.953846153846154,0.8985507246376812
2022,ONAGRI,CITRUS VOLKAMERIANA,10109,IMG-00003-39.jpg,4,5,4,1,0,0.8,1.0
2022,ONAGRI,CITRUS VOLKAMERIANA,10109,IMG-00008-39.jpg,105,104,95,9,10,0.9134615384615384,0.9047619047619048
2022,KHOUALKA,CITRANGE CARRIZO,10213,IMG-00001.jpg,77,75,68,7,9,0.9066666666666666,0.8831168831168831
2022,KHOUALKA,CITRANGE CARRIZO,10213,IMG-00005-40.jpg,73,80,70,10,3,0.875,0.958904109589041
2022,KHOUALKA,CITRANGE CARRIZO,10213,IMG-00009-40.jpg,14,16,13,3,1,0.8125,0.9285714285714286
2022,KHOUALKA,CITRANGE CARRIZO,10213,IMG-00014-40.jpg,21,22,18,4,3,0.8181818181818182,0.8571428571428571
2022,KHOUALKA,CITRANGE CARRIZO,10213,IMG-00028-40.jpg,47,51,44,7,3,0.8627450980392157,0.9361702127659576
2022,KHOUALKA,CITRANGE CARRIZO,10213,IMG-00034-40.jpg,48,48,43,5,5,0.8958333333333334,0.8958333333333334
2022,KHOUALKA,CITRANGE CARRIZO,10213,IMG-00035-40.jpg,37,37,34,3,3,0.918918918918919,0.918918918918919
2022,KHOUALKA,CITRANGE CARRIZO,10213,IMG-00036-40.jpg,47,52,44,8,3,0.8461538461538461,0.9361702127659576
2022,KHOUALKA,CITRANGE CARRIZO,10213,IMG-00042-40.jpg,22,25,22,3,0,0.88,1.0
2022,KHOUALKA,CITRANGE CARRIZO,10213,IMG-00047-40.jpg,70,62,59,3,11,0.9516129032258064,0.8428571428571429
2022,KHOUALKA,CITRANGE CARRIZO,10213,IMG-00054-40.jpg,33,35,28,7,5,0.8,0.8484848484848485
2022,KHOUALKA,CITRANGE CARRIZO,10213,IMG-00055-40.jpg,93,90,86,4,7,0.9555555555555556,0.9247311827956988
2022,KHOUALKA,CITRANGE CARRIZO,10213,IMG-00061-40.jpg,113,112,103,9,10,0.9196428571428572,0.911504424778761
2022,KHOUALKA,CITRANGE CARRIZO,10213,IMG-00066-40.jpg,48,50,43,7,5,0.86,0.8958333333333334
2024,KHOUALKA,CITRANGE CARRIZO,10213,IMG-12628.jpg,119,103,98,5,21,0.9514563106796116,0.8235294117647058
2024,KHOUALKA,CITRANGE CARRIZO,10213,IMG-12774.jpg,118,95,91,4,27,0.9578947368421052,0.7711864406779662
2024,KHOUALKA,CITRANGE CARRIZO,10213,IMG-12780.jpg,44,43,38,5,6,0.8837209302325582,0.8636363636363636
2024,KHOUALKA,CITRANGE CARRIZO,10213,IMG-12791.jpg,166,117,115,2,51,0.9829059829059827,0.6927710843373494
2024,KHOUALKA,CITRANGE CARRIZO,10213,IMG-12834.jpg,57,42,40,2,17,0.9523809523809524,0.7017543859649122
2024,KHOUALKA,CITRANGE CARRIZO,10213,IMG-12945.jpg,130,106,105,1,25,0.9905660377358492,0.8076923076923077
2022,OUARGHA,MACROPHYLLA,11010,IMG-00001.jpg,40,40,38,2,2,0.95,0.95
2022,OUARGHA,MACROPHYLLA,11010,IMG-00015-41.jpg,24,22,19,3,5,0.8636363636363636,0.7916666666666666
2022,OUARGHA,MACROPHYLLA,11010,IMG-00019-41.jpg,20,22,17,5,3,0.7727272727272727,0.85
2022,OUARGHA,MACROPHYLLA,11010,IMG-00024-41.jpg,21,21,19,2,2,0.9047619047619048,0.9047619047619048
2022,OUARGHA,MACROPHYLLA,11020,IMG-00017-41.jpg,51,50,48,2,3,0.96,0.9411764705882352
2022,OUARGHA,MACROPHYLLA,11020,IMG-00018-41.jpg,13,13,11,2,2,0.8461538461538461,0.8461538461538461
2022,OUARGHA,CITRANGE CARRIZO,13010,IMG-00067-41.jpg,55,54,50,4,5,0.925925925925926,0.9090909090909092
2022,OUARGHA,CITRANGE CARRIZO,13010,IMG-00086-41.jpg,49,47,45,2,4,0.9574468085106383,0.9183673469387756
2022,OUARGHA,CITRANGE CARRIZO,13010,IMG-00194-41.jpg,33,38,33,5,0,0.868421052631579,1.0
2022,OUARGHA,CITRANGE CARRIZO,13020,IMG-00023-41.jpg,31,30,28,2,3,0.9333333333333332,0.9032258064516128
2022,OUARGHA,CITRANGE CARRIZO,13020,IMG-00024-41.jpg,18,19,17,2,1,0.8947368421052632,0.9444444444444444
2022,OUARGHA,CITRANGE CARRIZO,13020,IMG-00039-41.jpg,4,5,4,1,0,0.8,1.0
2022,OUARGHA,CITRANGE CARRIZO,13020,IMG-00040-41.jpg,6,5,5,0,1,1.0,0.8333333333333334
2022,OUARGHA,CITRUS VOLKAMERIANA,13030,IMG-00009-41.jpg,18,18,14,4,4,0.7777777777777778,0.7777777777777778
2022,OUARGHA,CITRUS VOLKAMERIANA,13030,IMG-00013-41.jpg,46,45,42,3,4,0.9333333333333332,0.9130434782608696
2022,OUARGHA,CITRUS VOLKAMERIANA,13030,IMG-00027-41.jpg,12,9,9,0,3,1.0,0.75
2022,OUARGHA,CITRUS VOLKAMERIANA,13030,IMG-00029-41.jpg,18,17,14,3,4,0.8235294117647058,0.7777777777777778
2022,OUARGHA,CITRUS VOLKAMERIANA,13030,IMG-00036-41.jpg,16,16,12,4,4,0.75,0.75
2022,OUARGHA,CITRUS VOLKAMERIANA,14010,IMG-00008-41.jpg,40,36,33,3,7,0.9166666666666666,0.825
2022,OUARGHA,CITRUS VOLKAMERIANA,14010,IMG-00010-41.jpg,49,49,45,4,4,0.9183673469387756,0.9183673469387756
2022,OUARGHA,CITRUS VOLKAMERIANA,14010,IMG-00011-41.jpg,47,45,41,4,6,0.9111111111111112,0.8723404255319149
2022,OUARGHA,CITRUS VOLKAMERIANA,14010,IMG-00018-41.jpg,44,49,42,7,2,0.8571428571428571,0.9545454545454546
2022,KHOUALKA,MACROPHYLLA,20118,IMG-00007-40.jpg,44,42,37,5,7,0.8809523809523809,0.8409090909090909
2022,KHOUALKA,MACROPHYLLA,20118,IMG-00008-40.jpg,115,109,100,9,15,0.9174311926605504,0.8695652173913043
2022,KHOUALKA,MACROPHYLLA,20118,IMG-00022-40.jpg,113,103,100,3,13,0.970873786407767,0.8849557522123894
2022,KHOUALKA,MACROPHYLLA,20118,IMG-00033-40.jpg,58,58,52,6,6,0.896551724137931,0.896551724137931
2022,KHOUALKA,MACROPHYLLA,20118,IMG-00037-40.jpg,29,29,21,8,8,0.7241379310344828,0.7241379310344828
2022,KHOUALKA,MACROPHYLLA,20118,IMG-00042-40.jpg,137,128,121,7,16,0.9453125,0.8832116788321168
2022,KHOUALKA,MACROPHYLLA,20118,IMG-00046-40.jpg,45,40,36,4,9,0.9,0.8
2022,KHOUALKA,MACROPHYLLA,20118,IMG-00050-40.jpg,48,50,44,6,4,0.88,0.9166666666666666
2022,KHOUALKA,MACROPHYLLA,20118,IMG-00055-40.jpg,52,45,40,5,12,0.8888888888888888,0.7692307692307693
2022,KHOUALKA,MACROPHYLLA,20118,IMG-00061-40.jpg,120,107,99,8,21,0.9252336448598132,0.825
2022,KHOUALKA,MACROPHYLLA,20118,IMG-00062-40.jpg,63,54,51,3,12,0.9444444444444444,0.8095238095238095
2022,KHOUALKA,MACROPHYLLA,20118,IMG-00063-40.jpg,47,49,44,5,3,0.8979591836734694,0.9361702127659576
2022,KHOUALKA,MACROPHYLLA,20118,IMG-00066-40.jpg,84,79,74,5,10,0.9367088607594936,0.8809523809523809
2024,KHOUALKA,MACROPHYLLA,20118,IMG-12691.jpg,22,15,14,1,8,0.9333333333333332,0.6363636363636364
2024,KHOUALKA,MACROPHYLLA,20118,IMG-12729.jpg,56,40,38,2,18,0.95,0.6785714285714286
2024,KHOUALKA,MACROPHYLLA,20118,IMG-12735.jpg,88,64,63,1,25,0.984375,0.7159090909090909
2024,KHOUALKA,MACROPHYLLA,20118,IMG-12748.jpg,107,80,72,8,35,0.9,0.6728971962616822
2024,KHOUALKA,MACROPHYLLA,20118,IMG-12764.jpg,111,99,89,10,22,0.898989898989899,0.8018018018018018
2024,KHOUALKA,MACROPHYLLA,20118,IMG-12808.jpg,113,77,74,3,39,0.961038961038961,0.6548672566371682
2024,KHOUALKA,MACROPHYLLA,20118,IMG-12851.jpg,24,10,10,0,14,1.0,0.4166666666666667
2022,KHOUALKA,MACROPHYLLA,20119,IMG-00005-40.jpg,106,100,91,9,15,0.91,0.8584905660377359
2022,KHOUALKA,MACROPHYLLA,20119,IMG-00008-40.jpg,142,128,119,9,23,0.9296875,0.8380281690140845
2022,KHOUALKA,MACROPHYLLA,20119,IMG-00014-40.jpg,132,130,123,7,9,0.946153846153846,0.9318181818181818
2022,KHOUALKA,BIGARADIER,20132,IMG-00004-40.jpg,181,165,156,9,25,0.9454545454545454,0.861878453038674
2022,KHOUALKA,BIGARADIER,20132,IMG-00025-40.jpg,91,81,78,3,13,0.9629629629629628,0.8571428571428571
2022,KHOUALKA,BIGARADIER,20132,IMG-00028-40.jpg,49,45,42,3,7,0.9333333333333332,0.8571428571428571
2022,KHOUALKA,BIGARADIER,20132,IMG-00035-40.jpg,103,107,98,9,5,0.9158878504672896,0.9514563106796116
2022,KHOUALKA,BIGARADIER,20132,IMG-00039-40.jpg,119,118,109,9,10,0.923728813559322,0.9159663865546218
2022,KHOUALKA,BIGARADIER,20132,IMG-00046-40.jpg,156,150,143,7,13,0.9533333333333334,0.9166666666666666
2022,KHOUALKA,BIGARADIER,20132,IMG-00051-40.jpg,108,99,91,8,17,0.9191919191919192,0.8425925925925926
2022,KHOUALKA,BIGARADIER,20132,IMG-00055-40.jpg,67,59,58,1,9,0.9830508474576272,0.8656716417910447
2022,KHOUALKA,BIGARADIER,20132,IMG-00058-40.jpg,89,83,80,3,9,0.963855421686747,0.898876404494382
2022,KHOUALKA,BIGARADIER,20132,IMG-00059-40.jpg,139,122,116,6,23,0.9508196721311476,0.8345323741007195
2022,KHOUALKA,BIGARADIER,20132,IMG-00060-40.jpg,57,51,47,4,10,0.9215686274509804,0.8245614035087719
2022,KHOUALKA,BIGARADIER,20132,IMG-00064-40.jpg,117,105,100,5,17,0.9523809523809524,0.8547008547008547
2022,KHOUALKA,BIGARADIER,20132,IMG-00075-40.jpg,69,67,61,6,8,0.9104477611940298,0.8840579710144928
2022,ONAGRI,BIGARADIER,20139,IMG-00021-39.jpg,93,91,88,3,5,0.967032967032967,0.946236559139785
2024,KHOUALKA,CITRUS VOLKAMERIANA,20205,IMG-12040.jpg,123,94,87,7,36,0.925531914893617,0.7073170731707317
2024,KHOUALKA,CITRUS VOLKAMERIANA,20205,IMG-12058.jpg,116,114,103,11,13,0.9035087719298246,0.8879310344827587
2024,KHOUALKA,CITRUS VOLKAMERIANA,20207,IMG-11892.jpg,94,72,67,5,27,0.9305555555555556,0.7127659574468085
2024,KHOUALKA,CITRUS VOLKAMERIANA,20207,IMG-11921.jpg,264,172,168,4,96,0.9767441860465116,0.6363636363636364
2024,KHOUALKA,CITRUS VOLKAMERIANA,20207,IMG-11927.jpg,195,139,137,2,58,0.9856115107913668,0.7025641025641025
2024,KHOUALKA,CITRUS VOLKAMERIANA,20207,IMG-11961.jpg,113,90,87,3,26,0.9666666666666668,0.7699115044247787
2024,KHOUALKA,CITRUS VOLKAMERIANA,20207,IMG-11972.jpg,94,74,67,7,27,0.9054054054054054,0.7127659574468085
2024,KHOUALKA,CITRUS VOLKAMERIANA,20207,IMG-11981.jpg,81,56,52,4,29,0.9285714285714286,0.6419753086419753
2022,SAOUDA,CITRUS VOLKAMERIANA,21020,IMG-00033-45.jpg,67,84,65,19,2,0.7738095238095238,0.9701492537313432
2022,SAOUDA,CITRUS VOLKAMERIANA,21020,IMG-00087-45.jpg,21,24,15,9,6,0.625,0.7142857142857143
2022,SAOUDA,CITRUS VOLKAMERIANA,21020,IMG-00138-45.jpg,40,52,40,12,0,0.7692307692307693,1.0
2022,SAOUDA,CITRUS VOLKAMERIANA,21020,IMG-00145-45.jpg,37,43,36,7,1,0.8372093023255814,0.972972972972973
2022,SAOUDA,CITRUS VOLKAMERIANA,21020,IMG-00155-45.jpg,38,47,37,10,1,0.7872340425531915,0.9736842105263158
2022,SAOUDA,CITRUS VOLKAMERIANA,21030,IMG-00521-45.jpg,31,33,27,6,4,0.8181818181818182,0.8709677419354839
2022,SAOUDA,CITRUS VOLKAMERIANA,21030,IMG-00524-45.jpg,71,72,64,8,7,0.8888888888888888,0.9014084507042254
2022,SAOUDA,CITRUS VOLKAMERIANA,21030,IMG-00536-45.jpg,41,47,35,12,6,0.7446808510638298,0.8536585365853658
2022,SAOUDA,CITRUS VOLKAMERIANA,21030,IMG-00537-45.jpg,52,50,44,6,8,0.88,0.8461538461538461
2022,SAOUDA,CITRUS VOLKAMERIANA,22020,IMG-00053-45.jpg,39,34,30,4,9,0.8823529411764706,0.7692307692307693
2022,SAOUDA,CITRUS VOLKAMERIANA,22020,IMG-00059-45.jpg,46,46,35,11,11,0.7608695652173914,0.7608695652173914
2022,SAOUDA,CITRUS VOLKAMERIANA,22020,IMG-00060-45.jpg,48,58,47,11,1,0.8103448275862069,0.9791666666666666
2022,SAOUDA,CITRUS VOLKAMERIANA,22020,IMG-00062-45.jpg,50,53,49,4,1,0.9245283018867924,0.98
2022,SAOUDA,CITRUS VOLKAMERIANA,22030,IMG-00062-45.jpg,62,62,59,3,3,0.9516129032258064,0.9516129032258064
2022,SAOUDA,CITRUS VOLKAMERIANA,22030,IMG-00063-45.jpg,83,78,74,4,9,0.9487179487179488,0.891566265060241
2022,SAOUDA,CITRUS VOLKAMERIANA,22030,IMG-00065-45.jpg,58,61,53,8,5,0.8688524590163934,0.913793103448276
2022,SAOUDA,CITRUS VOLKAMERIANA,22030,IMG-00068-45.jpg,66,62,55,7,11,0.8870967741935484,0.8333333333333334
2022,SAOUDA,CITRUS VOLKAMERIANA,23020,IMG-00024-45.jpg,47,47,42,5,5,0.8936170212765957,0.8936170212765957
2022,SAOUDA,CITRUS VOLKAMERIANA,23020,IMG-00032-45.jpg,33,33,30,3,3,0.9090909090909092,0.9090909090909092
2022,SAOUDA,CITRUS VOLKAMERIANA,23020,IMG-00074-45.jpg,28,21,19,2,9,0.9047619047619048,0.6785714285714286
2022,SAOUDA,CITRUS VOLKAMERIANA,23020,IMG-00079-45.jpg,28,33,24,9,4,0.7272727272727273,0.8571428571428571
2022,SAOUDA,CITRUS VOLKAMERIANA,23030,IMG-00014-45.jpg,25,26,20,6,5,0.7692307692307693,0.8
2022,SAOUDA,CITRUS VOLKAMERIANA,23030,IMG-00034-45.jpg,43,47,40,7,3,0.851063829787234,0.9302325581395348
2022,SAOUDA,CITRUS VOLKAMERIANA,23030,IMG-00069-45.jpg,28,29,21,8,7,0.7241379310344828,0.75
2022,SAOUDA,CITRUS VOLKAMERIANA,23030,IMG-00079-45.jpg,50,54,43,11,7,0.7962962962962963,0.86
2022,SAOUDA,CITRANGE CARRIZO,24010,IMG-00097-45.jpg,59,61,56,5,3,0.918032786885246,0.9491525423728814
2022,SAOUDA,CITRANGE CARRIZO,24010,IMG-00101-45.jpg,27,28,24,4,3,0.8571428571428571,0.8888888888888888
2022,SAOUDA,CITRANGE CARRIZO,24010,IMG-00111-45.jpg,54,55,51,4,3,0.9272727272727272,0.9444444444444444
2022,SAOUDA,CITRANGE CARRIZO,24010,IMG-00112-45.jpg,40,37,35,2,5,0.945945945945946,0.875
2022,SAOUDA,CITRANGE CARRIZO,25010,IMG-00006-45.jpg,55,50,47,3,8,0.94,0.8545454545454545
2022,SAOUDA,CITRANGE CARRIZO,25010,IMG-00007-45.jpg,77,75,70,5,7,0.9333333333333332,0.9090909090909092
2022,SAOUDA,CITRANGE CARRIZO,25010,IMG-00010-45.jpg,53,53,49,4,4,0.9245283018867924,0.9245283018867924
2022,SAOUDA,CITRANGE CARRIZO,25010,IMG-00011-45.jpg,26,27,26,1,0,0.9629629629629628,1.0
2022,SAOUDA,CITRANGE CARRIZO,26010,IMG-00008-45.jpg,39,40,38,2,1,0.95,0.9743589743589745
2022,SAOUDA,CITRANGE CARRIZO,26010,IMG-00013-45.jpg,36,34,32,2,4,0.9411764705882352,0.8888888888888888
2022,SAOUDA,CITRANGE CARRIZO,26010,IMG-00018-45.jpg,43,39,37,2,6,0.9487179487179488,0.8604651162790697
2022,SAOUDA,CITRANGE CARRIZO,26010,IMG-00020-45.jpg,44,42,40,2,4,0.9523809523809524,0.9090909090909092
2022,KHOUALKA,CITRANGE CARRIZO,30138,IMG-00002-40.jpg,39,38,34,4,5,0.8947368421052632,0.8717948717948718
2022,KHOUALKA,CITRANGE CARRIZO,30138,IMG-00003-40.jpg,59,53,49,4,10,0.9245283018867924,0.8305084745762712
2022,KHOUALKA,CITRANGE CARRIZO,30138,IMG-00005-40.jpg,58,47,42,5,16,0.8936170212765957,0.7241379310344828
2022,KHOUALKA,CITRANGE CARRIZO,30138,IMG-00008-40.jpg,32,27,25,2,7,0.925925925925926,0.78125
2022,KHOUALKA,CITRANGE CARRIZO,30138,IMG-00011-40.jpg,26,27,25,2,1,0.925925925925926,0.9615384615384616
2022,KHOUALKA,CITRANGE CARRIZO,30138,IMG-00019-40.jpg,2,3,2,1,0,0.6666666666666666,1.0
2022,KHOUALKA,CITRANGE CARRIZO,30138,IMG-00037-40.jpg,30,30,28,2,2,0.9333333333333332,0.9333333333333332
2022,KHOUALKA,CITRANGE CARRIZO,30138,IMG-00040-40.jpg,41,42,40,2,1,0.9523809523809524,0.975609756097561
2022,KHOUALKA,CITRANGE CARRIZO,30138,IMG-00043-40.jpg,28,27,23,4,5,0.8518518518518519,0.8214285714285714
2022,KHOUALKA,CITRANGE CARRIZO,30138,IMG-00044-40.jpg,99,93,86,7,13,0.9247311827956988,0.8686868686868687
2022,KHOUALKA,CITRANGE CARRIZO,30138,IMG-00048-40.jpg,37,37,32,5,5,0.8648648648648649,0.8648648648648649
2022,KHOUALKA,CITRANGE CARRIZO,30138,IMG-00057-40.jpg,73,69,59,10,14,0.855072463768116,0.8082191780821918
2022,KHOUALKA,CITRANGE CARRIZO,30138,IMG-00063-40.jpg,89,85,79,6,10,0.9294117647058824,0.8876404494382022
2022,ONAGRI,CITRUS VOLKAMERIANA,30145,IMG-00018-39.jpg,219,227,208,19,11,0.9162995594713657,0.9497716894977168
2022,ONAGRI,CITRUS VOLKAMERIANA,30145,IMG-00043-39.jpg,64,66,59,7,5,0.8939393939393939,0.921875
2022,ONAGRI,CITRUS VOLKAMERIANA,30146,IMG-00008-39.jpg,262,272,252,20,10,0.9264705882352942,0.9618320610687024
2022,ONAGRI,CITRUS VOLKAMERIANA,30146,IMG-00045-39.jpg,190,209,178,31,12,0.8516746411483254,0.936842105263158
2022,ONAGRI,CITRUS VOLKAMERIANA,30147,IMG-00002-39.jpg,269,300,259,41,10,0.8633333333333333,0.9628252788104088
2022,ONAGRI,CITRUS VOLKAMERIANA,30147,IMG-00008-39.jpg,172,190,168,22,4,0.8842105263157894,0.9767441860465116
2022,ONAGRI,CITRUS VOLKAMERIANA,30148,IMG-00016-40.jpg,88,79,74,5,14,0.9367088607594936,0.8409090909090909
2022,ONAGRI,CITRUS VOLKAMERIANA,30148,IMG-00047-40.jpg,34,23,22,1,12,0.9565217391304348,0.6470588235294118
2022,ONAGRI,CITRUS VOLKAMERIANA,30149,IMG-00018-39.jpg,151,162,142,20,9,0.8765432098765432,0.9403973509933776
2022,ONAGRI,CITRUS VOLKAMERIANA,30149,IMG-00027-39.jpg,226,225,202,23,24,0.8977777777777778,0.8938053097345132
2022,ONAGRI,CITRUS VOLKAMERIANA,30151,IMG-00012-39.jpg,185,202,170,32,15,0.8415841584158416,0.918918918918919
2022,ONAGRI,CITRUS VOLKAMERIANA,30151,IMG-00033-39.jpg,214,227,202,25,12,0.8898678414096917,0.9439252336448598
2024,ONAGRI,CITRUS VOLKAMERIANA,30151,IMG-21881.jpg,73,51,48,3,25,0.9411764705882352,0.6575342465753424
2024,ONAGRI,CITRUS VOLKAMERIANA,30151,IMG-21935.jpg,179,88,88,0,91,1.0,0.4916201117318436
2024,ONAGRI,CITRUS VOLKAMERIANA,30151,IMG-21936.jpg,93,50,50,0,43,1.0,0.5376344086021505
2022,ONAGRI,CITRUS VOLKAMERIANA,30152,IMG-00016-39.jpg,39,31,26,5,13,0.8387096774193549,0.6666666666666666
2022,ONAGRI,CITRUS VOLKAMERIANA,30152,IMG-00019-39.jpg,139,147,129,18,10,0.8775510204081632,0.9280575539568344
2022,ONAGRI,CITRUS VOLKAMERIANA,30153,IMG-00001.jpg,157,158,142,16,15,0.8987341772151899,0.9044585987261148
2022,ONAGRI,CITRUS VOLKAMERIANA,30153,IMG-00007-39.jpg,127,122,115,7,12,0.9426229508196722,0.905511811023622
2022,ONAGRI,CITRUS VOLKAMERIANA,30153,IMG-00013-39.jpg,159,145,140,5,19,0.9655172413793104,0.8805031446540881
2022,ONAGRI,CITRUS VOLKAMERIANA,30153,IMG-00040-39.jpg,153,148,142,6,11,0.9594594594594594,0.9281045751633988
2022,ONAGRI,CITRUS VOLKAMERIANA,30154,IMG-00017-39.jpg,160,165,157,8,3,0.9515151515151516,0.98125
2022,ONAGRI,CITRUS VOLKAMERIANA,30154,IMG-00027-39.jpg,220,220,209,11,11,0.95,0.95
2022,ONAGRI,CITRUS VOLKAMERIANA,30154,IMG-00033-39.jpg,51,54,49,5,2,0.9074074074074074,0.9607843137254902
2022,ONAGRI,CITRUS VOLKAMERIANA,30154,IMG-00036-39.jpg,137,140,129,11,8,0.9214285714285714,0.9416058394160584
2022,ONAGRI,CITRUS VOLKAMERIANA,30154,IMG-00038-39.jpg,242,252,233,19,9,0.9246031746031746,0.962809917355372
2022,ONAGRI,CITRUS VOLKAMERIANA,30154,IMG-00041-39.jpg,272,275,258,17,14,0.9381818181818182,0.9485294117647058
2022,ONAGRI,CITRUS VOLKAMERIANA,30154,IMG-00044-39.jpg,141,151,133,18,8,0.8807947019867549,0.9432624113475178
2022,ONAGRI,BIGARADIER,30155,IMG-00002-39.jpg,139,139,130,9,9,0.935251798561151,0.935251798561151
2022,ONAGRI,BIGARADIER,30155,IMG-00003-39.jpg,115,114,108,6,7,0.9473684210526316,0.9391304347826088
2022,ONAGRI,BIGARADIER,30155,IMG-00006-39.jpg,44,41,39,2,5,0.951219512195122,0.8863636363636364
2022,ONAGRI,BIGARADIER,30155,IMG-00011-39.jpg,100,94,89,5,11,0.946808510638298,0.89
2022,ONAGRI,BIGARADIER,30155,IMG-00019-39.jpg,142,139,131,8,11,0.9424460431654677,0.9225352112676056
2022,ONAGRI,BIGARADIER,30155,IMG-00026-39.jpg,124,116,110,6,14,0.9482758620689656,0.8870967741935484
2022,ONAGRI,BIGARADIER,30155,IMG-00032-39.jpg,81,83,75,8,6,0.9036144578313252,0.925925925925926
2022,ONAGRI,BIGARADIER,30155,IMG-00039-39.jpg,19,16,15,1,4,0.9375,0.7894736842105263
2022,ONAGRI,BIGARADIER,30155,IMG-00043-39.jpg,130,140,126,14,4,0.9,0.9692307692307692
2022,ONAGRI,CITRUS VOLKAMERIANA,30157,IMG-00003-39.jpg,227,220,213,7,14,0.968181818181818,0.9383259911894272
2022,ONAGRI,CITRUS VOLKAMERIANA,30157,IMG-00012-39.jpg,283,284,260,24,23,0.9154929577464788,0.9187279151943464
2022,ONAGRI,CITRUS VOLKAMERIANA,30157,IMG-00032-39.jpg,64,70,60,10,4,0.8571428571428571,0.9375
2022,ONAGRI,CITRUS VOLKAMERIANA,30157,IMG-00035-39.jpg,159,151,144,7,15,0.9536423841059604,0.9056603773584906
2022,KHOUALKA,CITRUS VOLKAMERIANA,30235,IMG-00001.jpg,93,89,82,7,11,0.9213483146067416,0.8817204301075269
2022,KHOUALKA,CITRUS VOLKAMERIANA,30235,IMG-00003-40.jpg,37,40,35,5,2,0.875,0.945945945945946
2022,KHOUALKA,CITRUS VOLKAMERIANA,30235,IMG-00009-40.jpg,103,102,97,5,6,0.9509803921568628,0.941747572815534
2022,KHOUALKA,CITRUS VOLKAMERIANA,30235,IMG-00013-40.jpg,90,86,79,7,11,0.9186046511627908,0.8777777777777778
2022,KHOUALKA,CITRUS VOLKAMERIANA,30235,IMG-00026-40.jpg,122,122,115,7,7,0.9426229508196722,0.9426229508196722
2022,KHOUALKA,CITRUS VOLKAMERIANA,30235,IMG-00047-40.jpg,47,38,35,3,12,0.9210526315789472,0.7446808510638298
2022,KHOUALKA,CITRUS VOLKAMERIANA,30235,IMG-00048-40.jpg,90,91,78,13,12,0.8571428571428571,0.8666666666666667
2022,KHOUALKA,CITRUS VOLKAMERIANA,30235,IMG-00049-40.jpg,44,51,38,13,6,0.7450980392156863,0.8636363636363636
2022,KHOUALKA,CITRUS VOLKAMERIANA,30235,IMG-00050-40.jpg,84,78,72,6,12,0.9230769230769232,0.8571428571428571
2022,KHOUALKA,CITRUS VOLKAMERIANA,30235,IMG-00052-40.jpg,98,91,86,5,12,0.945054945054945,0.8775510204081632
2022,KHOUALKA,CITRUS VOLKAMERIANA,30235,IMG-00057-40.jpg,80,69,68,1,12,0.9855072463768116,0.85
2022,KHOUALKA,CITRUS VOLKAMERIANA,30235,IMG-00064-40.jpg,38,32,27,5,11,0.84375,0.7105263157894737
2022,KHOUALKA,CITRUS VOLKAMERIANA,30235,IMG-00067-40.jpg,107,93,91,2,16,0.978494623655914,0.8504672897196262
2022,KHOUALKA,CITRUS VOLKAMERIANA,30235,IMG-00069-40.jpg,34,35,30,5,4,0.8571428571428571,0.8823529411764706
2022,KHOUALKA,CITRUS VOLKAMERIANA,30235,IMG-00075-40.jpg,95,91,82,9,13,0.9010989010989012,0.8631578947368421
2022,KHOUALKA,BIGARADIER,40141,IMG-00006-40.jpg,7,7,4,3,3,0.5714285714285714,0.5714285714285714
2022,KHOUALKA,BIGARADIER,40141,IMG-00007-40.jpg,20,13,11,2,9,0.8461538461538461,0.55
2022,KHOUALKA,BIGARADIER,40141,IMG-00008-40.jpg,15,14,11,3,4,0.7857142857142857,0.7333333333333333
2022,ONAGRI,CITRANGE C35,40166,IMG-00009-39.jpg,38,31,30,1,8,0.967741935483871,0.7894736842105263
2022,ONAGRI,CITRANGE C35,40166,IMG-00011-39.jpg,173,156,152,4,21,0.9743589743589745,0.8786127167630058
2022,ONAGRI,CITRANGE C35,40166,IMG-00014-39.jpg,179,169,165,4,14,0.9763313609467456,0.9217877094972068
2022,ONAGRI,CITRANGE C35,40166,IMG-00015-39.jpg,122,115,111,4,11,0.9652173913043478,0.9098360655737704
2022,ONAGRI,CITRANGE C35,40166,IMG-00041-39.jpg,102,95,92,3,10,0.968421052631579,0.9019607843137256
2022,ONAGRI,CITRANGE C35,40167,IMG-00019-39.jpg,197,180,180,0,17,1.0,0.9137055837563453
2022,ONAGRI,CITRANGE C35,40167,IMG-00030-39.jpg,126,115,113,2,13,0.982608695652174,0.8968253968253969
2022,ONAGRI,CITRANGE C35,40167,IMG-00039-39.jpg,217,185,182,3,35,0.9837837837837838,0.8387096774193549
2022,ONAGRI,CITRANGE C35,40171,IMG-00008-39.jpg,109,100,98,2,11,0.98,0.8990825688073395
2022,ONAGRI,CITRANGE C35,40171,IMG-00037-39.jpg,94,80,80,0,14,1.0,0.851063829787234
2022,ONAGRI,CITRANGE C35,40171,IMG-00040-39.jpg,149,131,126,5,23,0.9618320610687024,0.8456375838926175
2022,ONAGRI,CITRANGE C35,40172,IMG-00012-39.jpg,89,79,77,2,12,0.9746835443037974,0.8651685393258427
2022,ONAGRI,CITRANGE C35,40172,IMG-00025-39.jpg,109,95,93,2,16,0.9789473684210528,0.8532110091743119
2022,ONAGRI,CITRANGE C35,40172,IMG-00027-39.jpg,103,88,84,4,19,0.9545454545454546,0.8155339805825242
2022,ONAGRI,CITRANGE C35,40173,IMG-00004-39.jpg,133,109,108,1,25,0.9908256880733946,0.8120300751879699
2022,ONAGRI,CITRANGE C35,40173,IMG-00008-39.jpg,57,46,44,2,13,0.9565217391304348,0.7719298245614035
2022,ONAGRI,CITRANGE C35,40173,IMG-00010-39.jpg,53,53,52,1,1,0.981132075471698,0.981132075471698
2022,ONAGRI,CITRANGE C35,40175,IMG-00005-39.jpg,95,79,77,2,18,0.9746835443037974,0.8105263157894737
2022,ONAGRI,CITRANGE C35,40175,IMG-00006-39.jpg,64,62,62,0,2,1.0,0.96875
2022,ONAGRI,CITRANGE C35,40176,IMG-00004-39.jpg,79,73,65,8,14,0.8904109589041096,0.8227848101265823
2022,ONAGRI,CITRANGE C35,40176,IMG-00012-39.jpg,105,100,94,6,11,0.94,0.8952380952380953
2022,ONAGRI,CITRANGE C35,40176,IMG-00014-39.jpg,91,79,71,8,20,0.8987341772151899,0.7802197802197802
2022,ONAGRI,CITRUMELO SACCATON,40177,IMG-00012-39.jpg,89,89,78,11,11,0.8764044943820225,0.8764044943820225
2022,ONAGRI,CITRUMELO SACCATON,40177,IMG-00015-39.jpg,213,210,199,11,14,0.9476190476190476,0.9342723004694836
2022,ONAGRI,CITRUMELO SACCATON,40177,IMG-00037-39.jpg,95,97,86,11,9,0.8865979381443299,0.9052631578947368
2022,ONAGRI,CITRANGE C35,40178,IMG-00013-39.jpg,76,72,71,1,5,0.9861111111111112,0.9342105263157896
2022,ONAGRI,CITRANGE C35,40178,IMG-00027-39.jpg,56,55,53,2,3,0.9636363636363636,0.9464285714285714
2022,ONAGRI,CITRANGE C35,40178,IMG-00031-39.jpg,30,30,29,1,1,0.9666666666666668,0.9666666666666668
2022,ONAGRI,CITRANGE C35,40178,IMG-00032-39.jpg,27,28,24,4,3,0.8571428571428571,0.8888888888888888
2022,ONAGRI,CITRANGE C35,40178,IMG-00033-39.jpg,34,32,31,1,3,0.96875,0.9117647058823528
2022,ONAGRI,CITRANGE C35,40179,IMG-00001.jpg,83,79,77,2,6,0.9746835443037974,0.927710843373494
2022,ONAGRI,CITRANGE C35,40179,IMG-00010-39.jpg,161,159,148,11,13,0.9308176100628932,0.9192546583850932
2022,ONAGRI,CITRANGE C35,40179,IMG-00011-39.jpg,102,102,97,5,5,0.9509803921568628,0.9509803921568628
2022,ONAGRI,CITRANGE C35,40179,IMG-00018-39.jpg,9,9,8,1,1,0.8888888888888888,0.8888888888888888
2022,ONAGRI,CITRUMELO SACCATON,40182,IMG-00004-39.jpg,35,36,34,2,1,0.9444444444444444,0.9714285714285714
2022,ONAGRI,CITRUMELO SACCATON,40182,IMG-00010-39.jpg,52,50,46,4,6,0.92,0.8846153846153846
2022,ONAGRI,CITRUMELO SACCATON,40182,IMG-00015-39.jpg,85,78,72,6,13,0.9230769230769232,0.8470588235294118
2022,ONAGRI,CITRUMELO SACCATON,40183,IMG-00005-39.jpg,68,59,58,1,10,0.9830508474576272,0.8529411764705882
2022,ONAGRI,CITRUMELO SACCATON,40183,IMG-00009-39.jpg,57,58,54,4,3,0.9310344827586208,0.9473684210526316
2022,ONAGRI,CITRUMELO SACCATON,40183,IMG-00010-39.jpg,48,43,40,3,8,0.9302325581395348,0.8333333333333334
2024,KHOUALKA,CITRUS VOLKAMERIANA,50152,IMG-17274.jpg,170,135,131,4,39,0.9703703703703704,0.7705882352941177
2024,KHOUALKA,CITRUS VOLKAMERIANA,50152,IMG-17306.jpg,105,78,77,1,28,0.9871794871794872,0.7333333333333333
2024,KHOUALKA,CITRUS VOLKAMERIANA,50152,IMG-17330.jpg,41,34,32,2,9,0.9411764705882352,0.7804878048780488
2024,KHOUALKA,CITRUS VOLKAMERIANA,50152,IMG-17335.jpg,44,37,35,2,9,0.945945945945946,0.7954545454545454
2024,KHOUALKA,CITRUS VOLKAMERIANA,50152,IMG-17340.jpg,108,79,76,3,32,0.9620253164556962,0.7037037037037037
2024,KHOUALKA,CITRUS VOLKAMERIANA,50152,IMG-17356.jpg,60,41,39,2,21,0.951219512195122,0.65
2024,KHOUALKA,CITRUS VOLKAMERIANA,50152,IMG-17384.jpg,53,30,28,2,25,0.9333333333333332,0.5283018867924528
2024,KHOUALKA,CITRUS VOLKAMERIANA,50154,IMG-17440.jpg,76,66,63,3,13,0.9545454545454546,0.8289473684210527
2024,KHOUALKA,CITRUS VOLKAMERIANA,50154,IMG-17490.jpg,107,78,74,4,33,0.9487179487179488,0.6915887850467289
2024,KHOUALKA,CITRUS VOLKAMERIANA,50154,IMG-17543.jpg,100,68,66,2,34,0.9705882352941176,0.66
2024,KHOUALKA,CITRUS VOLKAMERIANA,50154,IMG-17545.jpg,94,63,61,2,33,0.9682539682539684,0.648936170212766
2024,KHOUALKA,CITRUS VOLKAMERIANA,50154,IMG-17562.jpg,129,107,101,6,28,0.9439252336448598,0.7829457364341085
2024,KHOUALKA,CITRUS VOLKAMERIANA,50154,IMG-17576.jpg,121,91,89,2,32,0.978021978021978,0.7355371900826446
2024,KHOUALKA,CITRUS VOLKAMERIANA,50154,IMG-17585.jpg,171,112,110,2,61,0.9821428571428572,0.6432748538011696
2024,KHOUALKA,CITRUS VOLKAMERIANA,50168,IMG-13980.jpg,174,127,125,2,49,0.984251968503937,0.7183908045977011
2024,KHOUALKA,CITRUS VOLKAMERIANA,50168,IMG-15749.jpg,147,110,106,4,41,0.9636363636363636,0.7210884353741497
2024,KHOUALKA,CITRUS VOLKAMERIANA,50168,IMG-15758.jpg,163,108,104,4,59,0.9629629629629628,0.6380368098159509
2024,KHOUALKA,CITRUS VOLKAMERIANA,50168,IMG-15981.jpg,210,153,151,2,59,0.9869281045751634,0.719047619047619
2024,KHOUALKA,CITRUS VOLKAMERIANA,50168,IMG-15983.jpg,120,90,88,2,32,0.9777777777777776,0.7333333333333333
2024,KHOUALKA,CITRUS VOLKAMERIANA,50176,IMG-16025.jpg,81,56,54,2,27,0.9642857142857144,0.6666666666666666
2024,KHOUALKA,CITRUS VOLKAMERIANA,50176,IMG-16051.jpg,85,55,53,2,32,0.9636363636363636,0.6235294117647059
2024,KHOUALKA,CITRUS VOLKAMERIANA,50176,IMG-16079.jpg,161,114,109,5,52,0.956140350877193,0.6770186335403726
2024,KHOUALKA,CITRUS VOLKAMERIANA,50176,IMG-16095.jpg,101,54,53,1,48,0.9814814814814816,0.5247524752475248
2024,KHOUALKA,CITRUS VOLKAMERIANA,50176,IMG-16105.jpg,43,24,23,1,20,0.9583333333333334,0.5348837209302325
2022,ONAGRI,CITRUMELO SACCATON,50193,IMG-00007-39.jpg,218,207,203,4,15,0.9806763285024156,0.9311926605504588
2022,ONAGRI,CITRUMELO SACCATON,50193,IMG-00016-39.jpg,64,56,51,5,13,0.9107142857142856,0.796875
2022,ONAGRI,CITRUMELO SACCATON,50193,IMG-00018-39.jpg,115,111,104,7,11,0.9369369369369368,0.9043478260869564
2022,ONAGRI,CITRUMELO SACCATON,50193,IMG-00021-39.jpg,62,54,53,1,9,0.9814814814814816,0.8548387096774194
2022,ONAGRI,CITRUMELO SACCATON,50193,IMG-00023-39.jpg,113,108,100,8,13,0.925925925925926,0.8849557522123894
2022,ONAGRI,CITRUMELO SACCATON,50194,IMG-00032-39.jpg,162,150,142,8,20,0.9466666666666668,0.8765432098765432
2022,ONAGRI,CITRUMELO SACCATON,50194,IMG-00034-39.jpg,105,100,93,7,12,0.93,0.8857142857142857
2022,ONAGRI,CITRUMELO SACCATON,50194,IMG-00036-39.jpg,161,150,138,12,23,0.92,0.8571428571428571
2022,ONAGRI,CITRUMELO SACCATON,50194,IMG-00038-39.jpg,100,94,89,5,11,0.946808510638298,0.89
2022,ONAGRI,CITRUMELO SACCATON,50194,IMG-00039-39.jpg,65,64,60,4,5,0.9375,0.9230769230769232
2022,ONAGRI,CITRUMELO SACCATON,50194,IMG-00041-39.jpg,153,150,142,8,11,0.9466666666666668,0.9281045751633988
2022,ONAGRI,CITRUMELO SACCATON,50194,IMG-00051-39.jpg,137,134,121,13,16,0.9029850746268656,0.8832116788321168
2022,ONAGRI,CITRUMELO SACCATON,50194,IMG-00054-39.jpg,111,109,102,7,9,0.9357798165137616,0.918918918918919
2022,ONAGRI,CITRUMELO SACCATON,51091,IMG-00015-39.jpg,85,84,79,5,6,0.9404761904761904,0.9294117647058824
2022,ONAGRI,CITRUMELO SACCATON,51091,IMG-00016-39.jpg,170,158,154,4,16,0.9746835443037974,0.9058823529411764
2022,ONAGRI,CITRUMELO SACCATON,51091,IMG-00018-39.jpg,185,173,163,10,22,0.9421965317919077,0.8810810810810811
2022,ONAGRI,CITRUMELO SACCATON,51091,IMG-00022-39.jpg,135,139,126,13,9,0.9064748201438848,0.9333333333333332
2022,ONAGRI,CITRUMELO SACCATON,51091,IMG-00023-39.jpg,140,126,119,7,21,0.9444444444444444,0.85
2022,ONAGRI,CITRUMELO SACCATON,51091,IMG-00026-39.jpg,149,141,136,5,13,0.9645390070921984,0.912751677852349
2022,ONAGRI,CITRUMELO SACCATON,51091,IMG-00044-39.jpg,168,155,150,5,18,0.967741935483871,0.8928571428571429
2022,ONAGRI,CITRUMELO SACCATON,51095,IMG-00004-39.jpg,201,181,173,8,28,0.9558011049723756,0.8606965174129353
2022,ONAGRI,CITRUMELO SACCATON,51095,IMG-00013-39.jpg,154,141,134,7,20,0.950354609929078,0.8701298701298701
2022,ONAGRI,CITRUMELO SACCATON,51095,IMG-00014-39.jpg,140,139,127,12,13,0.9136690647482014,0.9071428571428573
2022,ONAGRI,CITRUMELO SACCATON,51095,IMG-00015-39.jpg,196,188,179,9,17,0.952127659574468,0.9132653061224488
2022,ONAGRI,CITRUMELO SACCATON,51095,IMG-00024-39.jpg,234,215,208,7,26,0.9674418604651164,0.8888888888888888
2022,ONAGRI,CITRUMELO SACCATON,51095,IMG-00025-39.jpg,198,195,184,11,14,0.9435897435897436,0.9292929292929292
2022,ONAGRI,CITRUMELO SACCATON,51096,IMG-00009-39.jpg,219,199,190,9,29,0.9547738693467336,0.867579908675799
2022,ONAGRI,CITRUMELO SACCATON,51096,IMG-00011-39.jpg,145,142,134,8,11,0.943661971830986,0.9241379310344828
2022,ONAGRI,CITRUMELO SACCATON,51096,IMG-00012-39.jpg,114,107,104,3,10,0.97196261682243,0.912280701754386
2022,ONAGRI,CITRUMELO SACCATON,51096,IMG-00055-39.jpg,217,192,186,6,31,0.96875,0.8571428571428571
2022,ONAGRI,MC PONSIRUCE TRIFOLIATA,51097,IMG-00025-39.jpg,121,113,107,6,14,0.9469026548672568,0.8842975206611571
2022,ONAGRI,MC PONSIRUCE TRIFOLIATA,51097,IMG-00029-39.jpg,106,104,97,7,9,0.9326923076923076,0.9150943396226416
2022,ONAGRI,MC PONSIRUCE TRIFOLIATA,51097,IMG-00044-39.jpg,182,170,163,7,19,0.9588235294117649,0.8956043956043956
2022,ONAGRI,MC PONSIRUCE TRIFOLIATA,51098,IMG-00003-39.jpg,65,67,58,9,7,0.8656716417910447,0.8923076923076924
2022,ONAGRI,MC PONSIRUCE TRIFOLIATA,51098,IMG-00010-39.jpg,184,177,164,13,20,0.9265536723163842,0.8913043478260869
2022,ONAGRI,MC PONSIRUCE TRIFOLIATA,51098,IMG-00015-39.jpg,162,150,145,5,17,0.9666666666666668,0.8950617283950617
2022,ONAGRI,MC PONSIRUCE TRIFOLIATA,51099,IMG-00012-39.jpg,133,130,118,12,15,0.9076923076923076,0.8872180451127819
2024,ONAGRI,MC PONSIRUCE TRIFOLIATA,51101,IMG-12118.jpg,177,127,123,4,54,0.968503937007874,0.6949152542372882
2024,ONAGRI,MC PONSIRUCE TRIFOLIATA,51101,IMG-14223.jpg,153,114,112,2,41,0.9824561403508772,0.7320261437908496
2024,ONAGRI,MC PONSIRUCE TRIFOLIATA,51101,IMG-14226.jpg,151,116,110,6,41,0.9482758620689656,0.7284768211920529
2024,ONAGRI,MC PONSIRUCE TRIFOLIATA,51101,IMG-14255.jpg,189,151,143,8,46,0.9470198675496688,0.7566137566137566
2024,ONAGRI,MC PONSIRUCE TRIFOLIATA,51101,IMG-14281.jpg,150,114,112,2,38,0.9824561403508772,0.7466666666666667
2022,ONAGRI,CITRUS VOLKAMERIANA,101020,IMG-00001.jpg,6,6,5,1,1,0.8333333333333334,0.8333333333333334
2022,ONAGRI,CITRUS VOLKAMERIANA,101020,IMG-00004-44.jpg,53,42,38,4,15,0.9047619047619048,0.7169811320754716
2022,ONAGRI,CITRUS VOLKAMERIANA,101030,IMG-00003-44.jpg,29,28,25,3,4,0.8928571428571429,0.8620689655172413
2022,ONAGRI,CITRUS VOLKAMERIANA,101030,IMG-00004-44.jpg,110,90,89,1,21,0.9888888888888888,0.8090909090909091
2022,ONAGRI,CITRUS VOLKAMERIANA,101030,IMG-00005-44.jpg,134,111,104,7,30,0.9369369369369368,0.7761194029850746
2022,ONAGRI,CITRUS VOLKAMERIANA,101030,IMG-00017-44.jpg,79,53,52,1,27,0.981132075471698,0.6582278481012658
2022,ONAGRI,CITRUS VOLKAMERIANA,101040,IMG-00005-44.jpg,172,149,139,10,33,0.9328859060402684,0.8081395348837209
2022,ONAGRI,CITRUS VOLKAMERIANA,101040,IMG-00009-44.jpg,131,110,104,6,27,0.9454545454545454,0.7938931297709924
2022,ONAGRI,CITRUS VOLKAMERIANA,101040,IMG-00011-44.jpg,64,38,35,3,29,0.9210526315789472,0.546875
2022,ONAGRI,CITRUS VOLKAMERIANA,101040,IMG-00012-44.jpg,139,91,87,4,52,0.956043956043956,0.6258992805755396
2022,ONAGRI,CITRUS VOLKAMERIANA,101050,IMG-00002-44.jpg,95,71,69,2,26,0.971830985915493,0.7263157894736842
2022,ONAGRI,CITRUS VOLKAMERIANA,101050,IMG-00005-44.jpg,59,49,47,2,12,0.9591836734693876,0.7966101694915254
2022,ONAGRI,CITRUS VOLKAMERIANA,101050,IMG-00011-44.jpg,46,25,23,2,23,0.92,0.5
2022,ONAGRI,CITRUS VOLKAMERIANA,101050,IMG-00024-44.jpg,40,30,28,2,12,0.9333333333333332,0.7
2022,ONAGRI,CITRUS VOLKAMERIANA,101080,IMG-00005-44.jpg,42,28,27,1,15,0.9642857142857144,0.6428571428571429
2022,ONAGRI,CITRUS VOLKAMERIANA,101080,IMG-00006-44.jpg,79,55,53,2,26,0.9636363636363636,0.6708860759493671
2022,ONAGRI,CITRUS VOLKAMERIANA,101080,IMG-00023-44.jpg,7,7,5,2,2,0.7142857142857143,0.7142857142857143
2022,ONAGRI,CITRUS VOLKAMERIANA,101080,IMG-00024-44.jpg,27,14,14,0,13,1.0,0.5185185185185185
2022,ONAGRI,CITRUS VOLKAMERIANA,101090,IMG-00003-44.jpg,66,55,52,3,14,0.9454545454545454,0.7878787878787878
2022,ONAGRI,CITRUS VOLKAMERIANA,101090,IMG-00006-44.jpg,41,28,25,3,16,0.8928571428571429,0.6097560975609756
2022,ONAGRI,CITRUS VOLKAMERIANA,101090,IMG-00019-44.jpg,35,27,25,2,10,0.925925925925926,0.7142857142857143
2022,ONAGRI,CITRUS VOLKAMERIANA,101090,IMG-00020-44.jpg,42,35,32,3,10,0.9142857142857144,0.7619047619047619
2022,KHOUALKA,CITRANGE CARRIZO,102130,IMG-00001.jpg,5,5,3,2,2,0.6,0.6
2022,KHOUALKA,CITRANGE CARRIZO,102130,IMG-00004-43.jpg,24,12,12,0,12,1.0,0.5
2022,KHOUALKA,CITRANGE CARRIZO,102130,IMG-00019-43.jpg,33,26,25,1,8,0.9615384615384616,0.7575757575757576
2022,KHOUALKA,CITRANGE CARRIZO,102130,IMG-00020-43.jpg,18,14,11,3,7,0.7857142857142857,0.6111111111111112
2022,KHOUALKA,MACROPHYLLA,201180,IMG-00007-43.jpg,38,33,28,5,10,0.8484848484848485,0.7368421052631579
2022,KHOUALKA,MACROPHYLLA,201180,IMG-00011-43.jpg,64,36,33,3,31,0.9166666666666666,0.515625
2022,KHOUALKA,MACROPHYLLA,201180,IMG-00019-43.jpg,64,32,31,1,33,0.96875,0.484375
2022,KHOUALKA,MACROPHYLLA,201180,IMG-00020-43.jpg,43,31,31,0,12,1.0,0.7209302325581395
2022,KHOUALKA,MACROPHYLLA,201190,IMG-00004-43.jpg,101,49,45,4,56,0.9183673469387756,0.4455445544554456
2022,KHOUALKA,MACROPHYLLA,201190,IMG-00010-43.jpg,90,35,35,0,55,1.0,0.3888888888888889
2022,KHOUALKA,MACROPHYLLA,201190,IMG-00011-43.jpg,134,52,52,0,82,1.0,0.3880597014925373
2022,KHOUALKA,MACROPHYLLA,201190,IMG-00020-43.jpg,95,52,51,1,44,0.9807692307692308,0.5368421052631579
2022,KHOUALKA,CITRUS VOLKAMERIANA,201210,IMG-00011-43.jpg,103,69,69,0,34,1.0,0.6699029126213593
2022,KHOUALKA,CITRUS VOLKAMERIANA,201210,IMG-00012-43.jpg,42,20,18,2,24,0.9,0.4285714285714285
2022,KHOUALKA,CITRUS VOLKAMERIANA,201210,IMG-00015-43.jpg,77,42,41,1,36,0.9761904761904762,0.5324675324675324
2022,KHOUALKA,CITRUS VOLKAMERIANA,201210,IMG-00019-43.jpg,31,22,21,1,10,0.9545454545454546,0.6774193548387096
2022,KHOUALKA,BIGARADIER,201320,IMG-00006-43.jpg,87,55,53,2,34,0.9636363636363636,0.6091954022988506
2022,KHOUALKA,BIGARADIER,201320,IMG-00016-43.jpg,97,64,62,2,35,0.96875,0.6391752577319587
2022,KHOUALKA,BIGARADIER,201320,IMG-00017-43.jpg,49,31,31,0,18,1.0,0.6326530612244898
2022,KHOUALKA,BIGARADIER,201320,IMG-00020-43.jpg,88,61,59,2,29,0.9672131147540984,0.6704545454545454
2022,ONAGRI,BIGARADIER,201390,IMG-00008-44.jpg,62,43,42,1,20,0.9767441860465116,0.6774193548387096
2022,ONAGRI,BIGARADIER,201390,IMG-00011-44.jpg,90,48,43,5,47,0.8958333333333334,0.4777777777777778
2022,ONAGRI,BIGARADIER,201390,IMG-00013-44.jpg,77,34,32,2,45,0.9411764705882352,0.4155844155844156
2022,ONAGRI,BIGARADIER,201390,IMG-00016-44.jpg,69,37,35,2,34,0.945945945945946,0.5072463768115942
2022,KHOUALKA,CITRUS VOLKAMERIANA,202050,IMG-00006-43.jpg,89,44,43,1,46,0.9772727272727272,0.4831460674157304
2022,KHOUALKA,CITRUS VOLKAMERIANA,202050,IMG-00010-43.jpg,94,46,46,0,48,1.0,0.4893617021276596
2022,KHOUALKA,CITRUS VOLKAMERIANA,202050,IMG-00011-43.jpg,151,93,90,3,61,0.967741935483871,0.5960264900662252
2022,KHOUALKA,CITRUS VOLKAMERIANA,202050,IMG-00020-43.jpg,129,67,66,1,63,0.9850746268656716,0.5116279069767442
2022,KHOUALKA,CITRUS VOLKAMERIANA,202070,IMG-00006-43.jpg,68,33,29,4,39,0.8787878787878788,0.4264705882352941
2022,KHOUALKA,CITRUS VOLKAMERIANA,202070,IMG-00009-43.jpg,120,62,61,1,59,0.9838709677419356,0.5083333333333333
2022,KHOUALKA,CITRUS VOLKAMERIANA,202070,IMG-00013-43.jpg,95,49,48,1,47,0.979591836734694,0.5052631578947369
2022,KHOUALKA,CITRUS VOLKAMERIANA,202070,IMG-00019-43.jpg,57,33,30,3,27,0.9090909090909092,0.5263157894736842
2022,KHOUALKA,CITRUS VOLKAMERIANA,202080,IMG-00005-43.jpg,65,41,41,0,24,1.0,0.6307692307692307
2022,KHOUALKA,CITRUS VOLKAMERIANA,202080,IMG-00008-43.jpg,31,21,21,0,10,1.0,0.6774193548387096
2022,KHOUALKA,CITRUS VOLKAMERIANA,202080,IMG-00015-43.jpg,220,102,101,1,119,0.9901960784313726,0.4590909090909091
2022,KHOUALKA,CITRUS VOLKAMERIANA,202080,IMG-00016-43.jpg,131,77,72,5,59,0.935064935064935,0.549618320610687
2022,KHOUALKA,CITRANGE CARRIZO,301380,IMG-00007-43.jpg,30,14,12,2,18,0.8571428571428571,0.4
2022,KHOUALKA,CITRANGE CARRIZO,301380,IMG-00011-43.jpg,53,30,29,1,24,0.9666666666666668,0.5471698113207547
2022,KHOUALKA,CITRANGE CARRIZO,301380,IMG-00014-43.jpg,7,4,4,0,3,1.0,0.5714285714285714
2022,KHOUALKA,CITRANGE CARRIZO,301380,IMG-00020-43.jpg,91,53,53,0,38,1.0,0.5824175824175825
2022,ONAGRI,CITRUS VOLKAMERIANA,301470,IMG-00003-44.jpg,148,100,99,1,49,0.99,0.668918918918919
2022,ONAGRI,CITRUS VOLKAMERIANA,301470,IMG-00004-44.jpg,163,83,80,3,83,0.963855421686747,0.4907975460122699
2022,ONAGRI,CITRUS VOLKAMERIANA,301470,IMG-00005-44.jpg,160,71,70,1,90,0.9859154929577464,0.4375
2022,ONAGRI,CITRUS VOLKAMERIANA,301480,IMG-00001.jpg,92,37,37,0,55,1.0,0.4021739130434783
2022,ONAGRI,CITRUS VOLKAMERIANA,301480,IMG-00003-43.jpg,26,7,7,0,19,1.0,0.2692307692307692
2022,ONAGRI,CITRUS VOLKAMERIANA,301480,IMG-00012-43.jpg,50,17,16,1,34,0.9411764705882352,0.32
2022,ONAGRI,CITRUS VOLKAMERIANA,301480,IMG-00014-43.jpg,77,42,41,1,36,0.9761904761904762,0.5324675324675324
2022,ONAGRI,CITRUS VOLKAMERIANA,301490,IMG-00005-44.jpg,108,52,49,3,59,0.9423076923076924,0.4537037037037037
2022,ONAGRI,CITRUS VOLKAMERIANA,301490,IMG-00009-44.jpg,185,86,83,3,102,0.9651162790697676,0.4486486486486487
2022,ONAGRI,CITRUS VOLKAMERIANA,301490,IMG-00012-44.jpg,162,86,85,1,77,0.9883720930232558,0.5246913580246914
2022,ONAGRI,CITRUS VOLKAMERIANA,301490,IMG-00015-44.jpg,109,54,51,3,58,0.9444444444444444,0.4678899082568808
2022,ONAGRI,CITRUS VOLKAMERIANA,301510,IMG-00001.jpg,252,129,126,3,126,0.9767441860465116,0.5
2022,ONAGRI,CITRUS VOLKAMERIANA,301510,IMG-00006-44.jpg,137,75,71,4,66,0.9466666666666668,0.5182481751824818
2022,ONAGRI,CITRUS VOLKAMERIANA,301510,IMG-00007-44.jpg,115,55,52,3,63,0.9454545454545454,0.4521739130434783
2022,ONAGRI,CITRUS VOLKAMERIANA,301510,IMG-00008-44.jpg,150,89,86,3,64,0.9662921348314608,0.5733333333333334
2022,ONAGRI,BIGARADIER,301550,IMG-00008-44.jpg,144,83,82,1,62,0.9879518072289156,0.5694444444444444
2022,ONAGRI,BIGARADIER,301550,IMG-00011-44.jpg,40,21,21,0,19,1.0,0.525
2022,ONAGRI,BIGARADIER,301550,IMG-00013-44.jpg,76,33,33,0,43,1.0,0.4342105263157895
2022,ONAGRI,BIGARADIER,301550,IMG-00014-44.jpg,80,40,37,3,43,0.925,0.4625
2022,ONAGRI,CITRUS VOLKAMERIANA,301570,IMG-00004-44.jpg,158,80,78,2,80,0.975,0.4936708860759494
2022,ONAGRI,CITRUS VOLKAMERIANA,301570,IMG-00007-44.jpg,152,78,77,1,75,0.9871794871794872,0.506578947368421
2022,ONAGRI,CITRUS VOLKAMERIANA,301570,IMG-00008-44.jpg,103,50,47,3,56,0.94,0.4563106796116505
2022,ONAGRI,CITRUS VOLKAMERIANA,301570,IMG-00017-44.jpg,218,105,103,2,115,0.9809523809523808,0.4724770642201835
2022,KHOUALKA,CITRUS VOLKAMERIANA,302340,IMG-00004-43.jpg,106,60,58,2,48,0.9666666666666668,0.5471698113207547
2022,KHOUALKA,CITRUS VOLKAMERIANA,302340,IMG-00005-43.jpg,105,57,57,0,48,1.0,0.5428571428571428
2022,KHOUALKA,CITRUS VOLKAMERIANA,302340,IMG-00011-43.jpg,75,33,32,1,43,0.9696969696969696,0.4266666666666667
2022,KHOUALKA,CITRUS VOLKAMERIANA,302340,IMG-00015-43.jpg,92,27,27,0,65,1.0,0.2934782608695652
2022,KHOUALKA,CITRUS VOLKAMERIANA,302350,IMG-00008-43.jpg,33,16,16,0,17,1.0,0.4848484848484849
2022,KHOUALKA,CITRUS VOLKAMERIANA,302350,IMG-00013-43.jpg,80,44,41,3,39,0.9318181818181818,0.5125
2022,KHOUALKA,CITRUS VOLKAMERIANA,302350,IMG-00014-43.jpg,76,42,40,2,36,0.9523809523809524,0.5263157894736842
2022,KHOUALKA,CITRUS VOLKAMERIANA,302350,IMG-00018-43.jpg,44,27,27,0,17,1.0,0.6136363636363636
2022,KHOUALKA,CITRUS VOLKAMERIANA,302360,IMG-00005-43.jpg,97,40,40,0,57,1.0,0.4123711340206185
2022,KHOUALKA,CITRUS VOLKAMERIANA,302360,IMG-00006-43.jpg,118,35,35,0,83,1.0,0.2966101694915254
2022,KHOUALKA,CITRUS VOLKAMERIANA,302360,IMG-00016-43.jpg,67,34,32,2,35,0.9411764705882352,0.4776119402985075
2022,KHOUALKA,CITRUS VOLKAMERIANA,302360,IMG-00021-43.jpg,65,34,31,3,34,0.9117647058823528,0.4769230769230769
2022,KHOUALKA,CITRUS VOLKAMERIANA,302510,IMG-00001.jpg,73,28,28,0,45,1.0,0.3835616438356164
2022,KHOUALKA,CITRUS VOLKAMERIANA,302510,IMG-00002-43.jpg,44,12,11,1,33,0.9166666666666666,0.25
2022,KHOUALKA,CITRUS VOLKAMERIANA,302510,IMG-00003-43.jpg,78,43,37,6,41,0.8604651162790697,0.4743589743589743
2022,KHOUALKA,CITRUS VOLKAMERIANA,302510,IMG-00015-43.jpg,49,22,20,2,29,0.9090909090909092,0.4081632653061225
2022,KHOUALKA,BIGARADIER,401410,IMG-00093-43.jpg,35,17,15,2,20,0.8823529411764706,0.4285714285714285
2022,KHOUALKA,BIGARADIER,401410,IMG-00099-43.jpg,6,2,1,1,5,0.5,0.1666666666666667
2022,KHOUALKA,BIGARADIER,401410,IMG-00102-43.jpg,78,32,31,1,47,0.96875,0.3974358974358974
2022,KHOUALKA,BIGARADIER,401410,IMG-00104-43.jpg,81,35,35,0,46,1.0,0.4320987654320987
2022,ONAGRI,CITRANGE C35,401660,IMG-00001.jpg,56,32,30,2,26,0.9375,0.5357142857142857
2022,ONAGRI,CITRANGE C35,401660,IMG-00008-44.jpg,42,24,24,0,18,1.0,0.5714285714285714
2022,ONAGRI,CITRANGE C35,401660,IMG-00010-44.jpg,29,22,21,1,8,0.9545454545454546,0.7241379310344828
2022,ONAGRI,CITRANGE C35,401660,IMG-00016-44.jpg,64,47,46,1,18,0.9787234042553192,0.71875
2022,ONAGRI,CITRANGE C35,401710,IMG-00003-44.jpg,51,26,25,1,26,0.9615384615384616,0.4901960784313725
2022,ONAGRI,CITRANGE C35,401710,IMG-00012-44.jpg,19,12,12,0,7,1.0,0.631578947368421
2022,ONAGRI,CITRANGE C35,401710,IMG-00013-44.jpg,33,26,24,2,9,0.9230769230769232,0.7272727272727273
2022,ONAGRI,CITRANGE C35,401710,IMG-00019-44.jpg,76,52,50,2,26,0.9615384615384616,0.6578947368421053
2022,ONAGRI,CITRANGE C35,401720,IMG-00007-44.jpg,93,60,58,2,35,0.9666666666666668,0.6236559139784946
2022,ONAGRI,CITRANGE C35,401720,IMG-00008-44.jpg,38,24,22,2,16,0.9166666666666666,0.5789473684210527
2022,ONAGRI,CITRANGE C35,401720,IMG-00010-44.jpg,50,19,19,0,31,1.0,0.38
2022,ONAGRI,CITRANGE C35,401720,IMG-00017-44.jpg,68,38,38,0,30,1.0,0.5588235294117647
2022,ONAGRI,CITRANGE C35,401730,IMG-00001.jpg,19,3,1,2,18,0.3333333333333333,0.0526315789473684
2022,ONAGRI,CITRANGE C35,401730,IMG-00010-44.jpg,50,34,33,1,17,0.9705882352941176,0.66
2022,ONAGRI,CITRANGE C35,401730,IMG-00013-44.jpg,75,58,57,1,18,0.9827586206896552,0.76
2022,ONAGRI,CITRANGE C35,401730,IMG-00016-44.jpg,36,23,22,1,14,0.9565217391304348,0.6111111111111112
2022,ONAGRI,CITRANGE C35,401750,IMG-00005-44.jpg,88,36,36,0,52,1.0,0.4090909090909091
2022,ONAGRI,CITRANGE C35,401750,IMG-00009-44.jpg,127,73,71,2,56,0.9726027397260274,0.5590551181102362
2022,ONAGRI,CITRANGE C35,401750,IMG-00016-44.jpg,107,66,63,3,44,0.9545454545454546,0.5887850467289719
2022,ONAGRI,CITRANGE C35,401750,IMG-00024-44.jpg,50,30,28,2,22,0.9333333333333332,0.56
2022,ONAGRI,CITRUMELO SACCATON,401770,IMG-00003-44.jpg,24,18,17,1,7,0.9444444444444444,0.7083333333333334
2022,ONAGRI,CITRUMELO SACCATON,401770,IMG-00008-44.jpg,72,39,38,1,34,0.9743589743589745,0.5277777777777778
2022,ONAGRI,CITRUMELO SACCATON,401770,IMG-00009-44.jpg,14,8,8,0,6,1.0,0.5714285714285714
2022,ONAGRI,CITRUMELO SACCATON,401770,IMG-00017-44.jpg,20,12,10,2,10,0.8333333333333334,0.5
2022,KHOUALKA,BIGARADIER,402440,IMG-00005-43.jpg,17,2,2,0,15,1.0,0.1176470588235294
2022,KHOUALKA,BIGARADIER,402440,IMG-00012-43.jpg,46,26,24,2,22,0.9230769230769232,0.5217391304347826
2022,KHOUALKA,BIGARADIER,402440,IMG-00014-43.jpg,11,3,3,0,8,1.0,0.2727272727272727
2022,KHOUALKA,BIGARADIER,402440,IMG-00015-43.jpg,22,6,5,1,17,0.8333333333333334,0.2272727272727273
2022,KHOUALKA,BIGARADIER,402590,IMG-00007-43.jpg,104,48,46,2,58,0.9583333333333334,0.4423076923076923
2022,KHOUALKA,BIGARADIER,402590,IMG-00012-43.jpg,45,21,17,4,28,0.8095238095238095,0.3777777777777778
2022,KHOUALKA,BIGARADIER,402590,IMG-00015-43.jpg,58,27,26,1,32,0.9629629629629628,0.4482758620689655
2022,KHOUALKA,BIGARADIER,402590,IMG-00019-43.jpg,64,32,30,2,34,0.9375,0.46875
2022,KHOUALKA,CITRUS VOLKAMERIANA,501520,IMG-00004-43.jpg,39,16,15,1,24,0.9375,0.3846153846153846
2022,KHOUALKA,CITRUS VOLKAMERIANA,501520,IMG-00007-43.jpg,43,24,22,2,21,0.9166666666666666,0.5116279069767442
2022,KHOUALKA,CITRUS VOLKAMERIANA,501520,IMG-00015-43.jpg,18,12,9,3,9,0.75,0.5
2022,KHOUALKA,CITRUS VOLKAMERIANA,501520,IMG-00020-43.jpg,48,27,26,1,22,0.9629629629629628,0.5416666666666666
2022,KHOUALKA,CITRUS VOLKAMERIANA,501540,IMG-00006-43.jpg,38,27,25,2,13,0.925925925925926,0.6578947368421053
2022,KHOUALKA,CITRUS VOLKAMERIANA,501540,IMG-00012-43.jpg,102,61,57,4,45,0.9344262295081968,0.5588235294117647
2022,KHOUALKA,CITRUS VOLKAMERIANA,501540,IMG-00017-43.jpg,138,59,58,1,80,0.9830508474576272,0.4202898550724637
2022,KHOUALKA,CITRUS VOLKAMERIANA,501540,IMG-00018-43.jpg,51,28,26,2,25,0.9285714285714286,0.5098039215686274
2022,KHOUALKA,CITRUS VOLKAMERIANA,501660,IMG-00006-43.jpg,60,32,29,3,31,0.90625,0.4833333333333333
2022,KHOUALKA,CITRUS VOLKAMERIANA,501660,IMG-00016-43.jpg,63,33,30,3,33,0.9090909090909092,0.4761904761904762
2022,KHOUALKA,CITRUS VOLKAMERIANA,501660,IMG-00018-43.jpg,112,56,54,2,58,0.9642857142857144,0.4821428571428572
2022,KHOUALKA,CITRUS VOLKAMERIANA,501660,IMG-00021-43.jpg,90,50,50,0,40,1.0,0.5555555555555556
2022,KHOUALKA,CITRUS VOLKAMERIANA,501680,IMG-00005-43.jpg,179,94,94,0,85,1.0,0.5251396648044693
2022,KHOUALKA,CITRUS VOLKAMERIANA,501680,IMG-00011-43.jpg,101,44,42,2,59,0.9545454545454546,0.4158415841584158
2022,KHOUALKA,CITRUS VOLKAMERIANA,501680,IMG-00012-43.jpg,76,21,19,2,57,0.9047619047619048,0.25
2022,KHOUALKA,CITRUS VOLKAMERIANA,501680,IMG-00016-43.jpg,113,55,53,2,60,0.9636363636363636,0.4690265486725664
2022,KHOUALKA,CITRUS VOLKAMERIANA,501690,IMG-00032-43.jpg,34,16,14,2,20,0.875,0.4117647058823529
2022,KHOUALKA,CITRUS VOLKAMERIANA,501690,IMG-00039-43.jpg,186,82,79,3,107,0.9634146341463414,0.4247311827956989
2022,KHOUALKA,CITRUS VOLKAMERIANA,501690,IMG-00047-43.jpg,103,43,42,1,61,0.9767441860465116,0.4077669902912621
2022,KHOUALKA,CITRUS VOLKAMERIANA,501690,IMG-00049-43.jpg,166,79,77,2,89,0.9746835443037974,0.463855421686747
2022,KHOUALKA,CITRUS VOLKAMERIANA,501760,IMG-00001.jpg,94,28,27,1,67,0.9642857142857144,0.2872340425531915
2022,KHOUALKA,CITRUS VOLKAMERIANA,501760,IMG-00034-43.jpg,45,8,8,0,37,1.0,0.1777777777777778
2022,KHOUALKA,CITRUS VOLKAMERIANA,501760,IMG-00036-43.jpg,40,10,9,1,31,0.9,0.225
2022,KHOUALKA,CITRUS VOLKAMERIANA,501760,IMG-00051-43.jpg,92,30,30,0,62,1.0,0.3260869565217391
2022,ONAGRI,CITRUMELO SACCATON,510910,IMG-00004-44.jpg,73,39,39,0,34,1.0,0.5342465753424658
2022,ONAGRI,CITRUMELO SACCATON,510910,IMG-00008-44.jpg,152,83,82,1,70,0.9879518072289156,0.5394736842105263
2022,ONAGRI,CITRUMELO SACCATON,510910,IMG-00010-44.jpg,107,59,57,2,50,0.9661016949152542,0.5327102803738317
2022,ONAGRI,CITRUMELO SACCATON,510910,IMG-00011-44.jpg,92,51,50,1,42,0.9803921568627452,0.5434782608695652
2022,ONAGRI,CITRUMELO SACCATON,510950,IMG-00006-44.jpg,70,43,43,0,27,1.0,0.6142857142857143
2022,ONAGRI,CITRUMELO SACCATON,510950,IMG-00008-44.jpg,75,43,42,1,33,0.9767441860465116,0.56
2022,ONAGRI,CITRUMELO SACCATON,510950,IMG-00009-44.jpg,85,42,41,1,44,0.9761904761904762,0.4823529411764706
2022,ONAGRI,CITRUMELO SACCATON,510950,IMG-00011-44.jpg,135,80,80,0,55,1.0,0.5925925925925926
2022,ONAGRI,MC PONSIRUCE TRIFOLIATA,510980,IMG-00014-44.jpg,67,37,34,3,33,0.918918918918919,0.5074626865671642
2022,ONAGRI,MC PONSIRUCE TRIFOLIATA,510980,IMG-00015-44.jpg,51,33,32,1,19,0.9696969696969696,0.6274509803921569
2022,ONAGRI,MC PONSIRUCE TRIFOLIATA,510980,IMG-00016-44.jpg,99,51,51,0,48,1.0,0.5151515151515151
2022,ONAGRI,MC PONSIRUCE TRIFOLIATA,510980,IMG-00019-44.jpg,102,51,51,0,51,1.0,0.5
2022,ONAGRI,MC PONSIRUCE TRIFOLIATA,510990,IMG-00006-44.jpg,135,89,88,1,47,0.9887640449438202,0.6518518518518519
2022,ONAGRI,MC PONSIRUCE TRIFOLIATA,510990,IMG-00008-44.jpg,110,67,65,2,45,0.9701492537313432,0.5909090909090909
2022,ONAGRI,MC PONSIRUCE TRIFOLIATA,510990,IMG-00009-44.jpg,85,56,53,3,32,0.9464285714285714,0.6235294117647059
2022,ONAGRI,MC PONSIRUCE TRIFOLIATA,510990,IMG-00024-44.jpg,65,35,34,1,31,0.9714285714285714,0.5230769230769231
2022,ONAGRI,MC PONSIRUCE TRIFOLIATA,511030,IMG-00007-44.jpg,100,76,74,2,26,0.9736842105263158,0.74
2022,ONAGRI,MC PONSIRUCE TRIFOLIATA,511030,IMG-00016-44.jpg,63,49,49,0,14,1.0,0.7777777777777778
2022,ONAGRI,MC PONSIRUCE TRIFOLIATA,511030,IMG-00022-44.jpg,98,77,74,3,24,0.961038961038961,0.7551020408163265
2022,ONAGRI,MC PONSIRUCE TRIFOLIATA,511030,IMG-00027-44.jpg,82,63,60,3,22,0.9523809523809524,0.7317073170731707
2022,ONAGRI,MS PONSIRUCE TRIFOLIATA,511040,IMG-00004-44.jpg,77,58,55,3,22,0.9482758620689656,0.7142857142857143
2022,ONAGRI,MS PONSIRUCE TRIFOLIATA,511040,IMG-00014-44.jpg,48,35,33,2,15,0.9428571428571428,0.6875
2022,ONAGRI,MS PONSIRUCE TRIFOLIATA,511040,IMG-00016-44.jpg,71,43,42,1,29,0.9767441860465116,0.5915492957746479
2022,ONAGRI,MS PONSIRUCE TRIFOLIATA,511040,IMG-00025-44.jpg,56,34,30,4,26,0.8823529411764706,0.5357142857142857
2022,ONAGRI,FUZHU,511050,IMG-00004-44.jpg,109,53,50,3,59,0.9433962264150944,0.4587155963302753
2022,ONAGRI,FUZHU,511050,IMG-00006-44.jpg,142,83,79,4,63,0.9518072289156626,0.5563380281690141
2022,ONAGRI,FUZHU,511050,IMG-00011-44.jpg,172,128,124,4,48,0.96875,0.7209302325581395
2022,ONAGRI,FUZHU,511050,IMG-00022-44.jpg,194,134,130,4,64,0.9701492537313432,0.6701030927835051
2022,ONAGRI,MS PONSIRUCE TRIFOLIATA,511060,IMG-00007-44.jpg,115,69,67,2,48,0.9710144927536232,0.5826086956521739
2022,ONAGRI,MS PONSIRUCE TRIFOLIATA,511060,IMG-00016-44.jpg,102,56,55,1,47,0.9821428571428572,0.5392156862745098
2022,ONAGRI,MS PONSIRUCE TRIFOLIATA,511060,IMG-00017-44.jpg,59,24,23,1,36,0.9583333333333334,0.3898305084745763
2022,ONAGRI,MS PONSIRUCE TRIFOLIATA,511060,IMG-00019-44.jpg,108,53,51,2,57,0.9622641509433962,0.4722222222222222
2022,ONAGRI,FUZHU,511070,IMG-00006-44.jpg,82,56,54,2,28,0.9642857142857144,0.6585365853658537
2022,ONAGRI,FUZHU,511070,IMG-00016-44.jpg,96,50,48,2,48,0.96,0.5
2022,ONAGRI,FUZHU,511070,IMG-00018-44.jpg,93,52,49,3,44,0.9423076923076924,0.5268817204301075
2022,ONAGRI,FUZHU,511070,IMG-00019-44.jpg,142,83,82,1,60,0.9879518072289156,0.5774647887323944
