compagnie,Domaine,Porte-greffe,parcelle,Filename,True_count,detect_count,TP,FP,FN,Precision,Recall
2022,SAOUDA,BIGARADIER,10010,IMG-00011-45.jpg,28,37,28,9,0,0.7567567567567568,1.0
2022,SAOUDA,BIGARADIER,10010,IMG-00012-45.jpg,27,34,26,8,1,0.7647058823529411,0.9629629629629628
2022,SAOUDA,BIGARADIER,10010,IMG-00014-45.jpg,50,60,48,12,2,0.8,0.96
2022,SAOUDA,BIGARADIER,10010,IMG-00018-45.jpg,30,34,29,5,1,0.8529411764705882,0.9666666666666668
2022,SAOUDA,BIGARADIER,10010,IMG-00020-45.jpg,31,44,31,13,0,0.7045454545454546,1.0
2024,SAOUDA,BIGARADIER,10010,IMG-23410.jpg,85,71,68,3,17,0.9577464788732394,0.8
2024,SAOUDA,BIGARADIER,10010,IMG-23417.jpg,86,67,67,0,19,1.0,0.7790697674418605
2024,SAOUDA,BIGARADIER,10010,IMG-23430.jpg,74,66,66,0,8,1.0,0.8918918918918919
2024,SAOUDA,BIGARADIER,10010,IMG-23647.jpg,95,80,79,1,16,0.9875,0.8315789473684211
2024,SAOUDA,BIGARADIER,10010,IMG-23672.jpg,47,31,31,0,16,1.0,0.6595744680851063
2024,SAOUDA,BIGARADIER,10010,IMG-23707.jpg,30,26,26,0,4,1.0,0.8666666666666667
2024,SAOUDA,BIGARADIER,10010,IMG-23709.jpg,31,23,23,0,8,1.0,0.7419354838709677
2024,SAOUDA,BIGARADIER,10010,IMG-23711.jpg,79,63,60,3,19,0.9523809523809524,0.759493670886076
2022,SAOUDA,MACROPHYLLA,10030,IMG-00158-45.jpg,101,137,101,36,0,0.7372262773722628,1.0
2022,SAOUDA,MACROPHYLLA,10030,IMG-00159-45.jpg,155,186,151,35,4,0.8118279569892473,0.9741935483870968
2022,SAOUDA,MACROPHYLLA,10030,IMG-00162-45.jpg,119,146,118,28,1,0.8082191780821918,0.9915966386554622
2022,SAOUDA,MACROPHYLLA,10030,IMG-00169-45.jpg,72,101,72,29,0,0.7128712871287128,1.0
2022,SAOUDA,MACROPHYLLA,10031,IMG-00002-45.jpg,46,57,45,12,1,0.7894736842105263,0.9782608695652174
2022,SAOUDA,MACROPHYLLA,10031,IMG-00084-45.jpg,41,54,41,13,0,0.7592592592592593,1.0
2022,SAOUDA,MACROPHYLLA,10031,IMG-00450-45.jpg,27,42,26,16,1,0.6190476190476191,0.9629629629629628
2022,SAOUDA,MACROPHYLLA,10031,IMG-00451-45.jpg,34,43,30,13,4,0.6976744186046512,0.8823529411764706
2022,SAOUDA,MACROPHYLLA,10031,IMG-00464-45.jpg,33,42,32,10,1,0.7619047619047619,0.9696969696969696
2022,ONAGRI,CITRUS VOLKAMERIANA,10101,IMG-00003-39.jpg,120,122,114,8,6,0.9344262295081968,0.95
2022,ONAGRI,CITRUS VOLKAMERIANA,10101,IMG-00010-39.jpg,85,82,76,6,9,0.926829268292683,0.8941176470588236
2024,ONAGRI,CITRUS VOLKAMERIANA,10101,IMG-10523.jpg,288,225,224,1,64,0.9955555555555556,0.7777777777777778
2024,ONAGRI,CITRUS VOLKAMERIANA,10101,IMG-10545.jpg,98,82,81,1,17,0.9878048780487804,0.826530612244898
2024,ONAGRI,CITRUS VOLKAMERIANA,10101,IMG-10558.jpg,143,103,102,1,41,0.9902912621359224,0.7132867132867133
2022,ONAGRI,CITRUS VOLKAMERIANA,10102,IMG-00003-39.jpg,48,41,40,1,8,0.975609756097561,0.8333333333333334
2024,ONAGRI,CITRUS VOLKAMERIANA,10102,IMG-10637.jpg,140,116,116,0,24,1.0,0.8285714285714286
2024,ONAGRI,CITRUS VOLKAMERIANA,10102,IMG-10658.jpg,163,133,132,1,31,0.9924812030075189,0.8098159509202454
2022,ONAGRI,CITRUS VOLKAMERIANA,10103,IMG-00003-39.jpg,215,195,189,6,26,0.9692307692307692,0.8790697674418605
2022,ONAGRI,CITRUS VOLKAMERIANA,10103,IMG-00008-39.jpg,195,191,181,10,14,0.9476439790575916,0.9282051282051282
2024,ONAGRI,CITRUS VOLKAMERIANA,10103,IMG-10614.jpg,134,110,109,1,25,0.990909090909091,0.8134328358208955
2024,ONAGRI,CITRUS VOLKAMERIANA,10103,IMG-10630.jpg,213,181,178,3,35,0.9834254143646408,0.8356807511737089
2024,ONAGRI,CITRUS VOLKAMERIANA,10103,IMG-10631.jpg,134,103,103,0,31,1.0,0.7686567164179104
2022,ONAGRI,CITRUS VOLKAMERIANA,10104,IMG-00004-39.jpg,65,63,59,4,6,0.9365079365079364,0.9076923076923076
2022,ONAGRI,CITRUS VOLKAMERIANA,10104,IMG-00008-39.jpg,69,64,57,7,12,0.890625,0.8260869565217391
2024,ONAGRI,CITRUS VOLKAMERIANA,10104,IMG-11267.jpg,22,11,11,0,11,1.0,0.5
2024,ONAGRI,CITRUS VOLKAMERIANA,10104,IMG-11327.jpg,128,93,93,0,35,1.0,0.7265625
2024,ONAGRI,CITRUS VOLKAMERIANA,10104,IMG-11347.jpg,118,85,85,0,33,1.0,0.7203389830508474
2024,ONAGRI,CITRUS VOLKAMERIANA,10104,IMG-11366.jpg,351,269,265,4,86,0.9851301115241636,0.7549857549857549
2024,ONAGRI,CITRUS VOLKAMERIANA,10104,IMG-11386.jpg,99,73,73,0,26,1.0,0.7373737373737373
2022,ONAGRI,CITRUS VOLKAMERIANA,10105,IMG-00004-39.jpg,17,20,15,5,2,0.75,0.8823529411764706
2022,ONAGRI,CITRUS VOLKAMERIANA,10105,IMG-00005-39.jpg,68,68,62,6,6,0.9117647058823528,0.9117647058823528
2022,ONAGRI,CITRUS VOLKAMERIANA,10108,IMG-00003-39.jpg,61,59,55,4,6,0.9322033898305084,0.9016393442622952
2022,ONAGRI,CITRUS VOLKAMERIANA,10108,IMG-00007-39.jpg,69,61,61,0,8,1.0,0.8840579710144928
2022,ONAGRI,CITRUS VOLKAMERIANA,10109,IMG-00003-39.jpg,4,4,4,0,0,1.0,1.0
2022,ONAGRI,CITRUS VOLKAMERIANA,10109,IMG-00008-39.jpg,105,103,97,6,8,0.941747572815534,0.923809523809524
2022,KHOUALKA,CITRANGE CARRIZO,10213,IMG-00001.jpg,77,89,74,15,3,0.8314606741573034,0.961038961038961
2022,KHOUALKA,CITRANGE CARRIZO,10213,IMG-00005-40.jpg,73,88,72,16,1,0.8181818181818182,0.9863013698630136
2022,KHOUALKA,CITRANGE CARRIZO,10213,IMG-00009-40.jpg,14,19,14,5,0,0.7368421052631579,1.0
2022,KHOUALKA,CITRANGE CARRIZO,10213,IMG-00014-40.jpg,21,25,21,4,0,0.84,1.0
2022,KHOUALKA,CITRANGE CARRIZO,10213,IMG-00028-40.jpg,47,48,46,2,1,0.9583333333333334,0.9787234042553192
2022,KHOUALKA,CITRANGE CARRIZO,10213,IMG-00034-40.jpg,48,49,47,2,1,0.9591836734693876,0.9791666666666666
2022,KHOUALKA,CITRANGE CARRIZO,10213,IMG-00035-40.jpg,37,40,36,4,1,0.9,0.972972972972973
2022,KHOUALKA,CITRANGE CARRIZO,10213,IMG-00036-40.jpg,47,55,47,8,0,0.8545454545454545,1.0
2022,KHOUALKA,CITRANGE CARRIZO,10213,IMG-00042-40.jpg,22,26,22,4,0,0.8461538461538461,1.0
2022,KHOUALKA,CITRANGE CARRIZO,10213,IMG-00047-40.jpg,70,71,69,2,1,0.971830985915493,0.9857142857142858
2022,KHOUALKA,CITRANGE CARRIZO,10213,IMG-00054-40.jpg,33,38,33,5,0,0.868421052631579,1.0
2022,KHOUALKA,CITRANGE CARRIZO,10213,IMG-00055-40.jpg,93,93,88,5,5,0.946236559139785,0.946236559139785
2022,KHOUALKA,CITRANGE CARRIZO,10213,IMG-00061-40.jpg,113,126,109,17,4,0.8650793650793651,0.9646017699115044
2022,KHOUALKA,CITRANGE CARRIZO,10213,IMG-00066-40.jpg,48,51,43,8,5,0.8431372549019608,0.8958333333333334
2022,OUARGHA,MACROPHYLLA,11010,IMG-00001.jpg,40,42,39,3,1,0.9285714285714286,0.975
2022,OUARGHA,MACROPHYLLA,11010,IMG-00015-41.jpg,24,28,23,5,1,0.8214285714285714,0.9583333333333334
2022,OUARGHA,MACROPHYLLA,11010,IMG-00019-41.jpg,20,35,20,15,0,0.5714285714285714,1.0
2022,OUARGHA,MACROPHYLLA,11010,IMG-00024-41.jpg,21,25,21,4,0,0.84,1.0
2022,OUARGHA,MACROPHYLLA,11020,IMG-00017-41.jpg,51,58,51,7,0,0.8793103448275862,1.0
2022,OUARGHA,MACROPHYLLA,11020,IMG-00018-41.jpg,13,13,13,0,0,1.0,1.0
2022,OUARGHA,CITRANGE CARRIZO,13010,IMG-00067-41.jpg,55,75,54,21,1,0.72,0.9818181818181818
2022,OUARGHA,CITRANGE CARRIZO,13010,IMG-00086-41.jpg,49,62,49,13,0,0.7903225806451613,1.0
2022,OUARGHA,CITRANGE CARRIZO,13010,IMG-00194-41.jpg,33,40,32,8,1,0.8,0.9696969696969696
2022,OUARGHA,CITRANGE CARRIZO,13020,IMG-00023-41.jpg,31,40,31,9,0,0.775,1.0
2022,OUARGHA,CITRANGE CARRIZO,13020,IMG-00024-41.jpg,18,26,18,8,0,0.6923076923076923,1.0
2022,OUARGHA,CITRANGE CARRIZO,13020,IMG-00039-41.jpg,4,12,4,8,0,0.3333333333333333,1.0
2022,OUARGHA,CITRANGE CARRIZO,13020,IMG-00040-41.jpg,6,13,6,7,0,0.4615384615384616,1.0
2022,OUARGHA,CITRUS VOLKAMERIANA,13030,IMG-00009-41.jpg,18,25,18,7,0,0.72,1.0
2022,OUARGHA,CITRUS VOLKAMERIANA,13030,IMG-00013-41.jpg,46,74,46,28,0,0.6216216216216216,1.0
2022,OUARGHA,CITRUS VOLKAMERIANA,13030,IMG-00027-41.jpg,12,28,11,17,1,0.3928571428571428,0.9166666666666666
2022,OUARGHA,CITRUS VOLKAMERIANA,13030,IMG-00029-41.jpg,18,32,18,14,0,0.5625,1.0
2022,OUARGHA,CITRUS VOLKAMERIANA,13030,IMG-00036-41.jpg,16,39,16,23,0,0.4102564102564102,1.0
2022,OUARGHA,CITRUS VOLKAMERIANA,14010,IMG-00008-41.jpg,40,46,40,6,0,0.8695652173913043,1.0
2022,OUARGHA,CITRUS VOLKAMERIANA,14010,IMG-00010-41.jpg,49,57,48,9,1,0.8421052631578947,0.979591836734694
2022,OUARGHA,CITRUS VOLKAMERIANA,14010,IMG-00011-41.jpg,47,63,47,16,0,0.746031746031746,1.0
2022,OUARGHA,CITRUS VOLKAMERIANA,14010,IMG-00018-41.jpg,44,61,44,17,0,0.7213114754098361,1.0
2022,KHOUALKA,MACROPHYLLA,20118,IMG-00007-40.jpg,44,47,43,4,1,0.9148936170212766,0.9772727272727272
2022,KHOUALKA,MACROPHYLLA,20118,IMG-00008-40.jpg,115,128,115,13,0,0.8984375,1.0
2022,KHOUALKA,MACROPHYLLA,20118,IMG-00022-40.jpg,113,115,109,6,4,0.9478260869565216,0.9646017699115044
2022,KHOUALKA,MACROPHYLLA,20118,IMG-00033-40.jpg,58,63,56,7,2,0.8888888888888888,0.9655172413793104
2022,KHOUALKA,MACROPHYLLA,20118,IMG-00037-40.jpg,29,31,28,3,1,0.9032258064516128,0.9655172413793104
2022,KHOUALKA,MACROPHYLLA,20118,IMG-00042-40.jpg,137,145,133,12,4,0.9172413793103448,0.9708029197080292
2022,KHOUALKA,MACROPHYLLA,20118,IMG-00046-40.jpg,45,53,43,10,2,0.8113207547169812,0.9555555555555556
2022,KHOUALKA,MACROPHYLLA,20118,IMG-00050-40.jpg,48,49,45,4,3,0.9183673469387756,0.9375
2022,KHOUALKA,MACROPHYLLA,20118,IMG-00055-40.jpg,52,55,51,4,1,0.9272727272727272,0.9807692307692308
2022,KHOUALKA,MACROPHYLLA,20118,IMG-00061-40.jpg,120,130,112,18,8,0.8615384615384616,0.9333333333333332
2022,KHOUALKA,MACROPHYLLA,20118,IMG-00062-40.jpg,63,68,61,7,2,0.8970588235294118,0.9682539682539684
2022,KHOUALKA,MACROPHYLLA,20118,IMG-00063-40.jpg,47,54,45,9,2,0.8333333333333334,0.9574468085106383
2022,KHOUALKA,MACROPHYLLA,20118,IMG-00066-40.jpg,84,89,81,8,3,0.9101123595505618,0.9642857142857144
2024,KHOUALKA,MACROPHYLLA,20118,IMG-12691.jpg,22,14,14,0,8,1.0,0.6363636363636364
2024,KHOUALKA,MACROPHYLLA,20118,IMG-12729.jpg,56,44,42,2,14,0.9545454545454546,0.75
2024,KHOUALKA,MACROPHYLLA,20118,IMG-12735.jpg,88,65,65,0,23,1.0,0.7386363636363636
2024,KHOUALKA,MACROPHYLLA,20118,IMG-12748.jpg,107,78,78,0,29,1.0,0.7289719626168224
2024,KHOUALKA,MACROPHYLLA,20118,IMG-12764.jpg,111,93,92,1,19,0.989247311827957,0.8288288288288288
2024,KHOUALKA,MACROPHYLLA,20118,IMG-12808.jpg,113,81,80,1,33,0.9876543209876544,0.7079646017699115
2024,KHOUALKA,MACROPHYLLA,20118,IMG-12851.jpg,24,13,13,0,11,1.0,0.5416666666666666
2022,KHOUALKA,MACROPHYLLA,20119,IMG-00005-40.jpg,106,115,105,10,1,0.9130434782608696,0.9905660377358492
2022,KHOUALKA,MACROPHYLLA,20119,IMG-00008-40.jpg,142,155,139,16,3,0.896774193548387,0.9788732394366196
2022,KHOUALKA,MACROPHYLLA,20119,IMG-00014-40.jpg,132,142,130,12,2,0.9154929577464788,0.9848484848484848
2022,KHOUALKA,BIGARADIER,20132,IMG-00004-40.jpg,181,183,177,6,4,0.9672131147540984,0.9779005524861878
2022,KHOUALKA,BIGARADIER,20132,IMG-00025-40.jpg,91,104,89,15,2,0.8557692307692307,0.978021978021978
2022,KHOUALKA,BIGARADIER,20132,IMG-00028-40.jpg,49,52,46,6,3,0.8846153846153846,0.9387755102040816
2022,KHOUALKA,BIGARADIER,20132,IMG-00035-40.jpg,103,121,103,18,0,0.8512396694214877,1.0
2022,KHOUALKA,BIGARADIER,20132,IMG-00039-40.jpg,119,135,115,20,4,0.8518518518518519,0.9663865546218487
2022,KHOUALKA,BIGARADIER,20132,IMG-00046-40.jpg,156,165,153,12,3,0.9272727272727272,0.9807692307692308
2022,KHOUALKA,BIGARADIER,20132,IMG-00051-40.jpg,108,112,104,8,4,0.9285714285714286,0.9629629629629628
2022,KHOUALKA,BIGARADIER,20132,IMG-00055-40.jpg,67,66,62,4,5,0.9393939393939394,0.9253731343283582
2022,KHOUALKA,BIGARADIER,20132,IMG-00058-40.jpg,89,89,86,3,3,0.9662921348314608,0.9662921348314608
2022,KHOUALKA,BIGARADIER,20132,IMG-00059-40.jpg,139,139,131,8,8,0.9424460431654677,0.9424460431654677
2022,KHOUALKA,BIGARADIER,20132,IMG-00060-40.jpg,57,58,52,6,5,0.896551724137931,0.912280701754386
2022,KHOUALKA,BIGARADIER,20132,IMG-00064-40.jpg,117,131,115,16,2,0.8778625954198473,0.9829059829059827
2022,KHOUALKA,BIGARADIER,20132,IMG-00075-40.jpg,69,75,69,6,0,0.92,1.0
2022,ONAGRI,BIGARADIER,20139,IMG-00021-39.jpg,93,88,84,4,9,0.9545454545454546,0.9032258064516128
2024,KHOUALKA,CITRUS VOLKAMERIANA,20205,IMG-12040.jpg,123,92,91,1,32,0.9891304347826086,0.7398373983739838
2024,KHOUALKA,CITRUS VOLKAMERIANA,20205,IMG-12058.jpg,116,110,108,2,8,0.9818181818181818,0.9310344827586208
2022,SAOUDA,CITRUS VOLKAMERIANA,21020,IMG-00033-45.jpg,67,83,65,18,2,0.7831325301204819,0.9701492537313432
2022,SAOUDA,CITRUS VOLKAMERIANA,21020,IMG-00087-45.jpg,21,28,21,7,0,0.75,1.0
2022,SAOUDA,CITRUS VOLKAMERIANA,21020,IMG-00138-45.jpg,40,47,39,8,1,0.8297872340425532,0.975
2022,SAOUDA,CITRUS VOLKAMERIANA,21020,IMG-00145-45.jpg,37,42,37,5,0,0.8809523809523809,1.0
2022,SAOUDA,CITRUS VOLKAMERIANA,21020,IMG-00155-45.jpg,38,56,38,18,0,0.6785714285714286,1.0
2022,SAOUDA,CITRUS VOLKAMERIANA,21030,IMG-00521-45.jpg,31,42,31,11,0,0.7380952380952381,1.0
2022,SAOUDA,CITRUS VOLKAMERIANA,21030,IMG-00524-45.jpg,71,88,71,17,0,0.8068181818181818,1.0
2022,SAOUDA,CITRUS VOLKAMERIANA,21030,IMG-00536-45.jpg,41,64,39,25,2,0.609375,0.951219512195122
2022,SAOUDA,CITRUS VOLKAMERIANA,21030,IMG-00537-45.jpg,52,70,50,20,2,0.7142857142857143,0.9615384615384616
2022,SAOUDA,CITRUS VOLKAMERIANA,22020,IMG-00053-45.jpg,39,56,39,17,0,0.6964285714285714,1.0
2022,SAOUDA,CITRUS VOLKAMERIANA,22020,IMG-00059-45.jpg,46,55,45,10,1,0.8181818181818182,0.9782608695652174
2022,SAOUDA,CITRUS VOLKAMERIANA,22020,IMG-00060-45.jpg,48,56,46,10,2,0.8214285714285714,0.9583333333333334
2022,SAOUDA,CITRUS VOLKAMERIANA,22020,IMG-00062-45.jpg,50,66,50,16,0,0.7575757575757576,1.0
2022,SAOUDA,CITRUS VOLKAMERIANA,22030,IMG-00062-45.jpg,62,72,62,10,0,0.8611111111111112,1.0
2022,SAOUDA,CITRUS VOLKAMERIANA,22030,IMG-00063-45.jpg,83,100,81,19,2,0.81,0.9759036144578314
2022,SAOUDA,CITRUS VOLKAMERIANA,22030,IMG-00065-45.jpg,58,67,57,10,1,0.8507462686567164,0.9827586206896552
2022,SAOUDA,CITRUS VOLKAMERIANA,22030,IMG-00068-45.jpg,66,80,65,15,1,0.8125,0.9848484848484848
2022,SAOUDA,CITRUS VOLKAMERIANA,23020,IMG-00024-45.jpg,47,61,46,15,1,0.7540983606557377,0.9787234042553192
2022,SAOUDA,CITRUS VOLKAMERIANA,23020,IMG-00032-45.jpg,33,37,33,4,0,0.8918918918918919,1.0
2022,SAOUDA,CITRUS VOLKAMERIANA,23020,IMG-00074-45.jpg,28,33,26,7,2,0.7878787878787878,0.9285714285714286
2022,SAOUDA,CITRUS VOLKAMERIANA,23020,IMG-00079-45.jpg,28,42,28,14,0,0.6666666666666666,1.0
2022,SAOUDA,CITRUS VOLKAMERIANA,23030,IMG-00014-45.jpg,25,40,25,15,0,0.625,1.0
2022,SAOUDA,CITRUS VOLKAMERIANA,23030,IMG-00034-45.jpg,43,60,42,18,1,0.7,0.9767441860465116
2022,SAOUDA,CITRUS VOLKAMERIANA,23030,IMG-00069-45.jpg,28,52,27,25,1,0.5192307692307693,0.9642857142857144
2022,SAOUDA,CITRUS VOLKAMERIANA,23030,IMG-00079-45.jpg,50,77,49,28,1,0.6363636363636364,0.98
2022,SAOUDA,CITRANGE CARRIZO,24010,IMG-00097-45.jpg,59,73,58,15,1,0.7945205479452054,0.9830508474576272
2022,SAOUDA,CITRANGE CARRIZO,24010,IMG-00101-45.jpg,27,36,27,9,0,0.75,1.0
2022,SAOUDA,CITRANGE CARRIZO,24010,IMG-00111-45.jpg,54,62,53,9,1,0.8548387096774194,0.9814814814814816
2022,SAOUDA,CITRANGE CARRIZO,24010,IMG-00112-45.jpg,40,53,40,13,0,0.7547169811320755,1.0
2022,SAOUDA,CITRANGE CARRIZO,25010,IMG-00006-45.jpg,55,69,54,15,1,0.782608695652174,0.9818181818181818
2022,SAOUDA,CITRANGE CARRIZO,25010,IMG-00007-45.jpg,77,94,77,17,0,0.8191489361702128,1.0
2022,SAOUDA,CITRANGE CARRIZO,25010,IMG-00010-45.jpg,53,71,53,18,0,0.7464788732394366,1.0
2022,SAOUDA,CITRANGE CARRIZO,25010,IMG-00011-45.jpg,26,32,26,6,0,0.8125,1.0
2022,SAOUDA,CITRANGE CARRIZO,26010,IMG-00008-45.jpg,39,45,39,6,0,0.8666666666666667,1.0
2022,SAOUDA,CITRANGE CARRIZO,26010,IMG-00013-45.jpg,36,47,36,11,0,0.7659574468085106,1.0
2022,SAOUDA,CITRANGE CARRIZO,26010,IMG-00018-45.jpg,43,53,43,10,0,0.8113207547169812,1.0
2022,SAOUDA,CITRANGE CARRIZO,26010,IMG-00020-45.jpg,44,48,44,4,0,0.9166666666666666,1.0
2022,KHOUALKA,CITRANGE CARRIZO,30138,IMG-00002-40.jpg,39,44,38,6,1,0.8636363636363636,0.9743589743589745
2022,KHOUALKA,CITRANGE CARRIZO,30138,IMG-00003-40.jpg,59,63,57,6,2,0.9047619047619048,0.9661016949152542
2022,KHOUALKA,CITRANGE CARRIZO,30138,IMG-00005-40.jpg,58,65,58,7,0,0.8923076923076924,1.0
2022,KHOUALKA,CITRANGE CARRIZO,30138,IMG-00008-40.jpg,32,33,30,3,2,0.9090909090909092,0.9375
2022,KHOUALKA,CITRANGE CARRIZO,30138,IMG-00011-40.jpg,26,31,26,5,0,0.8387096774193549,1.0
2022,KHOUALKA,CITRANGE CARRIZO,30138,IMG-00019-40.jpg,2,2,2,0,0,1.0,1.0
2022,KHOUALKA,CITRANGE CARRIZO,30138,IMG-00037-40.jpg,30,36,28,8,2,0.7777777777777778,0.9333333333333332
2022,KHOUALKA,CITRANGE CARRIZO,30138,IMG-00040-40.jpg,41,44,41,3,0,0.9318181818181818,1.0
2022,KHOUALKA,CITRANGE CARRIZO,30138,IMG-00043-40.jpg,28,35,28,7,0,0.8,1.0
2022,KHOUALKA,CITRANGE CARRIZO,30138,IMG-00044-40.jpg,99,103,96,7,3,0.9320388349514565,0.9696969696969696
2022,KHOUALKA,CITRANGE CARRIZO,30138,IMG-00048-40.jpg,37,42,35,7,2,0.8333333333333334,0.945945945945946
2022,KHOUALKA,CITRANGE CARRIZO,30138,IMG-00057-40.jpg,73,77,71,6,2,0.922077922077922,0.9726027397260274
2022,KHOUALKA,CITRANGE CARRIZO,30138,IMG-00063-40.jpg,89,82,80,2,9,0.975609756097561,0.898876404494382
2022,ONAGRI,CITRUS VOLKAMERIANA,30145,IMG-00018-39.jpg,219,202,194,8,25,0.9603960396039604,0.8858447488584474
2022,ONAGRI,CITRUS VOLKAMERIANA,30145,IMG-00043-39.jpg,64,65,62,3,2,0.953846153846154,0.96875
2022,ONAGRI,CITRUS VOLKAMERIANA,30146,IMG-00008-39.jpg,262,256,243,13,19,0.94921875,0.9274809160305344
2022,ONAGRI,CITRUS VOLKAMERIANA,30146,IMG-00045-39.jpg,190,195,181,14,9,0.9282051282051282,0.9526315789473684
2022,ONAGRI,CITRUS VOLKAMERIANA,30147,IMG-00002-39.jpg,269,263,249,14,20,0.946768060836502,0.9256505576208178
2022,ONAGRI,CITRUS VOLKAMERIANA,30147,IMG-00008-39.jpg,172,174,162,12,10,0.9310344827586208,0.9418604651162792
2022,ONAGRI,CITRUS VOLKAMERIANA,30148,IMG-00016-40.jpg,88,91,84,7,4,0.9230769230769232,0.9545454545454546
2022,ONAGRI,CITRUS VOLKAMERIANA,30148,IMG-00047-40.jpg,34,31,30,1,4,0.967741935483871,0.8823529411764706
2022,ONAGRI,CITRUS VOLKAMERIANA,30149,IMG-00018-39.jpg,151,138,137,1,14,0.9927536231884058,0.9072847682119204
2022,ONAGRI,CITRUS VOLKAMERIANA,30149,IMG-00027-39.jpg,226,202,199,3,27,0.9851485148514852,0.8805309734513275
2022,ONAGRI,CITRUS VOLKAMERIANA,30151,IMG-00012-39.jpg,185,168,159,9,26,0.9464285714285714,0.8594594594594595
2022,ONAGRI,CITRUS VOLKAMERIANA,30151,IMG-00033-39.jpg,214,213,200,13,14,0.9389671361502347,0.9345794392523364
2024,ONAGRI,CITRUS VOLKAMERIANA,30151,IMG-21881.jpg,73,57,56,1,17,0.9824561403508772,0.7671232876712328
2024,ONAGRI,CITRUS VOLKAMERIANA,30151,IMG-21935.jpg,179,151,150,1,29,0.9933774834437086,0.8379888268156425
2024,ONAGRI,CITRUS VOLKAMERIANA,30151,IMG-21936.jpg,93,71,71,0,22,1.0,0.7634408602150538
2022,ONAGRI,CITRUS VOLKAMERIANA,30152,IMG-00016-39.jpg,39,38,36,2,3,0.9473684210526316,0.9230769230769232
2022,ONAGRI,CITRUS VOLKAMERIANA,30152,IMG-00019-39.jpg,139,127,124,3,15,0.9763779527559056,0.8920863309352518
2022,ONAGRI,CITRUS VOLKAMERIANA,30153,IMG-00001.jpg,157,145,139,6,18,0.9586206896551724,0.8853503184713376
2022,ONAGRI,CITRUS VOLKAMERIANA,30153,IMG-00007-39.jpg,127,115,111,4,16,0.9652173913043478,0.8740157480314961
2022,ONAGRI,CITRUS VOLKAMERIANA,30153,IMG-00013-39.jpg,159,148,144,4,15,0.972972972972973,0.9056603773584906
2022,ONAGRI,CITRUS VOLKAMERIANA,30153,IMG-00040-39.jpg,153,147,140,7,13,0.9523809523809524,0.915032679738562
2022,ONAGRI,CITRUS VOLKAMERIANA,30154,IMG-00017-39.jpg,160,157,152,5,8,0.9681528662420382,0.95
2022,ONAGRI,CITRUS VOLKAMERIANA,30154,IMG-00027-39.jpg,220,218,212,6,8,0.9724770642201837,0.9636363636363636
2022,ONAGRI,CITRUS VOLKAMERIANA,30154,IMG-00033-39.jpg,51,50,49,1,2,0.98,0.9607843137254902
2022,ONAGRI,CITRUS VOLKAMERIANA,30154,IMG-00036-39.jpg,137,137,132,5,5,0.9635036496350364,0.9635036496350364
2022,ONAGRI,CITRUS VOLKAMERIANA,30154,IMG-00038-39.jpg,242,243,235,8,7,0.9670781893004116,0.9710743801652892
2022,ONAGRI,CITRUS VOLKAMERIANA,30154,IMG-00041-39.jpg,272,250,241,9,31,0.964,0.8860294117647058
2022,ONAGRI,CITRUS VOLKAMERIANA,30154,IMG-00044-39.jpg,141,147,134,13,7,0.91156462585034,0.950354609929078
2022,ONAGRI,BIGARADIER,30155,IMG-00002-39.jpg,139,144,135,9,4,0.9375,0.9712230215827338
2022,ONAGRI,BIGARADIER,30155,IMG-00003-39.jpg,115,117,109,8,6,0.9316239316239316,0.9478260869565216
2022,ONAGRI,BIGARADIER,30155,IMG-00006-39.jpg,44,46,41,5,3,0.8913043478260869,0.9318181818181818
2022,ONAGRI,BIGARADIER,30155,IMG-00011-39.jpg,100,96,93,3,7,0.96875,0.93
2022,ONAGRI,BIGARADIER,30155,IMG-00019-39.jpg,142,138,132,6,10,0.9565217391304348,0.9295774647887324
2022,ONAGRI,BIGARADIER,30155,IMG-00026-39.jpg,124,121,114,7,10,0.9421487603305784,0.9193548387096774
2022,ONAGRI,BIGARADIER,30155,IMG-00032-39.jpg,81,78,76,2,5,0.9743589743589745,0.9382716049382716
2022,ONAGRI,BIGARADIER,30155,IMG-00039-39.jpg,19,18,18,0,1,1.0,0.9473684210526316
2022,ONAGRI,BIGARADIER,30155,IMG-00043-39.jpg,130,134,126,8,4,0.9402985074626866,0.9692307692307692
2022,ONAGRI,CITRUS VOLKAMERIANA,30157,IMG-00003-39.jpg,227,224,217,7,10,0.96875,0.9559471365638766
2022,ONAGRI,CITRUS VOLKAMERIANA,30157,IMG-00012-39.jpg,283,286,269,17,14,0.9405594405594404,0.950530035335689
2022,ONAGRI,CITRUS VOLKAMERIANA,30157,IMG-00032-39.jpg,64,67,60,7,4,0.8955223880597015,0.9375
2022,ONAGRI,CITRUS VOLKAMERIANA,30157,IMG-00035-39.jpg,159,154,148,6,11,0.961038961038961,0.9308176100628932
2022,KHOUALKA,CITRUS VOLKAMERIANA,30235,IMG-00001.jpg,93,100,92,8,1,0.92,0.989247311827957
2022,KHOUALKA,CITRUS VOLKAMERIANA,30235,IMG-00003-40.jpg,37,40,37,3,0,0.925,1.0
2022,KHOUALKA,CITRUS VOLKAMERIANA,30235,IMG-00009-40.jpg,103,113,102,11,1,0.9026548672566372,0.9902912621359224
2022,KHOUALKA,CITRUS VOLKAMERIANA,30235,IMG-00013-40.jpg,90,99,89,10,1,0.898989898989899,0.9888888888888888
2022,KHOUALKA,CITRUS VOLKAMERIANA,30235,IMG-00026-40.jpg,122,133,120,13,2,0.9022556390977444,0.9836065573770492
2022,KHOUALKA,CITRUS VOLKAMERIANA,30235,IMG-00047-40.jpg,47,56,45,11,2,0.8035714285714286,0.9574468085106383
2022,KHOUALKA,CITRUS VOLKAMERIANA,30235,IMG-00048-40.jpg,90,101,87,14,3,0.8613861386138614,0.9666666666666668
2022,KHOUALKA,CITRUS VOLKAMERIANA,30235,IMG-00049-40.jpg,44,53,42,11,2,0.7924528301886793,0.9545454545454546
2022,KHOUALKA,CITRUS VOLKAMERIANA,30235,IMG-00050-40.jpg,84,95,80,15,4,0.8421052631578947,0.9523809523809524
2022,KHOUALKA,CITRUS VOLKAMERIANA,30235,IMG-00052-40.jpg,98,113,97,16,1,0.8584070796460177,0.9897959183673468
2022,KHOUALKA,CITRUS VOLKAMERIANA,30235,IMG-00057-40.jpg,80,82,74,8,6,0.902439024390244,0.925
2022,KHOUALKA,CITRUS VOLKAMERIANA,30235,IMG-00064-40.jpg,38,41,35,6,3,0.8536585365853658,0.9210526315789472
2022,KHOUALKA,CITRUS VOLKAMERIANA,30235,IMG-00067-40.jpg,107,113,102,11,5,0.9026548672566372,0.9532710280373832
2022,KHOUALKA,CITRUS VOLKAMERIANA,30235,IMG-00069-40.jpg,34,41,33,8,1,0.8048780487804879,0.9705882352941176
2022,KHOUALKA,CITRUS VOLKAMERIANA,30235,IMG-00075-40.jpg,95,104,93,11,2,0.8942307692307693,0.9789473684210528
2022,KHOUALKA,BIGARADIER,40141,IMG-00006-40.jpg,7,8,6,2,1,0.75,0.8571428571428571
2022,KHOUALKA,BIGARADIER,40141,IMG-00007-40.jpg,20,13,11,2,9,0.8461538461538461,0.55
2022,KHOUALKA,BIGARADIER,40141,IMG-00008-40.jpg,15,15,12,3,3,0.8,0.8
2022,ONAGRI,CITRANGE C35,40166,IMG-00009-39.jpg,38,40,36,4,2,0.9,0.9473684210526316
2022,ONAGRI,CITRANGE C35,40166,IMG-00011-39.jpg,173,175,164,11,9,0.9371428571428572,0.9479768786127168
2022,ONAGRI,CITRANGE C35,40166,IMG-00014-39.jpg,179,179,176,3,3,0.9832402234636872,0.9832402234636872
2022,ONAGRI,CITRANGE C35,40166,IMG-00015-39.jpg,122,123,117,6,5,0.951219512195122,0.9590163934426228
2022,ONAGRI,CITRANGE C35,40166,IMG-00041-39.jpg,102,100,99,1,3,0.99,0.9705882352941176
2022,ONAGRI,CITRANGE C35,40167,IMG-00019-39.jpg,197,201,195,6,2,0.9701492537313432,0.9898477157360406
2022,ONAGRI,CITRANGE C35,40167,IMG-00030-39.jpg,126,125,123,2,3,0.984,0.9761904761904762
2022,ONAGRI,CITRANGE C35,40167,IMG-00039-39.jpg,217,212,201,11,16,0.9481132075471698,0.9262672811059908
2022,ONAGRI,CITRANGE C35,40171,IMG-00008-39.jpg,109,106,104,2,5,0.981132075471698,0.9541284403669724
2022,ONAGRI,CITRANGE C35,40171,IMG-00037-39.jpg,94,90,85,5,9,0.9444444444444444,0.9042553191489362
2022,ONAGRI,CITRANGE C35,40171,IMG-00040-39.jpg,149,147,139,8,10,0.9455782312925172,0.9328859060402684
2022,ONAGRI,CITRANGE C35,40172,IMG-00012-39.jpg,89,85,82,3,7,0.9647058823529412,0.9213483146067416
2022,ONAGRI,CITRANGE C35,40172,IMG-00025-39.jpg,109,102,98,4,11,0.9607843137254902,0.8990825688073395
2022,ONAGRI,CITRANGE C35,40172,IMG-00027-39.jpg,103,93,89,4,14,0.956989247311828,0.8640776699029126
2022,ONAGRI,CITRANGE C35,40173,IMG-00004-39.jpg,133,127,123,4,10,0.968503937007874,0.924812030075188
2022,ONAGRI,CITRANGE C35,40173,IMG-00008-39.jpg,57,47,46,1,11,0.9787234042553192,0.8070175438596491
2022,ONAGRI,CITRANGE C35,40173,IMG-00010-39.jpg,53,58,51,7,2,0.8793103448275862,0.9622641509433962
2022,ONAGRI,CITRANGE C35,40175,IMG-00005-39.jpg,95,86,83,3,12,0.9651162790697676,0.8736842105263158
2022,ONAGRI,CITRANGE C35,40175,IMG-00006-39.jpg,64,68,63,5,1,0.9264705882352942,0.984375
2022,ONAGRI,CITRANGE C35,40176,IMG-00004-39.jpg,79,83,74,9,5,0.891566265060241,0.9367088607594936
2022,ONAGRI,CITRANGE C35,40176,IMG-00012-39.jpg,105,111,101,10,4,0.90990990990991,0.961904761904762
2022,ONAGRI,CITRANGE C35,40176,IMG-00014-39.jpg,91,99,87,12,4,0.8787878787878788,0.956043956043956
2022,ONAGRI,CITRUMELO SACCATON,40177,IMG-00012-39.jpg,89,97,87,10,2,0.8969072164948454,0.9775280898876404
2022,ONAGRI,CITRUMELO SACCATON,40177,IMG-00015-39.jpg,213,225,212,13,1,0.9422222222222222,0.9953051643192488
2022,ONAGRI,CITRUMELO SACCATON,40177,IMG-00037-39.jpg,95,100,93,7,2,0.93,0.9789473684210528
2022,ONAGRI,CITRANGE C35,40178,IMG-00013-39.jpg,76,80,76,4,0,0.95,1.0
2022,ONAGRI,CITRANGE C35,40178,IMG-00027-39.jpg,56,58,55,3,1,0.9482758620689656,0.9821428571428572
2022,ONAGRI,CITRANGE C35,40178,IMG-00031-39.jpg,30,32,30,2,0,0.9375,1.0
2022,ONAGRI,CITRANGE C35,40178,IMG-00032-39.jpg,27,30,27,3,0,0.9,1.0
2022,ONAGRI,CITRANGE C35,40178,IMG-00033-39.jpg,34,38,34,4,0,0.8947368421052632,1.0
2022,ONAGRI,CITRANGE C35,40179,IMG-00001.jpg,83,87,78,9,5,0.896551724137931,0.9397590361445785
2022,ONAGRI,CITRANGE C35,40179,IMG-00010-39.jpg,161,170,155,15,6,0.9117647058823528,0.9627329192546584
2022,ONAGRI,CITRANGE C35,40179,IMG-00011-39.jpg,102,103,96,7,6,0.9320388349514565,0.9411764705882352
2022,ONAGRI,CITRANGE C35,40179,IMG-00018-39.jpg,9,10,9,1,0,0.9,1.0
2022,ONAGRI,CITRUMELO SACCATON,40182,IMG-00004-39.jpg,35,38,35,3,0,0.9210526315789472,1.0
2022,ONAGRI,CITRUMELO SACCATON,40182,IMG-00010-39.jpg,52,53,50,3,2,0.9433962264150944,0.9615384615384616
2022,ONAGRI,CITRUMELO SACCATON,40182,IMG-00015-39.jpg,85,87,80,7,5,0.9195402298850576,0.9411764705882352
2022,ONAGRI,CITRUMELO SACCATON,40183,IMG-00005-39.jpg,68,70,67,3,1,0.9571428571428572,0.9852941176470588
2022,ONAGRI,CITRUMELO SACCATON,40183,IMG-00009-39.jpg,57,63,57,6,0,0.9047619047619048,1.0
2022,ONAGRI,CITRUMELO SACCATON,40183,IMG-00010-39.jpg,48,50,46,4,2,0.92,0.9583333333333334
2024,KHOUALKA,CITRUS VOLKAMERIANA,50152,IMG-17274.jpg,170,122,121,1,49,0.9918032786885246,0.711764705882353
2024,KHOUALKA,CITRUS VOLKAMERIANA,50152,IMG-17306.jpg,105,87,87,0,18,1.0,0.8285714285714286
2024,KHOUALKA,CITRUS VOLKAMERIANA,50152,IMG-17330.jpg,41,30,30,0,11,1.0,0.7317073170731707
2024,KHOUALKA,CITRUS VOLKAMERIANA,50152,IMG-17335.jpg,44,34,34,0,10,1.0,0.7727272727272727
2024,KHOUALKA,CITRUS VOLKAMERIANA,50152,IMG-17340.jpg,108,77,76,1,32,0.987012987012987,0.7037037037037037
2024,KHOUALKA,CITRUS VOLKAMERIANA,50152,IMG-17356.jpg,60,46,43,3,17,0.9347826086956522,0.7166666666666667
2024,KHOUALKA,CITRUS VOLKAMERIANA,50152,IMG-17384.jpg,53,33,32,1,21,0.9696969696969696,0.6037735849056604
2024,KHOUALKA,CITRUS VOLKAMERIANA,50154,IMG-17440.jpg,76,63,63,0,13,1.0,0.8289473684210527
2024,KHOUALKA,CITRUS VOLKAMERIANA,50154,IMG-17490.jpg,107,78,78,0,29,1.0,0.7289719626168224
2024,KHOUALKA,CITRUS VOLKAMERIANA,50154,IMG-17543.jpg,100,69,69,0,31,1.0,0.69
2024,KHOUALKA,CITRUS VOLKAMERIANA,50154,IMG-17545.jpg,94,68,68,0,26,1.0,0.723404255319149
2024,KHOUALKA,CITRUS VOLKAMERIANA,50154,IMG-17562.jpg,129,110,109,1,20,0.990909090909091,0.8449612403100775
2024,KHOUALKA,CITRUS VOLKAMERIANA,50154,IMG-17576.jpg,121,99,99,0,22,1.0,0.8181818181818182
2024,KHOUALKA,CITRUS VOLKAMERIANA,50154,IMG-17585.jpg,171,125,124,1,47,0.992,0.7251461988304093
2024,KHOUALKA,CITRUS VOLKAMERIANA,50168,IMG-13980.jpg,174,132,132,0,42,1.0,0.7586206896551724
2024,KHOUALKA,CITRUS VOLKAMERIANA,50168,IMG-15749.jpg,147,118,118,0,29,1.0,0.8027210884353742
2024,KHOUALKA,CITRUS VOLKAMERIANA,50168,IMG-15758.jpg,163,129,128,1,35,0.992248062015504,0.7852760736196319
2024,KHOUALKA,CITRUS VOLKAMERIANA,50168,IMG-15981.jpg,210,162,161,1,49,0.9938271604938272,0.7666666666666667
2024,KHOUALKA,CITRUS VOLKAMERIANA,50168,IMG-15983.jpg,120,92,91,1,29,0.9891304347826086,0.7583333333333333
2024,KHOUALKA,CITRUS VOLKAMERIANA,50176,IMG-16025.jpg,81,62,62,0,19,1.0,0.7654320987654321
2024,KHOUALKA,CITRUS VOLKAMERIANA,50176,IMG-16051.jpg,85,64,64,0,21,1.0,0.7529411764705882
2024,KHOUALKA,CITRUS VOLKAMERIANA,50176,IMG-16079.jpg,161,120,120,0,41,1.0,0.7453416149068323
2024,KHOUALKA,CITRUS VOLKAMERIANA,50176,IMG-16095.jpg,101,69,69,0,32,1.0,0.6831683168316832
2024,KHOUALKA,CITRUS VOLKAMERIANA,50176,IMG-16105.jpg,43,31,31,0,12,1.0,0.7209302325581395
2022,ONAGRI,CITRUMELO SACCATON,50193,IMG-00007-39.jpg,218,241,218,23,0,0.9045643153526972,1.0
2022,ONAGRI,CITRUMELO SACCATON,50193,IMG-00016-39.jpg,64,73,62,11,2,0.8493150684931506,0.96875
2022,ONAGRI,CITRUMELO SACCATON,50193,IMG-00018-39.jpg,115,125,113,12,2,0.904,0.982608695652174
2022,ONAGRI,CITRUMELO SACCATON,50193,IMG-00021-39.jpg,62,62,59,3,3,0.9516129032258064,0.9516129032258064
2022,ONAGRI,CITRUMELO SACCATON,50193,IMG-00023-39.jpg,113,129,113,16,0,0.875968992248062,1.0
2022,ONAGRI,CITRUMELO SACCATON,50194,IMG-00032-39.jpg,162,171,154,17,8,0.9005847953216374,0.9506172839506172
2022,ONAGRI,CITRUMELO SACCATON,50194,IMG-00034-39.jpg,105,116,104,12,1,0.896551724137931,0.9904761904761904
2022,ONAGRI,CITRUMELO SACCATON,50194,IMG-00036-39.jpg,161,189,155,34,6,0.8201058201058201,0.9627329192546584
2022,ONAGRI,CITRUMELO SACCATON,50194,IMG-00038-39.jpg,100,119,97,22,3,0.8151260504201681,0.97
2022,ONAGRI,CITRUMELO SACCATON,50194,IMG-00039-39.jpg,65,68,64,4,1,0.9411764705882352,0.9846153846153848
2022,ONAGRI,CITRUMELO SACCATON,50194,IMG-00041-39.jpg,153,165,150,15,3,0.9090909090909092,0.9803921568627452
2022,ONAGRI,CITRUMELO SACCATON,50194,IMG-00051-39.jpg,137,146,135,11,2,0.9246575342465754,0.9854014598540146
2022,ONAGRI,CITRUMELO SACCATON,50194,IMG-00054-39.jpg,111,111,105,6,6,0.945945945945946,0.945945945945946
2022,ONAGRI,CITRUMELO SACCATON,51091,IMG-00015-39.jpg,85,100,85,15,0,0.85,1.0
2022,ONAGRI,CITRUMELO SACCATON,51091,IMG-00016-39.jpg,170,180,168,12,2,0.9333333333333332,0.9882352941176472
2022,ONAGRI,CITRUMELO SACCATON,51091,IMG-00018-39.jpg,185,205,183,22,2,0.8926829268292683,0.9891891891891892
2022,ONAGRI,CITRUMELO SACCATON,51091,IMG-00022-39.jpg,135,153,133,20,2,0.869281045751634,0.9851851851851852
2022,ONAGRI,CITRUMELO SACCATON,51091,IMG-00023-39.jpg,140,149,133,16,7,0.8926174496644296,0.95
2022,ONAGRI,CITRUMELO SACCATON,51091,IMG-00026-39.jpg,149,149,141,8,8,0.9463087248322148,0.9463087248322148
2022,ONAGRI,CITRUMELO SACCATON,51091,IMG-00044-39.jpg,168,180,166,14,2,0.9222222222222224,0.988095238095238
2022,ONAGRI,CITRUMELO SACCATON,51095,IMG-00004-39.jpg,201,223,195,28,6,0.874439461883408,0.9701492537313432
2022,ONAGRI,CITRUMELO SACCATON,51095,IMG-00013-39.jpg,154,160,147,13,7,0.91875,0.9545454545454546
2022,ONAGRI,CITRUMELO SACCATON,51095,IMG-00014-39.jpg,140,150,134,16,6,0.8933333333333333,0.9571428571428572
2022,ONAGRI,CITRUMELO SACCATON,51095,IMG-00015-39.jpg,196,202,194,8,2,0.9603960396039604,0.9897959183673468
2022,ONAGRI,CITRUMELO SACCATON,51095,IMG-00024-39.jpg,234,248,228,20,6,0.9193548387096774,0.9743589743589745
2022,ONAGRI,CITRUMELO SACCATON,51095,IMG-00025-39.jpg,198,214,197,17,1,0.9205607476635514,0.9949494949494948
2022,ONAGRI,CITRUMELO SACCATON,51096,IMG-00009-39.jpg,219,232,216,16,3,0.9310344827586208,0.9863013698630136
2022,ONAGRI,CITRUMELO SACCATON,51096,IMG-00011-39.jpg,145,154,143,11,2,0.9285714285714286,0.986206896551724
2022,ONAGRI,CITRUMELO SACCATON,51096,IMG-00012-39.jpg,114,114,108,6,6,0.9473684210526316,0.9473684210526316
2022,ONAGRI,CITRUMELO SACCATON,51096,IMG-00055-39.jpg,217,220,208,12,9,0.9454545454545454,0.9585253456221198
2022,ONAGRI,MC PONSIRUCE TRIFOLIATA,51097,IMG-00025-39.jpg,121,140,116,24,5,0.8285714285714286,0.9586776859504132
2022,ONAGRI,MC PONSIRUCE TRIFOLIATA,51097,IMG-00029-39.jpg,106,125,104,21,2,0.832,0.981132075471698
2022,ONAGRI,MC PONSIRUCE TRIFOLIATA,51097,IMG-00044-39.jpg,182,197,176,21,6,0.8934010152284264,0.967032967032967
2022,ONAGRI,MC PONSIRUCE TRIFOLIATA,51098,IMG-00003-39.jpg,65,70,62,8,3,0.8857142857142857,0.953846153846154
2022,ONAGRI,MC PONSIRUCE TRIFOLIATA,51098,IMG-00010-39.jpg,184,192,178,14,6,0.9270833333333334,0.967391304347826
2022,ONAGRI,MC PONSIRUCE TRIFOLIATA,51098,IMG-00015-39.jpg,162,170,160,10,2,0.9411764705882352,0.9876543209876544
2022,ONAGRI,MC PONSIRUCE TRIFOLIATA,51099,IMG-00012-39.jpg,133,142,129,13,4,0.908450704225352,0.9699248120300752
2024,ONAGRI,MC PONSIRUCE TRIFOLIATA,51101,IMG-12118.jpg,177,132,132,0,45,1.0,0.7457627118644068
2024,ONAGRI,MC PONSIRUCE TRIFOLIATA,51101,IMG-14223.jpg,153,118,118,0,35,1.0,0.7712418300653595
2024,ONAGRI,MC PONSIRUCE TRIFOLIATA,51101,IMG-14226.jpg,151,126,125,1,26,0.992063492063492,0.8278145695364238
2024,ONAGRI,MC PONSIRUCE TRIFOLIATA,51101,IMG-14255.jpg,189,152,152,0,37,1.0,0.8042328042328042
2024,ONAGRI,MC PONSIRUCE TRIFOLIATA,51101,IMG-14281.jpg,150,123,123,0,27,1.0,0.82
2022,ONAGRI,CITRUS VOLKAMERIANA,101020,IMG-00001.jpg,6,7,6,1,0,0.8571428571428571,1.0
2022,ONAGRI,CITRUS VOLKAMERIANA,101020,IMG-00004-44.jpg,53,50,48,2,5,0.96,0.9056603773584906
2022,ONAGRI,CITRUS VOLKAMERIANA,101030,IMG-00003-44.jpg,29,28,27,1,2,0.9642857142857144,0.9310344827586208
2022,ONAGRI,CITRUS VOLKAMERIANA,101030,IMG-00004-44.jpg,110,109,105,4,5,0.963302752293578,0.9545454545454546
2022,ONAGRI,CITRUS VOLKAMERIANA,101030,IMG-00005-44.jpg,134,129,124,5,10,0.9612403100775194,0.9253731343283582
2022,ONAGRI,CITRUS VOLKAMERIANA,101030,IMG-00017-44.jpg,79,71,70,1,9,0.9859154929577464,0.8860759493670886
2022,ONAGRI,CITRUS VOLKAMERIANA,101040,IMG-00005-44.jpg,172,161,156,5,16,0.968944099378882,0.9069767441860463
2022,ONAGRI,CITRUS VOLKAMERIANA,101040,IMG-00009-44.jpg,131,138,127,11,4,0.9202898550724636,0.9694656488549618
2022,ONAGRI,CITRUS VOLKAMERIANA,101040,IMG-00011-44.jpg,64,66,62,4,2,0.9393939393939394,0.96875
2022,ONAGRI,CITRUS VOLKAMERIANA,101040,IMG-00012-44.jpg,139,136,130,6,9,0.9558823529411764,0.935251798561151
2022,ONAGRI,CITRUS VOLKAMERIANA,101050,IMG-00002-44.jpg,95,95,91,4,4,0.9578947368421052,0.9578947368421052
2022,ONAGRI,CITRUS VOLKAMERIANA,101050,IMG-00005-44.jpg,59,57,56,1,3,0.9824561403508772,0.9491525423728814
2022,ONAGRI,CITRUS VOLKAMERIANA,101050,IMG-00011-44.jpg,46,41,40,1,6,0.975609756097561,0.8695652173913043
2022,ONAGRI,CITRUS VOLKAMERIANA,101050,IMG-00024-44.jpg,40,42,40,2,0,0.9523809523809524,1.0
2022,ONAGRI,CITRUS VOLKAMERIANA,101080,IMG-00005-44.jpg,42,42,39,3,3,0.9285714285714286,0.9285714285714286
2022,ONAGRI,CITRUS VOLKAMERIANA,101080,IMG-00006-44.jpg,79,72,70,2,9,0.9722222222222222,0.8860759493670886
2022,ONAGRI,CITRUS VOLKAMERIANA,101080,IMG-00023-44.jpg,7,7,7,0,0,1.0,1.0
2022,ONAGRI,CITRUS VOLKAMERIANA,101080,IMG-00024-44.jpg,27,26,24,2,3,0.9230769230769232,0.8888888888888888
2022,ONAGRI,CITRUS VOLKAMERIANA,101090,IMG-00003-44.jpg,66,69,65,4,1,0.9420289855072465,0.9848484848484848
2022,ONAGRI,CITRUS VOLKAMERIANA,101090,IMG-00006-44.jpg,41,36,36,0,5,1.0,0.8780487804878049
2022,ONAGRI,CITRUS VOLKAMERIANA,101090,IMG-00019-44.jpg,35,38,35,3,0,0.9210526315789472,1.0
2022,ONAGRI,CITRUS VOLKAMERIANA,101090,IMG-00020-44.jpg,42,41,40,1,2,0.975609756097561,0.9523809523809524
2022,KHOUALKA,CITRANGE CARRIZO,102130,IMG-00001.jpg,5,5,5,0,0,1.0,1.0
2022,KHOUALKA,CITRANGE CARRIZO,102130,IMG-00004-43.jpg,24,15,15,0,9,1.0,0.625
2022,KHOUALKA,CITRANGE CARRIZO,102130,IMG-00019-43.jpg,33,34,31,3,2,0.9117647058823528,0.9393939393939394
2022,KHOUALKA,CITRANGE CARRIZO,102130,IMG-00020-43.jpg,18,24,17,7,1,0.7083333333333334,0.9444444444444444
2022,KHOUALKA,MACROPHYLLA,201180,IMG-00007-43.jpg,38,46,38,8,0,0.8260869565217391,1.0
2022,KHOUALKA,MACROPHYLLA,201180,IMG-00011-43.jpg,64,66,61,5,3,0.9242424242424242,0.953125
2022,KHOUALKA,MACROPHYLLA,201180,IMG-00019-43.jpg,64,59,59,0,5,1.0,0.921875
2022,KHOUALKA,MACROPHYLLA,201180,IMG-00020-43.jpg,43,41,39,2,4,0.951219512195122,0.9069767441860463
2022,KHOUALKA,MACROPHYLLA,201190,IMG-00004-43.jpg,101,80,77,3,24,0.9625,0.7623762376237624
2022,KHOUALKA,MACROPHYLLA,201190,IMG-00010-43.jpg,90,75,74,1,16,0.9866666666666668,0.8222222222222222
2022,KHOUALKA,MACROPHYLLA,201190,IMG-00011-43.jpg,134,107,105,2,29,0.9813084112149532,0.7835820895522388
2022,KHOUALKA,MACROPHYLLA,201190,IMG-00020-43.jpg,95,75,72,3,23,0.96,0.7578947368421053
2022,KHOUALKA,CITRUS VOLKAMERIANA,201210,IMG-00011-43.jpg,103,105,100,5,3,0.9523809523809524,0.970873786407767
2022,KHOUALKA,CITRUS VOLKAMERIANA,201210,IMG-00012-43.jpg,42,41,41,0,1,1.0,0.9761904761904762
2022,KHOUALKA,CITRUS VOLKAMERIANA,201210,IMG-00015-43.jpg,77,73,73,0,4,1.0,0.948051948051948
2022,KHOUALKA,CITRUS VOLKAMERIANA,201210,IMG-00019-43.jpg,31,30,30,0,1,1.0,0.967741935483871
2022,KHOUALKA,BIGARADIER,201320,IMG-00006-43.jpg,87,75,75,0,12,1.0,0.8620689655172413
2022,KHOUALKA,BIGARADIER,201320,IMG-00016-43.jpg,97,94,90,4,7,0.9574468085106383,0.9278350515463918
2022,KHOUALKA,BIGARADIER,201320,IMG-00017-43.jpg,49,46,46,0,3,1.0,0.9387755102040816
2022,KHOUALKA,BIGARADIER,201320,IMG-00020-43.jpg,88,87,85,2,3,0.9770114942528736,0.9659090909090908
2022,ONAGRI,BIGARADIER,201390,IMG-00008-44.jpg,62,60,58,2,4,0.9666666666666668,0.935483870967742
2022,ONAGRI,BIGARADIER,201390,IMG-00011-44.jpg,90,82,81,1,9,0.9878048780487804,0.9
2022,ONAGRI,BIGARADIER,201390,IMG-00013-44.jpg,77,66,64,2,13,0.9696969696969696,0.8311688311688312
2022,ONAGRI,BIGARADIER,201390,IMG-00016-44.jpg,69,63,62,1,7,0.984126984126984,0.8985507246376812
2022,KHOUALKA,CITRUS VOLKAMERIANA,202050,IMG-00006-43.jpg,89,91,88,3,1,0.967032967032967,0.9887640449438202
2022,KHOUALKA,CITRUS VOLKAMERIANA,202050,IMG-00010-43.jpg,94,90,90,0,4,1.0,0.9574468085106383
2022,KHOUALKA,CITRUS VOLKAMERIANA,202050,IMG-00011-43.jpg,151,150,147,3,4,0.98,0.9735099337748344
2022,KHOUALKA,CITRUS VOLKAMERIANA,202050,IMG-00020-43.jpg,129,123,123,0,6,1.0,0.9534883720930232
2022,KHOUALKA,CITRUS VOLKAMERIANA,202070,IMG-00006-43.jpg,68,68,68,0,0,1.0,1.0
2022,KHOUALKA,CITRUS VOLKAMERIANA,202070,IMG-00009-43.jpg,120,123,115,8,5,0.934959349593496,0.9583333333333334
2022,KHOUALKA,CITRUS VOLKAMERIANA,202070,IMG-00013-43.jpg,95,83,81,2,14,0.9759036144578314,0.8526315789473684
2022,KHOUALKA,CITRUS VOLKAMERIANA,202070,IMG-00019-43.jpg,57,59,56,3,1,0.9491525423728814,0.9824561403508772
2022,KHOUALKA,CITRUS VOLKAMERIANA,202080,IMG-00005-43.jpg,65,63,62,1,3,0.984126984126984,0.953846153846154
2022,KHOUALKA,CITRUS VOLKAMERIANA,202080,IMG-00008-43.jpg,31,30,30,0,1,1.0,0.967741935483871
2022,KHOUALKA,CITRUS VOLKAMERIANA,202080,IMG-00015-43.jpg,220,220,213,7,7,0.968181818181818,0.968181818181818
2022,KHOUALKA,CITRUS VOLKAMERIANA,202080,IMG-00016-43.jpg,131,130,127,3,4,0.9769230769230768,0.9694656488549618
2022,KHOUALKA,CITRANGE CARRIZO,301380,IMG-00007-43.jpg,30,30,28,2,2,0.9333333333333332,0.9333333333333332
2022,KHOUALKA,CITRANGE CARRIZO,301380,IMG-00011-43.jpg,53,56,52,4,1,0.9285714285714286,0.981132075471698
2022,KHOUALKA,CITRANGE CARRIZO,301380,IMG-00014-43.jpg,7,7,5,2,2,0.7142857142857143,0.7142857142857143
2022,KHOUALKA,CITRANGE CARRIZO,301380,IMG-00020-43.jpg,91,94,87,7,4,0.925531914893617,0.956043956043956
2022,ONAGRI,CITRUS VOLKAMERIANA,301470,IMG-00003-44.jpg,148,148,142,6,6,0.9594594594594594,0.9594594594594594
2022,ONAGRI,CITRUS VOLKAMERIANA,301470,IMG-00004-44.jpg,163,156,144,12,19,0.9230769230769232,0.8834355828220859
2022,ONAGRI,CITRUS VOLKAMERIANA,301470,IMG-00005-44.jpg,160,144,137,7,23,0.9513888888888888,0.85625
2022,ONAGRI,CITRUS VOLKAMERIANA,301480,IMG-00001.jpg,92,70,70,0,22,1.0,0.7608695652173914
2022,ONAGRI,CITRUS VOLKAMERIANA,301480,IMG-00003-43.jpg,26,19,18,1,8,0.9473684210526316,0.6923076923076923
2022,ONAGRI,CITRUS VOLKAMERIANA,301480,IMG-00012-43.jpg,50,40,38,2,12,0.95,0.76
2022,ONAGRI,CITRUS VOLKAMERIANA,301480,IMG-00014-43.jpg,77,68,68,0,9,1.0,0.8831168831168831
2022,ONAGRI,CITRUS VOLKAMERIANA,301490,IMG-00005-44.jpg,108,89,85,4,23,0.9550561797752808,0.7870370370370371
2022,ONAGRI,CITRUS VOLKAMERIANA,301490,IMG-00009-44.jpg,185,174,162,12,23,0.9310344827586208,0.8756756756756757
2022,ONAGRI,CITRUS VOLKAMERIANA,301490,IMG-00012-44.jpg,162,150,145,5,17,0.9666666666666668,0.8950617283950617
2022,ONAGRI,CITRUS VOLKAMERIANA,301490,IMG-00015-44.jpg,109,104,97,7,12,0.9326923076923076,0.8899082568807339
2022,ONAGRI,CITRUS VOLKAMERIANA,301510,IMG-00001.jpg,252,232,226,6,26,0.9741379310344828,0.8968253968253969
2022,ONAGRI,CITRUS VOLKAMERIANA,301510,IMG-00006-44.jpg,137,133,127,6,10,0.9548872180451128,0.927007299270073
2022,ONAGRI,CITRUS VOLKAMERIANA,301510,IMG-00007-44.jpg,115,108,102,6,13,0.9444444444444444,0.8869565217391304
2022,ONAGRI,CITRUS VOLKAMERIANA,301510,IMG-00008-44.jpg,150,135,125,10,25,0.925925925925926,0.8333333333333334
2022,ONAGRI,BIGARADIER,301550,IMG-00008-44.jpg,144,143,136,7,8,0.951048951048951,0.9444444444444444
2022,ONAGRI,BIGARADIER,301550,IMG-00011-44.jpg,40,39,37,2,3,0.9487179487179488,0.925
2022,ONAGRI,BIGARADIER,301550,IMG-00013-44.jpg,76,68,64,4,12,0.9411764705882352,0.8421052631578947
2022,ONAGRI,BIGARADIER,301550,IMG-00014-44.jpg,80,81,76,5,4,0.9382716049382716,0.95
2022,ONAGRI,CITRUS VOLKAMERIANA,301570,IMG-00004-44.jpg,158,151,144,7,14,0.9536423841059604,0.9113924050632912
2022,ONAGRI,CITRUS VOLKAMERIANA,301570,IMG-00007-44.jpg,152,139,135,4,17,0.9712230215827338,0.8881578947368421
2022,ONAGRI,CITRUS VOLKAMERIANA,301570,IMG-00008-44.jpg,103,97,89,8,14,0.9175257731958762,0.8640776699029126
2022,ONAGRI,CITRUS VOLKAMERIANA,301570,IMG-00017-44.jpg,218,212,198,14,20,0.9339622641509434,0.908256880733945
2022,KHOUALKA,CITRUS VOLKAMERIANA,302340,IMG-00004-43.jpg,106,97,94,3,12,0.9690721649484536,0.8867924528301887
2022,KHOUALKA,CITRUS VOLKAMERIANA,302340,IMG-00005-43.jpg,105,90,88,2,17,0.9777777777777776,0.8380952380952381
2022,KHOUALKA,CITRUS VOLKAMERIANA,302340,IMG-00011-43.jpg,75,71,71,0,4,1.0,0.9466666666666668
2022,KHOUALKA,CITRUS VOLKAMERIANA,302340,IMG-00015-43.jpg,92,82,81,1,11,0.9878048780487804,0.8804347826086957
2022,KHOUALKA,CITRUS VOLKAMERIANA,302350,IMG-00008-43.jpg,33,30,29,1,4,0.9666666666666668,0.8787878787878788
2022,KHOUALKA,CITRUS VOLKAMERIANA,302350,IMG-00013-43.jpg,80,80,75,5,5,0.9375,0.9375
2022,KHOUALKA,CITRUS VOLKAMERIANA,302350,IMG-00014-43.jpg,76,74,69,5,7,0.9324324324324323,0.9078947368421052
2022,KHOUALKA,CITRUS VOLKAMERIANA,302350,IMG-00018-43.jpg,44,43,40,3,4,0.9302325581395348,0.9090909090909092
2022,KHOUALKA,CITRUS VOLKAMERIANA,302360,IMG-00005-43.jpg,97,92,91,1,6,0.9891304347826086,0.9381443298969072
2022,KHOUALKA,CITRUS VOLKAMERIANA,302360,IMG-00006-43.jpg,118,113,110,3,8,0.9734513274336284,0.9322033898305084
2022,KHOUALKA,CITRUS VOLKAMERIANA,302360,IMG-00016-43.jpg,67,65,64,1,3,0.9846153846153848,0.9552238805970148
2022,KHOUALKA,CITRUS VOLKAMERIANA,302360,IMG-00021-43.jpg,65,65,62,3,3,0.953846153846154,0.953846153846154
2022,KHOUALKA,CITRUS VOLKAMERIANA,302510,IMG-00001.jpg,73,61,60,1,13,0.9836065573770492,0.821917808219178
2022,KHOUALKA,CITRUS VOLKAMERIANA,302510,IMG-00002-43.jpg,44,37,36,1,8,0.972972972972973,0.8181818181818182
2022,KHOUALKA,CITRUS VOLKAMERIANA,302510,IMG-00003-43.jpg,78,75,75,0,3,1.0,0.9615384615384616
2022,KHOUALKA,CITRUS VOLKAMERIANA,302510,IMG-00015-43.jpg,49,34,34,0,15,1.0,0.6938775510204082
2022,KHOUALKA,BIGARADIER,401410,IMG-00093-43.jpg,35,22,22,0,13,1.0,0.6285714285714286
2022,KHOUALKA,BIGARADIER,401410,IMG-00099-43.jpg,6,4,4,0,2,1.0,0.6666666666666666
2022,KHOUALKA,BIGARADIER,401410,IMG-00102-43.jpg,78,61,61,0,17,1.0,0.782051282051282
2022,KHOUALKA,BIGARADIER,401410,IMG-00104-43.jpg,81,64,62,2,19,0.96875,0.7654320987654321
2022,ONAGRI,CITRANGE C35,401660,IMG-00001.jpg,56,57,54,3,2,0.9473684210526316,0.9642857142857144
2022,ONAGRI,CITRANGE C35,401660,IMG-00008-44.jpg,42,43,42,1,0,0.9767441860465116,1.0
2022,ONAGRI,CITRANGE C35,401660,IMG-00010-44.jpg,29,28,27,1,2,0.9642857142857144,0.9310344827586208
2022,ONAGRI,CITRANGE C35,401660,IMG-00016-44.jpg,64,65,60,5,4,0.9230769230769232,0.9375
2022,ONAGRI,CITRANGE C35,401710,IMG-00003-44.jpg,51,47,46,1,5,0.9787234042553192,0.9019607843137256
2022,ONAGRI,CITRANGE C35,401710,IMG-00012-44.jpg,19,18,18,0,1,1.0,0.9473684210526316
2022,ONAGRI,CITRANGE C35,401710,IMG-00013-44.jpg,33,32,30,2,3,0.9375,0.9090909090909092
2022,ONAGRI,CITRANGE C35,401710,IMG-00019-44.jpg,76,72,71,1,5,0.9861111111111112,0.9342105263157896
2022,ONAGRI,CITRANGE C35,401720,IMG-00007-44.jpg,93,100,93,7,0,0.93,1.0
2022,ONAGRI,CITRANGE C35,401720,IMG-00008-44.jpg,38,36,36,0,2,1.0,0.9473684210526316
2022,ONAGRI,CITRANGE C35,401720,IMG-00010-44.jpg,50,44,43,1,7,0.9772727272727272,0.86
2022,ONAGRI,CITRANGE C35,401720,IMG-00017-44.jpg,68,65,63,2,5,0.9692307692307692,0.9264705882352942
2022,ONAGRI,CITRANGE C35,401730,IMG-00001.jpg,19,20,19,1,0,0.95,1.0
2022,ONAGRI,CITRANGE C35,401730,IMG-00010-44.jpg,50,49,49,0,1,1.0,0.98
2022,ONAGRI,CITRANGE C35,401730,IMG-00013-44.jpg,75,72,70,2,5,0.9722222222222222,0.9333333333333332
2022,ONAGRI,CITRANGE C35,401730,IMG-00016-44.jpg,36,33,33,0,3,1.0,0.9166666666666666
2022,ONAGRI,CITRANGE C35,401750,IMG-00005-44.jpg,88,83,76,7,12,0.9156626506024096,0.8636363636363636
2022,ONAGRI,CITRANGE C35,401750,IMG-00009-44.jpg,127,117,113,4,14,0.9658119658119658,0.889763779527559
2022,ONAGRI,CITRANGE C35,401750,IMG-00016-44.jpg,107,98,96,2,11,0.979591836734694,0.897196261682243
2022,ONAGRI,CITRANGE C35,401750,IMG-00024-44.jpg,50,48,44,4,6,0.9166666666666666,0.88
2022,ONAGRI,CITRUMELO SACCATON,401770,IMG-00003-44.jpg,24,22,21,1,3,0.9545454545454546,0.875
2022,ONAGRI,CITRUMELO SACCATON,401770,IMG-00008-44.jpg,72,76,70,6,2,0.9210526315789472,0.9722222222222222
2022,ONAGRI,CITRUMELO SACCATON,401770,IMG-00009-44.jpg,14,13,13,0,1,1.0,0.9285714285714286
2022,ONAGRI,CITRUMELO SACCATON,401770,IMG-00017-44.jpg,20,17,17,0,3,1.0,0.85
2022,KHOUALKA,BIGARADIER,402440,IMG-00005-43.jpg,17,10,9,1,8,0.9,0.5294117647058824
2022,KHOUALKA,BIGARADIER,402440,IMG-00012-43.jpg,46,36,36,0,10,1.0,0.782608695652174
2022,KHOUALKA,BIGARADIER,402440,IMG-00014-43.jpg,11,7,7,0,4,1.0,0.6363636363636364
2022,KHOUALKA,BIGARADIER,402440,IMG-00015-43.jpg,22,12,12,0,10,1.0,0.5454545454545454
2022,KHOUALKA,BIGARADIER,402590,IMG-00007-43.jpg,104,83,81,2,23,0.9759036144578314,0.7788461538461539
2022,KHOUALKA,BIGARADIER,402590,IMG-00012-43.jpg,45,43,41,2,4,0.9534883720930232,0.9111111111111112
2022,KHOUALKA,BIGARADIER,402590,IMG-00015-43.jpg,58,50,46,4,12,0.92,0.7931034482758621
2022,KHOUALKA,BIGARADIER,402590,IMG-00019-43.jpg,64,62,62,0,2,1.0,0.96875
2022,KHOUALKA,CITRUS VOLKAMERIANA,501520,IMG-00004-43.jpg,39,38,36,2,3,0.9473684210526316,0.9230769230769232
2022,KHOUALKA,CITRUS VOLKAMERIANA,501520,IMG-00007-43.jpg,43,38,37,1,6,0.9736842105263158,0.8604651162790697
2022,KHOUALKA,CITRUS VOLKAMERIANA,501520,IMG-00015-43.jpg,18,12,12,0,6,1.0,0.6666666666666666
2022,KHOUALKA,CITRUS VOLKAMERIANA,501520,IMG-00020-43.jpg,48,45,45,0,3,1.0,0.9375
2022,KHOUALKA,CITRUS VOLKAMERIANA,501540,IMG-00006-43.jpg,38,34,34,0,4,1.0,0.8947368421052632
2022,KHOUALKA,CITRUS VOLKAMERIANA,501540,IMG-00012-43.jpg,102,99,98,1,4,0.98989898989899,0.9607843137254902
2022,KHOUALKA,CITRUS VOLKAMERIANA,501540,IMG-00017-43.jpg,138,129,127,2,11,0.9844961240310076,0.9202898550724636
2022,KHOUALKA,CITRUS VOLKAMERIANA,501540,IMG-00018-43.jpg,51,52,51,1,0,0.9807692307692308,1.0
2022,KHOUALKA,CITRUS VOLKAMERIANA,501660,IMG-00006-43.jpg,60,62,59,3,1,0.9516129032258064,0.9833333333333332
2022,KHOUALKA,CITRUS VOLKAMERIANA,501660,IMG-00016-43.jpg,63,59,58,1,5,0.9830508474576272,0.9206349206349206
2022,KHOUALKA,CITRUS VOLKAMERIANA,501660,IMG-00018-43.jpg,112,96,94,2,18,0.9791666666666666,0.8392857142857143
2022,KHOUALKA,CITRUS VOLKAMERIANA,501660,IMG-00021-43.jpg,90,93,89,4,1,0.956989247311828,0.9888888888888888
2022,KHOUALKA,CITRUS VOLKAMERIANA,501680,IMG-00005-43.jpg,179,159,157,2,22,0.9874213836477987,0.8770949720670391
2022,KHOUALKA,CITRUS VOLKAMERIANA,501680,IMG-00011-43.jpg,101,76,76,0,25,1.0,0.7524752475247525
2022,KHOUALKA,CITRUS VOLKAMERIANA,501680,IMG-00012-43.jpg,76,53,52,1,24,0.981132075471698,0.6842105263157895
2022,KHOUALKA,CITRUS VOLKAMERIANA,501680,IMG-00016-43.jpg,113,94,94,0,19,1.0,0.831858407079646
2022,KHOUALKA,CITRUS VOLKAMERIANA,501690,IMG-00032-43.jpg,34,25,24,1,10,0.96,0.7058823529411765
2022,KHOUALKA,CITRUS VOLKAMERIANA,501690,IMG-00039-43.jpg,186,152,149,3,37,0.9802631578947368,0.8010752688172043
2022,KHOUALKA,CITRUS VOLKAMERIANA,501690,IMG-00047-43.jpg,103,74,74,0,29,1.0,0.7184466019417476
2022,KHOUALKA,CITRUS VOLKAMERIANA,501690,IMG-00049-43.jpg,166,148,143,5,23,0.9662162162162162,0.8614457831325302
2022,KHOUALKA,CITRUS VOLKAMERIANA,501760,IMG-00001.jpg,94,54,52,2,42,0.9629629629629628,0.5531914893617021
2022,KHOUALKA,CITRUS VOLKAMERIANA,501760,IMG-00034-43.jpg,45,26,26,0,19,1.0,0.5777777777777777
2022,KHOUALKA,CITRUS VOLKAMERIANA,501760,IMG-00036-43.jpg,40,30,30,0,10,1.0,0.75
2022,KHOUALKA,CITRUS VOLKAMERIANA,501760,IMG-00051-43.jpg,92,68,67,1,25,0.9852941176470588,0.7282608695652174
2022,ONAGRI,CITRUMELO SACCATON,510910,IMG-00004-44.jpg,73,69,67,2,6,0.9710144927536232,0.9178082191780822
2022,ONAGRI,CITRUMELO SACCATON,510910,IMG-00008-44.jpg,152,117,117,0,35,1.0,0.7697368421052632
2022,ONAGRI,CITRUMELO SACCATON,510910,IMG-00010-44.jpg,107,97,94,3,13,0.9690721649484536,0.8785046728971962
2022,ONAGRI,CITRUMELO SACCATON,510910,IMG-00011-44.jpg,92,85,82,3,10,0.9647058823529412,0.8913043478260869
2022,ONAGRI,CITRUMELO SACCATON,510950,IMG-00006-44.jpg,70,61,61,0,9,1.0,0.8714285714285714
2022,ONAGRI,CITRUMELO SACCATON,510950,IMG-00008-44.jpg,75,67,63,4,12,0.9402985074626866,0.84
2022,ONAGRI,CITRUMELO SACCATON,510950,IMG-00009-44.jpg,85,71,70,1,15,0.9859154929577464,0.8235294117647058
2022,ONAGRI,CITRUMELO SACCATON,510950,IMG-00011-44.jpg,135,113,111,2,24,0.9823008849557522,0.8222222222222222
2022,ONAGRI,MC PONSIRUCE TRIFOLIATA,510980,IMG-00014-44.jpg,67,62,59,3,8,0.9516129032258064,0.8805970149253731
2022,ONAGRI,MC PONSIRUCE TRIFOLIATA,510980,IMG-00015-44.jpg,51,49,46,3,5,0.9387755102040816,0.9019607843137256
2022,ONAGRI,MC PONSIRUCE TRIFOLIATA,510980,IMG-00016-44.jpg,99,91,88,3,11,0.967032967032967,0.8888888888888888
2022,ONAGRI,MC PONSIRUCE TRIFOLIATA,510980,IMG-00019-44.jpg,102,84,81,3,21,0.9642857142857144,0.7941176470588235
2022,ONAGRI,MC PONSIRUCE TRIFOLIATA,510990,IMG-00006-44.jpg,135,115,114,1,21,0.991304347826087,0.8444444444444444
2022,ONAGRI,MC PONSIRUCE TRIFOLIATA,510990,IMG-00008-44.jpg,110,105,104,1,6,0.9904761904761904,0.9454545454545454
2022,ONAGRI,MC PONSIRUCE TRIFOLIATA,510990,IMG-00009-44.jpg,85,74,74,0,11,1.0,0.8705882352941177
2022,ONAGRI,MC PONSIRUCE TRIFOLIATA,510990,IMG-00024-44.jpg,65,57,57,0,8,1.0,0.8769230769230769
2022,ONAGRI,MC PONSIRUCE TRIFOLIATA,511030,IMG-00007-44.jpg,100,88,88,0,12,1.0,0.88
2022,ONAGRI,MC PONSIRUCE TRIFOLIATA,511030,IMG-00016-44.jpg,63,58,57,1,6,0.9827586206896552,0.9047619047619048
2022,ONAGRI,MC PONSIRUCE TRIFOLIATA,511030,IMG-00022-44.jpg,98,90,90,0,8,1.0,0.9183673469387756
2022,ONAGRI,MC PONSIRUCE TRIFOLIATA,511030,IMG-00027-44.jpg,82,79,79,0,3,1.0,0.9634146341463414
2022,ONAGRI,MS PONSIRUCE TRIFOLIATA,511040,IMG-00004-44.jpg,77,72,72,0,5,1.0,0.935064935064935
2022,ONAGRI,MS PONSIRUCE TRIFOLIATA,511040,IMG-00014-44.jpg,48,42,42,0,6,1.0,0.875
2022,ONAGRI,MS PONSIRUCE TRIFOLIATA,511040,IMG-00016-44.jpg,71,71,70,1,1,0.9859154929577464,0.9859154929577464
2022,ONAGRI,MS PONSIRUCE TRIFOLIATA,511040,IMG-00025-44.jpg,56,51,51,0,5,1.0,0.9107142857142856
2022,ONAGRI,FUZHU,511050,IMG-00004-44.jpg,109,96,92,4,17,0.9583333333333334,0.8440366972477065
2022,ONAGRI,FUZHU,511050,IMG-00006-44.jpg,142,123,119,4,23,0.967479674796748,0.8380281690140845
2022,ONAGRI,FUZHU,511050,IMG-00011-44.jpg,172,163,155,8,17,0.950920245398773,0.9011627906976744
2022,ONAGRI,FUZHU,511050,IMG-00022-44.jpg,194,172,170,2,24,0.9883720930232558,0.8762886597938144
2022,ONAGRI,MS PONSIRUCE TRIFOLIATA,511060,IMG-00007-44.jpg,115,109,106,3,9,0.9724770642201837,0.9217391304347826
2022,ONAGRI,MS PONSIRUCE TRIFOLIATA,511060,IMG-00016-44.jpg,102,85,82,3,20,0.9647058823529412,0.803921568627451
2022,ONAGRI,MS PONSIRUCE TRIFOLIATA,511060,IMG-00017-44.jpg,59,52,51,1,8,0.9807692307692308,0.864406779661017
2022,ONAGRI,MS PONSIRUCE TRIFOLIATA,511060,IMG-00019-44.jpg,108,93,89,4,19,0.956989247311828,0.8240740740740741
2022,ONAGRI,FUZHU,511070,IMG-00006-44.jpg,82,82,78,4,4,0.951219512195122,0.951219512195122
2022,ONAGRI,FUZHU,511070,IMG-00016-44.jpg,96,87,82,5,14,0.942528735632184,0.8541666666666666
2022,ONAGRI,FUZHU,511070,IMG-00018-44.jpg,93,82,81,1,12,0.9878048780487804,0.8709677419354839
2022,ONAGRI,FUZHU,511070,IMG-00019-44.jpg,142,123,120,3,22,0.975609756097561,0.8450704225352113
